

PokerStars Game #102594015621:  Hold'em No Limit ($3/$6 USD) - 2013/08/11 2:48:17 ET
Table 'Hakone VI 40-100 bb' 6-max Seat #2 is the button
Seat 2: vjxbkf ($600 in chips) 
Seat 5: king10clubs ($600 in chips) 
vjxbkf: posts small blind $3
king10clubs: posts big blind $6
*** HOLE CARDS ***
vjxbkf: raises $6 to $12
king10clubs: calls $6
*** FLOP *** [9c 2d Jh]
king10clubs: checks 
vjxbkf: checks 
*** TURN *** [9c 2d Jh] [5h]
king10clubs: bets $21
vjxbkf: folds 
Uncalled bet ($21) returned to king10clubs
king10clubs collected $23.50 from pot
king10clubs: doesn't show hand 
*** SUMMARY ***
Total pot $24 | Rake $0.50 
Board [9c 2d Jh 5h]
Seat 2: vjxbkf (button) (small blind) folded on the Turn
Seat 5: king10clubs (big blind) collected ($23.50)


PokerStars Game #102594026472:  Hold'em No Limit ($3/$6 USD) - 2013/08/11 2:49:01 ET
Table 'Hakone VI 40-100 bb' 6-max Seat #5 is the button
Seat 2: vjxbkf ($600 in chips) 
Seat 5: king10clubs ($611.50 in chips) 
king10clubs: posts small blind $3
vjxbkf: posts big blind $6
*** HOLE CARDS ***
king10clubs: raises $6 to $12
vjxbkf: folds 
Uncalled bet ($6) returned to king10clubs
king10clubs collected $12 from pot
king10clubs: doesn't show hand 
*** SUMMARY ***
Total pot $12 | Rake $0 
Seat 2: vjxbkf (big blind) folded before Flop
Seat 5: king10clubs (button) (small blind) collected ($12)


PokerStars Game #102594029994:  Hold'em No Limit ($3/$6 USD) - 2013/08/11 2:49:15 ET
Table 'Hakone VI 40-100 bb' 6-max Seat #2 is the button
Seat 2: vjxbkf ($600 in chips) 
Seat 5: king10clubs ($617.50 in chips) 
vjxbkf: posts small blind $3
king10clubs: posts big blind $6
*** HOLE CARDS ***
vjxbkf: raises $6 to $12
king10clubs: calls $6
*** FLOP *** [8d 8h 9h]
king10clubs: checks 
vjxbkf: bets $15
king10clubs: folds 
Uncalled bet ($15) returned to vjxbkf
vjxbkf collected $23.50 from pot
vjxbkf: doesn't show hand 
*** SUMMARY ***
Total pot $24 | Rake $0.50 
Board [8d 8h 9h]
Seat 2: vjxbkf (button) (small blind) collected ($23.50)
Seat 5: king10clubs (big blind) folded on the Flop


PokerStars Game #102594038190:  Hold'em No Limit ($3/$6 USD) - 2013/08/11 2:49:48 ET
Table 'Hakone VI 40-100 bb' 6-max Seat #5 is the button
Seat 2: vjxbkf ($611.50 in chips) 
Seat 5: king10clubs ($605.50 in chips) 
king10clubs: posts small blind $3
vjxbkf: posts big blind $6
*** HOLE CARDS ***
king10clubs: raises $6 to $12
vjxbkf: folds 
Uncalled bet ($6) returned to king10clubs
king10clubs collected $12 from pot
king10clubs: doesn't show hand 
*** SUMMARY ***
Total pot $12 | Rake $0 
Seat 2: vjxbkf (big blind) folded before Flop
Seat 5: king10clubs (button) (small blind) collected ($12)


PokerStars Game #102594041628:  Hold'em No Limit ($3/$6 USD) - 2013/08/11 2:50:02 ET
Table 'Hakone VI 40-100 bb' 6-max Seat #2 is the button
Seat 2: vjxbkf ($605.50 in chips) 
Seat 5: king10clubs ($611.50 in chips) 
vjxbkf: posts small blind $3
king10clubs: posts big blind $6
*** HOLE CARDS ***
vjxbkf: raises $6 to $12
king10clubs: calls $6
*** FLOP *** [9s Js Kd]
king10clubs: checks 
vjxbkf: checks 
*** TURN *** [9s Js Kd] [4d]
king10clubs: bets $18
vjxbkf: calls $18
*** RIVER *** [9s Js Kd 4d] [6s]
king10clubs: bets $48
vjxbkf: calls $48
*** SHOW DOWN ***
king10clubs: shows [8c Kc] (a pair of Kings)
vjxbkf: shows [6c 4s] (two pair, Sixes and Fours)
vjxbkf collected $155.50 from pot
*** SUMMARY ***
Total pot $156 | Rake $0.50 
Board [9s Js Kd 4d 6s]
Seat 2: vjxbkf (button) (small blind) showed [6c 4s] and won ($155.50) with two pair, Sixes and Fours
Seat 5: king10clubs (big blind) showed [8c Kc] and lost with a pair of Kings


PokerStars Game #102594057514:  Hold'em No Limit ($3/$6 USD) - 2013/08/11 2:51:06 ET
Table 'Hakone VI 40-100 bb' 6-max Seat #5 is the button
Seat 2: vjxbkf ($683 in chips) 
Seat 5: king10clubs ($600 in chips) 
king10clubs: posts small blind $3
vjxbkf: posts big blind $6
*** HOLE CARDS ***
king10clubs: raises $6 to $12
vjxbkf: folds 
Uncalled bet ($6) returned to king10clubs
king10clubs collected $12 from pot
king10clubs: doesn't show hand 
*** SUMMARY ***
Total pot $12 | Rake $0 
Seat 2: vjxbkf (big blind) folded before Flop
Seat 5: king10clubs (button) (small blind) collected ($12)


PokerStars Game #102594059643:  Hold'em No Limit ($3/$6 USD) - 2013/08/11 2:51:15 ET
Table 'Hakone VI 40-100 bb' 6-max Seat #2 is the button
Seat 2: vjxbkf ($677 in chips) 
Seat 5: king10clubs ($606 in chips) 
vjxbkf: posts small blind $3
king10clubs: posts big blind $6
*** HOLE CARDS ***
vjxbkf: raises $6 to $12
king10clubs: raises $33 to $45
vjxbkf: folds 
Uncalled bet ($33) returned to king10clubs
king10clubs collected $24 from pot
king10clubs: doesn't show hand 
*** SUMMARY ***
Total pot $24 | Rake $0 
Seat 2: vjxbkf (button) (small blind) folded before Flop
Seat 5: king10clubs (big blind) collected ($24)


PokerStars Game #102594065321:  Hold'em No Limit ($3/$6 USD) - 2013/08/11 2:51:38 ET
Table 'Hakone VI 40-100 bb' 6-max Seat #5 is the button
Seat 2: vjxbkf ($665 in chips) 
Seat 5: king10clubs ($618 in chips) 
king10clubs: posts small blind $3
vjxbkf: posts big blind $6
*** HOLE CARDS ***
king10clubs: raises $6 to $12
vjxbkf: calls $6
*** FLOP *** [Ts Qh 8d]
vjxbkf: bets $18
king10clubs: raises $39 to $57
vjxbkf: folds 
Uncalled bet ($39) returned to king10clubs
king10clubs collected $59.50 from pot
king10clubs: doesn't show hand 
*** SUMMARY ***
Total pot $60 | Rake $0.50 
Board [Ts Qh 8d]
Seat 2: vjxbkf (big blind) folded on the Flop
Seat 5: king10clubs (button) (small blind) collected ($59.50)


PokerStars Game #102594079984:  Hold'em No Limit ($3/$6 USD) - 2013/08/11 2:52:36 ET
Table 'Hakone VI 40-100 bb' 6-max Seat #2 is the button
Seat 2: vjxbkf ($635 in chips) 
Seat 5: king10clubs ($647.50 in chips) 
vjxbkf: posts small blind $3
king10clubs: posts big blind $6
*** HOLE CARDS ***
vjxbkf: raises $6 to $12
king10clubs: folds 
Uncalled bet ($6) returned to vjxbkf
vjxbkf collected $12 from pot
vjxbkf: doesn't show hand 
*** SUMMARY ***
Total pot $12 | Rake $0 
Seat 2: vjxbkf (button) (small blind) collected ($12)
Seat 5: king10clubs (big blind) folded before Flop


PokerStars Game #102594083449:  Hold'em No Limit ($3/$6 USD) - 2013/08/11 2:52:50 ET
Table 'Hakone VI 40-100 bb' 6-max Seat #5 is the button
Seat 2: vjxbkf ($641 in chips) 
Seat 5: king10clubs ($641.50 in chips) 
king10clubs: posts small blind $3
vjxbkf: posts big blind $6
*** HOLE CARDS ***
king10clubs: raises $6 to $12
vjxbkf: folds 
Uncalled bet ($6) returned to king10clubs
king10clubs collected $12 from pot
king10clubs: doesn't show hand 
*** SUMMARY ***
Total pot $12 | Rake $0 
Seat 2: vjxbkf (big blind) folded before Flop
Seat 5: king10clubs (button) (small blind) collected ($12)


PokerStars Game #102594085741:  Hold'em No Limit ($3/$6 USD) - 2013/08/11 2:53:00 ET
Table 'Hakone VI 40-100 bb' 6-max Seat #2 is the button
Seat 2: vjxbkf ($635 in chips) 
Seat 5: king10clubs ($647.50 in chips) 
vjxbkf: posts small blind $3
king10clubs: posts big blind $6
*** HOLE CARDS ***
vjxbkf: raises $6 to $12
king10clubs: folds 
Uncalled bet ($6) returned to vjxbkf
vjxbkf collected $12 from pot
vjxbkf: doesn't show hand 
*** SUMMARY ***
Total pot $12 | Rake $0 
Seat 2: vjxbkf (button) (small blind) collected ($12)
Seat 5: king10clubs (big blind) folded before Flop


PokerStars Game #102594088716:  Hold'em No Limit ($3/$6 USD) - 2013/08/11 2:53:11 ET
Table 'Hakone VI 40-100 bb' 6-max Seat #5 is the button
Seat 2: vjxbkf ($641 in chips) 
Seat 5: king10clubs ($641.50 in chips) 
king10clubs: posts small blind $3
vjxbkf: posts big blind $6
*** HOLE CARDS ***
king10clubs: raises $6 to $12
vjxbkf: folds 
Uncalled bet ($6) returned to king10clubs
king10clubs collected $12 from pot
king10clubs: doesn't show hand 
*** SUMMARY ***
Total pot $12 | Rake $0 
Seat 2: vjxbkf (big blind) folded before Flop
Seat 5: king10clubs (button) (small blind) collected ($12)


PokerStars Game #102594091459:  Hold'em No Limit ($3/$6 USD) - 2013/08/11 2:53:23 ET
Table 'Hakone VI 40-100 bb' 6-max Seat #2 is the button
Seat 2: vjxbkf ($635 in chips) 
Seat 5: king10clubs ($647.50 in chips) 
vjxbkf: posts small blind $3
king10clubs: posts big blind $6
*** HOLE CARDS ***
vjxbkf: raises $6 to $12
king10clubs: calls $6
*** FLOP *** [Ks Qh Js]
king10clubs: checks 
vjxbkf: checks 
*** TURN *** [Ks Qh Js] [5h]
king10clubs: checks 
vjxbkf: checks 
*** RIVER *** [Ks Qh Js 5h] [Ah]
king10clubs: checks 
vjxbkf: checks 
*** SHOW DOWN ***
king10clubs: shows [7h 8s] (high card Ace)
vjxbkf: shows [5c 6s] (a pair of Fives)
vjxbkf collected $23.50 from pot
*** SUMMARY ***
Total pot $24 | Rake $0.50 
Board [Ks Qh Js 5h Ah]
Seat 2: vjxbkf (button) (small blind) showed [5c 6s] and won ($23.50) with a pair of Fives
Seat 5: king10clubs (big blind) showed [7h 8s] and lost with high card Ace


PokerStars Game #102594100898:  Hold'em No Limit ($3/$6 USD) - 2013/08/11 2:54:00 ET
Table 'Hakone VI 40-100 bb' 6-max Seat #5 is the button
Seat 2: vjxbkf ($646.50 in chips) 
Seat 5: king10clubs ($635.50 in chips) 
king10clubs: posts small blind $3
vjxbkf: posts big blind $6
*** HOLE CARDS ***
king10clubs: raises $6 to $12
vjxbkf: raises $30 to $42
king10clubs: folds 
Uncalled bet ($30) returned to vjxbkf
vjxbkf collected $24 from pot
vjxbkf: doesn't show hand 
*** SUMMARY ***
Total pot $24 | Rake $0 
Seat 2: vjxbkf (big blind) collected ($24)
Seat 5: king10clubs (button) (small blind) folded before Flop


PokerStars Game #102594107005:  Hold'em No Limit ($3/$6 USD) - 2013/08/11 2:54:25 ET
Table 'Hakone VI 40-100 bb' 6-max Seat #2 is the button
Seat 2: vjxbkf ($658.50 in chips) 
Seat 5: king10clubs ($623.50 in chips) 
vjxbkf: posts small blind $3
king10clubs: posts big blind $6
*** HOLE CARDS ***
vjxbkf: raises $6 to $12
king10clubs: raises $33 to $45
vjxbkf: calls $33
*** FLOP *** [Jc 6c 4h]
king10clubs: checks 
vjxbkf: bets $54
king10clubs: calls $54
*** TURN *** [Jc 6c 4h] [8h]
king10clubs: checks 
vjxbkf: bets $135
king10clubs: folds 
Uncalled bet ($135) returned to vjxbkf
vjxbkf collected $197.50 from pot
vjxbkf: doesn't show hand 
*** SUMMARY ***
Total pot $198 | Rake $0.50 
Board [Jc 6c 4h 8h]
Seat 2: vjxbkf (button) (small blind) collected ($197.50)
Seat 5: king10clubs (big blind) folded on the Turn


PokerStars Game #102594350869:  Hold'em No Limit ($3/$6 USD) - 2013/08/11 3:10:10 ET
Table 'Hakone VI 40-100 bb' 6-max Seat #2 is the button
Seat 1: leo 32824 ($491 in chips) 
Seat 2: vjxbkf ($827.63 in chips) 
Seat 3: Naebushkin ($890 in chips) 
Seat 4: iviz21 ($252.20 in chips) 
Seat 5: king10clubs ($710.13 in chips) 
Seat 6: NutPopper ($249.97 in chips) 
Naebushkin: posts small blind $3
iviz21: posts big blind $6
*** HOLE CARDS ***
king10clubs: folds 
NutPopper: folds 
leo 32824: folds 
vjxbkf: raises $6 to $12
Naebushkin: folds 
iviz21: folds 
Uncalled bet ($6) returned to vjxbkf
vjxbkf collected $15 from pot
vjxbkf: doesn't show hand 
*** SUMMARY ***
Total pot $15 | Rake $0 
Seat 1: leo 32824 folded before Flop (didn't bet)
Seat 2: vjxbkf (button) collected ($15)
Seat 3: Naebushkin (small blind) folded before Flop
Seat 4: iviz21 (big blind) folded before Flop
Seat 5: king10clubs folded before Flop (didn't bet)
Seat 6: NutPopper folded before Flop (didn't bet)


PokerStars Game #102594360777:  Hold'em No Limit ($3/$6 USD) - 2013/08/11 3:10:44 ET
Table 'Hakone VI 40-100 bb' 6-max Seat #3 is the button
Seat 1: leo 32824 ($491 in chips) 
Seat 2: vjxbkf ($836.63 in chips) 
Seat 3: Naebushkin ($887 in chips) 
Seat 4: iviz21 ($246.20 in chips) 
Seat 5: king10clubs ($710.13 in chips) 
Seat 6: NutPopper ($249.97 in chips) 
iviz21: posts small blind $3
king10clubs: posts big blind $6
*** HOLE CARDS ***
NutPopper: folds 
leo 32824: folds 
vjxbkf: raises $9 to $15
Naebushkin: raises $30 to $45
iviz21: folds 
king10clubs: folds 
vjxbkf: folds 
Uncalled bet ($30) returned to Naebushkin
Naebushkin collected $39 from pot
Naebushkin: doesn't show hand 
*** SUMMARY ***
Total pot $39 | Rake $0 
Seat 1: leo 32824 folded before Flop (didn't bet)
Seat 2: vjxbkf folded before Flop
Seat 3: Naebushkin (button) collected ($39)
Seat 4: iviz21 (small blind) folded before Flop
Seat 5: king10clubs (big blind) folded before Flop
Seat 6: NutPopper folded before Flop (didn't bet)


PokerStars Game #102594374632:  Hold'em No Limit ($3/$6 USD) - 2013/08/11 3:11:31 ET
Table 'Hakone VI 40-100 bb' 6-max Seat #4 is the button
Seat 1: leo 32824 ($491 in chips) 
Seat 2: vjxbkf ($821.63 in chips) 
Seat 3: Naebushkin ($911 in chips) 
Seat 4: iviz21 ($243.20 in chips) 
Seat 5: king10clubs ($704.13 in chips) 
Seat 6: NutPopper ($249.97 in chips) 
king10clubs: posts small blind $3
NutPopper: posts big blind $6
*** HOLE CARDS ***
leo 32824: folds 
vjxbkf: folds 
Naebushkin: folds 
iviz21: raises $6 to $12
king10clubs: folds 
NutPopper: folds 
Uncalled bet ($6) returned to iviz21
iviz21 collected $15 from pot
*** SUMMARY ***
Total pot $15 | Rake $0 
Seat 1: leo 32824 folded before Flop (didn't bet)
Seat 2: vjxbkf folded before Flop (didn't bet)
Seat 3: Naebushkin folded before Flop (didn't bet)
Seat 4: iviz21 (button) collected ($15)
Seat 5: king10clubs (small blind) folded before Flop
Seat 6: NutPopper (big blind) folded before Flop


PokerStars Game #102594385010:  Hold'em No Limit ($3/$6 USD) - 2013/08/11 3:12:06 ET
Table 'Hakone VI 40-100 bb' 6-max Seat #5 is the button
Seat 1: leo 32824 ($491 in chips) 
Seat 2: vjxbkf ($821.63 in chips) 
Seat 3: Naebushkin ($911 in chips) 
Seat 4: iviz21 ($252.20 in chips) 
Seat 5: king10clubs ($701.13 in chips) 
Seat 6: NutPopper ($243.97 in chips) 
NutPopper: posts small blind $3
leo 32824: posts big blind $6
*** HOLE CARDS ***
vjxbkf: folds 
Naebushkin: folds 
iviz21: raises $6 to $12
king10clubs: folds 
NutPopper: calls $9
leo 32824: folds 
*** FLOP *** [7h As Js]
NutPopper: checks 
iviz21: checks 
*** TURN *** [7h As Js] [Qc]
NutPopper: bets $6.78
iviz21: raises $11.22 to $18
NutPopper: folds 
Uncalled bet ($11.22) returned to iviz21
iviz21 collected $41.60 from pot
iviz21: doesn't show hand 
*** SUMMARY ***
Total pot $43.56 | Rake $1.96 
Board [7h As Js Qc]
Seat 1: leo 32824 (big blind) folded before Flop
Seat 2: vjxbkf folded before Flop (didn't bet)
Seat 3: Naebushkin folded before Flop (didn't bet)
Seat 4: iviz21 collected ($41.60)
Seat 5: king10clubs (button) folded before Flop (didn't bet)
Seat 6: NutPopper (small blind) folded on the Turn


PokerStars Game #102594402530:  Hold'em No Limit ($3/$6 USD) - 2013/08/11 3:13:03 ET
Table 'Hakone VI 40-100 bb' 6-max Seat #6 is the button
Seat 1: leo 32824 ($485 in chips) 
Seat 2: vjxbkf ($821.63 in chips) 
Seat 3: Naebushkin ($911 in chips) 
Seat 4: iviz21 ($275.02 in chips) 
Seat 5: king10clubs ($701.13 in chips) 
Seat 6: NutPopper ($225.19 in chips) 
leo 32824: posts small blind $3
vjxbkf: posts big blind $6
*** HOLE CARDS ***
Naebushkin: folds 
iviz21: raises $6 to $12
king10clubs: folds 
NutPopper: folds 
leo 32824: calls $9
vjxbkf: folds 
*** FLOP *** [6d 3s Kh]
leo 32824: bets $24
iviz21: folds 
Uncalled bet ($24) returned to leo 32824
leo 32824 collected $28.65 from pot
*** SUMMARY ***
Total pot $30 | Rake $1.35 
Board [6d 3s Kh]
Seat 1: leo 32824 (small blind) collected ($28.65)
Seat 2: vjxbkf (big blind) folded before Flop
Seat 3: Naebushkin folded before Flop (didn't bet)
Seat 4: iviz21 folded on the Flop
Seat 5: king10clubs folded before Flop (didn't bet)
Seat 6: NutPopper (button) folded before Flop (didn't bet)


PokerStars Game #102594417598:  Hold'em No Limit ($3/$6 USD) - 2013/08/11 3:13:53 ET
Table 'Hakone VI 40-100 bb' 6-max Seat #1 is the button
Seat 1: leo 32824 ($501.65 in chips) 
Seat 2: vjxbkf ($815.63 in chips) 
Seat 3: Naebushkin ($911 in chips) 
Seat 4: iviz21 ($263.02 in chips) 
Seat 5: king10clubs ($701.13 in chips) 
Seat 6: NutPopper ($225.19 in chips) 
vjxbkf: posts small blind $3
Naebushkin: posts big blind $6
*** HOLE CARDS ***
iviz21: calls $6
king10clubs: folds 
NutPopper: folds 
leo 32824 has timed out while being disconnected
leo 32824: folds 
leo 32824 is disconnected 
vjxbkf: folds 
Naebushkin: checks 
*** FLOP *** [Qh 4c 6c]
Naebushkin: checks 
iviz21: bets $18
Naebushkin: folds 
Uncalled bet ($18) returned to iviz21
iviz21 collected $14.32 from pot
iviz21: doesn't show hand 
*** SUMMARY ***
Total pot $15 | Rake $0.68 
Board [Qh 4c 6c]
Seat 1: leo 32824 (button) folded before Flop (didn't bet)
Seat 2: vjxbkf (small blind) folded before Flop
Seat 3: Naebushkin (big blind) folded on the Flop
Seat 4: iviz21 collected ($14.32)
Seat 5: king10clubs folded before Flop (didn't bet)
Seat 6: NutPopper folded before Flop (didn't bet)


PokerStars Game #102594272753:  Hold'em No Limit ($3/$6 USD) - 2013/08/11 3:05:43 ET
Table 'Hakone VI 40-100 bb' 6-max Seat #2 is the button
Seat 2: vjxbkf ($842.63 in chips) 
Seat 3: Naebushkin ($899 in chips) 
Seat 4: iviz21 ($330.20 in chips) 
Seat 5: king10clubs ($624.28 in chips) 
Seat 6: NutPopper ($231 in chips) 
Naebushkin: posts small blind $3
iviz21: posts big blind $6
*** HOLE CARDS ***
noeljohn250 leaves the table
king10clubs: raises $9 to $15
NutPopper: folds 
vjxbkf: folds 
Naebushkin: folds 
iviz21: folds 
Uncalled bet ($9) returned to king10clubs
king10clubs collected $15 from pot
king10clubs: doesn't show hand 
*** SUMMARY ***
Total pot $15 | Rake $0 
Seat 2: vjxbkf (button) folded before Flop (didn't bet)
Seat 3: Naebushkin (small blind) folded before Flop
Seat 4: iviz21 (big blind) folded before Flop
Seat 5: king10clubs collected ($15)
Seat 6: NutPopper folded before Flop (didn't bet)


PokerStars Game #102594277148:  Hold'em No Limit ($3/$6 USD) - 2013/08/11 3:05:58 ET
Table 'Hakone VI 40-100 bb' 6-max Seat #3 is the button
Seat 2: vjxbkf ($842.63 in chips) 
Seat 3: Naebushkin ($896 in chips) 
Seat 4: iviz21 ($324.20 in chips) 
Seat 5: king10clubs ($633.28 in chips) 
Seat 6: NutPopper ($231 in chips) 
iviz21: posts small blind $3
king10clubs: posts big blind $6
*** HOLE CARDS ***
NutPopper: folds 
vjxbkf: folds 
Naebushkin: folds 
iviz21: raises $6 to $12
king10clubs: calls $6
*** FLOP *** [Ac 3s 2s]
iviz21: bets $18
king10clubs: calls $18
*** TURN *** [Ac 3s 2s] [5h]
iviz21: checks 
king10clubs: bets $36
iviz21: calls $36
*** RIVER *** [Ac 3s 2s 5h] [6d]
iviz21: checks 
king10clubs: bets $105
iviz21: folds 
Uncalled bet ($105) returned to king10clubs
king10clubs collected $129.20 from pot
king10clubs: doesn't show hand 
*** SUMMARY ***
Total pot $132 | Rake $2.80 
Board [Ac 3s 2s 5h 6d]
Seat 2: vjxbkf folded before Flop (didn't bet)
Seat 3: Naebushkin (button) folded before Flop (didn't bet)
Seat 4: iviz21 (small blind) folded on the River
Seat 5: king10clubs (big blind) collected ($129.20)
Seat 6: NutPopper folded before Flop (didn't bet)


PokerStars Game #102594295124:  Hold'em No Limit ($3/$6 USD) - 2013/08/11 3:07:00 ET
Table 'Hakone VI 40-100 bb' 6-max Seat #4 is the button
Seat 2: vjxbkf ($842.63 in chips) 
Seat 3: Naebushkin ($896 in chips) 
Seat 4: iviz21 ($258.20 in chips) 
Seat 5: king10clubs ($696.48 in chips) 
Seat 6: NutPopper ($231 in chips) 
king10clubs: posts small blind $3
NutPopper: posts big blind $6
*** HOLE CARDS ***
vjxbkf: folds 
Naebushkin: folds 
iviz21: folds 
king10clubs: raises $9 to $15
NutPopper: calls $9
*** FLOP *** [Kh 4s 6h]
leo 32824 joins the table at seat #1 
king10clubs: checks 
NutPopper: checks 
*** TURN *** [Kh 4s 6h] [Ks]
king10clubs: bets $14
NutPopper: folds 
Uncalled bet ($14) returned to king10clubs
king10clubs collected $28.65 from pot
king10clubs: doesn't show hand 
*** SUMMARY ***
Total pot $30 | Rake $1.35 
Board [Kh 4s 6h Ks]
Seat 2: vjxbkf folded before Flop (didn't bet)
Seat 3: Naebushkin folded before Flop (didn't bet)
Seat 4: iviz21 (button) folded before Flop (didn't bet)
Seat 5: king10clubs (small blind) collected ($28.65)
Seat 6: NutPopper (big blind) folded on the Turn


PokerStars Game #102594310612:  Hold'em No Limit ($3/$6 USD) - 2013/08/11 3:07:54 ET
Table 'Hakone VI 40-100 bb' 6-max Seat #5 is the button
Seat 1: leo 32824 ($500 in chips) 
Seat 2: vjxbkf ($842.63 in chips) 
Seat 3: Naebushkin ($896 in chips) 
Seat 4: iviz21 ($258.20 in chips) 
Seat 5: king10clubs ($710.13 in chips) 
Seat 6: NutPopper ($216 in chips) 
NutPopper: posts small blind $3
leo 32824: posts big blind $6
*** HOLE CARDS ***
vjxbkf: folds 
Naebushkin: folds 
iviz21: calls $6
king10clubs: folds 
NutPopper: calls $3
leo 32824: checks 
*** FLOP *** [Td 7c Ks]
NutPopper: checks 
leo 32824: checks 
iviz21: checks 
*** TURN *** [Td 7c Ks] [7d]
NutPopper: bets $13
leo 32824: folds 
iviz21: folds 
Uncalled bet ($13) returned to NutPopper
NutPopper collected $17.19 from pot
NutPopper: doesn't show hand 
*** SUMMARY ***
Total pot $18 | Rake $0.81 
Board [Td 7c Ks 7d]
Seat 1: leo 32824 (big blind) folded on the Turn
Seat 2: vjxbkf folded before Flop (didn't bet)
Seat 3: Naebushkin folded before Flop (didn't bet)
Seat 4: iviz21 folded on the Turn
Seat 5: king10clubs (button) folded before Flop (didn't bet)
Seat 6: NutPopper (small blind) collected ($17.19)


PokerStars Game #102594326446:  Hold'em No Limit ($3/$6 USD) - 2013/08/11 3:08:48 ET
Table 'Hakone VI 40-100 bb' 6-max Seat #6 is the button
Seat 1: leo 32824 ($494 in chips) 
Seat 2: vjxbkf ($842.63 in chips) 
Seat 3: Naebushkin ($896 in chips) 
Seat 4: iviz21 ($252.20 in chips) 
Seat 5: king10clubs ($710.13 in chips) 
Seat 6: NutPopper ($227.19 in chips) 
leo 32824: posts small blind $3
vjxbkf: posts big blind $6
*** HOLE CARDS ***
Naebushkin: folds 
iviz21: folds 
king10clubs: folds 
NutPopper: raises $6 to $12
leo 32824: folds 
vjxbkf: calls $6
*** FLOP *** [9d 5d Ts]
vjxbkf: checks 
NutPopper: bets $12
vjxbkf: folds 
Uncalled bet ($12) returned to NutPopper
NutPopper collected $25.78 from pot
NutPopper: doesn't show hand 
*** SUMMARY ***
Total pot $27 | Rake $1.22 
Board [9d 5d Ts]
Seat 1: leo 32824 (small blind) folded before Flop
Seat 2: vjxbkf (big blind) folded on the Flop
Seat 3: Naebushkin folded before Flop (didn't bet)
Seat 4: iviz21 folded before Flop (didn't bet)
Seat 5: king10clubs folded before Flop (didn't bet)
Seat 6: NutPopper (button) collected ($25.78)


PokerStars Game #102594341331:  Hold'em No Limit ($3/$6 USD) - 2013/08/11 3:09:39 ET
Table 'Hakone VI 40-100 bb' 6-max Seat #1 is the button
Seat 1: leo 32824 ($491 in chips) 
Seat 2: vjxbkf ($830.63 in chips) 
Seat 3: Naebushkin ($896 in chips) 
Seat 4: iviz21 ($252.20 in chips) 
Seat 5: king10clubs ($710.13 in chips) 
Seat 6: NutPopper ($240.97 in chips) 
vjxbkf: posts small blind $3
Naebushkin: posts big blind $6
*** HOLE CARDS ***
iviz21: folds 
king10clubs: folds 
NutPopper: raises $6 to $12
leo 32824: folds 
vjxbkf: folds 
Naebushkin: folds 
Uncalled bet ($6) returned to NutPopper
NutPopper collected $15 from pot
NutPopper: doesn't show hand 
*** SUMMARY ***
Total pot $15 | Rake $0 
Seat 1: leo 32824 (button) folded before Flop (didn't bet)
Seat 2: vjxbkf (small blind) folded before Flop
Seat 3: Naebushkin (big blind) folded before Flop
Seat 4: iviz21 folded before Flop (didn't bet)
Seat 5: king10clubs folded before Flop (didn't bet)
Seat 6: NutPopper collected ($15)


PokerStars Game #102594141533:  Hold'em No Limit ($3/$6 USD) - 2013/08/11 2:57:01 ET
Table 'Hakone VI 40-100 bb' 6-max Seat #2 is the button
Seat 1: noeljohn250 ($250 in chips) 
Seat 2: vjxbkf ($757 in chips) 
Seat 5: king10clubs ($600 in chips) 
king10clubs: posts small blind $3
noeljohn250: posts big blind $6
*** HOLE CARDS ***
vjxbkf: raises $6 to $12
king10clubs: folds 
noeljohn250: calls $6
*** FLOP *** [Jh Kc 8s]
noeljohn250: checks 
Naebushkin joins the table at seat #3 
iviz21 joins the table at seat #4 
vjxbkf: checks 
*** TURN *** [Jh Kc 8s] [4s]
noeljohn250: checks 
NutPopper joins the table at seat #6 
vjxbkf: checks 
*** RIVER *** [Jh Kc 8s 4s] [Kh]
noeljohn250: checks 
vjxbkf: bets $18
noeljohn250: folds 
Uncalled bet ($18) returned to vjxbkf
vjxbkf collected $25.78 from pot
vjxbkf: doesn't show hand 
*** SUMMARY ***
Total pot $27 | Rake $1.22 
Board [Jh Kc 8s 4s Kh]
Seat 1: noeljohn250 (big blind) folded on the River
Seat 2: vjxbkf (button) collected ($25.78)
Seat 5: king10clubs (small blind) folded before Flop


PokerStars Game #102594155627:  Hold'em No Limit ($3/$6 USD) - 2013/08/11 2:58:07 ET
Table 'Hakone VI 40-100 bb' 6-max Seat #5 is the button
Seat 1: noeljohn250 ($238 in chips) 
Seat 3: Naebushkin ($600 in chips) 
Seat 5: king10clubs ($600 in chips) 
noeljohn250: posts small blind $3
vjxbkf: is sitting out 
Naebushkin: posts big blind $6
iviz21: sits out 
*** HOLE CARDS ***
king10clubs: raises $6 to $12
noeljohn250: folds 
Naebushkin: calls $6
*** FLOP *** [8h Kd 9d]
Naebushkin: checks 
king10clubs: bets $18
Naebushkin: folds 
Uncalled bet ($18) returned to king10clubs
king10clubs collected $25.78 from pot
king10clubs: doesn't show hand 
*** SUMMARY ***
Total pot $27 | Rake $1.22 
Board [8h Kd 9d]
Seat 1: noeljohn250 (small blind) folded before Flop
Seat 3: Naebushkin (big blind) folded on the Flop
Seat 5: king10clubs (button) collected ($25.78)


PokerStars Game #102594160967:  Hold'em No Limit ($3/$6 USD) - 2013/08/11 2:58:31 ET
Table 'Hakone VI 40-100 bb' 6-max Seat #1 is the button
Seat 1: noeljohn250 ($235 in chips) 
Seat 3: Naebushkin ($600 in chips) 
Seat 4: iviz21 ($240 in chips) 
Seat 5: king10clubs ($613.78 in chips) 
vjxbkf will be allowed to play after the button
Naebushkin: posts small blind $3
iviz21: posts big blind $6
NutPopper: is sitting out 
*** HOLE CARDS ***
king10clubs: folds 
noeljohn250: folds 
Naebushkin: folds 
Uncalled bet ($3) returned to iviz21
iviz21 collected $6 from pot
*** SUMMARY ***
Total pot $6 | Rake $0 
Seat 1: noeljohn250 (button) folded before Flop (didn't bet)
Seat 3: Naebushkin (small blind) folded before Flop
Seat 4: iviz21 (big blind) collected ($6)
Seat 5: king10clubs folded before Flop (didn't bet)


PokerStars Game #102594164292:  Hold'em No Limit ($3/$6 USD) - 2013/08/11 2:58:46 ET
Table 'Hakone VI 40-100 bb' 6-max Seat #3 is the button
Seat 1: noeljohn250 ($235 in chips) 
Seat 3: Naebushkin ($600 in chips) 
Seat 4: iviz21 ($243 in chips) 
Seat 5: king10clubs ($613.78 in chips) 
iviz21: posts small blind $3
king10clubs: posts big blind $6
vjxbkf: sits out 
*** HOLE CARDS ***
noeljohn250: folds 
Naebushkin: folds 
iviz21: calls $3
king10clubs: raises $12 to $18
iviz21: calls $12
*** FLOP *** [4d Kd 8c]
iviz21: bets $18
king10clubs: calls $18
*** TURN *** [4d Kd 8c] [Jh]
iviz21: checks 
king10clubs: checks 
*** RIVER *** [4d Kd 8c Jh] [6s]
iviz21: checks 
king10clubs: checks 
*** SHOW DOWN ***
iviz21: shows [7h Qh] (high card King)
king10clubs: shows [4c Ac] (a pair of Fours)
king10clubs collected $70.50 from pot
*** SUMMARY ***
Total pot $72 | Rake $1.50 
Board [4d Kd 8c Jh 6s]
Seat 1: noeljohn250 folded before Flop (didn't bet)
Seat 3: Naebushkin (button) folded before Flop (didn't bet)
Seat 4: iviz21 (small blind) showed [7h Qh] and lost with high card King
Seat 5: king10clubs (big blind) showed [4c Ac] and won ($70.50) with a pair of Fours


PokerStars Game #102594175841:  Hold'em No Limit ($3/$6 USD) - 2013/08/11 2:59:39 ET
Table 'Hakone VI 40-100 bb' 6-max Seat #4 is the button
Seat 1: noeljohn250 ($235 in chips) 
Seat 3: Naebushkin ($600 in chips) 
Seat 4: iviz21 ($207 in chips) 
Seat 5: king10clubs ($648.28 in chips) 
king10clubs: posts small blind $3
noeljohn250: posts big blind $6
vjxbkf: sits out 
*** HOLE CARDS ***
Naebushkin: raises $12 to $18
iviz21: calls $18
king10clubs: folds 
noeljohn250: folds 
*** FLOP *** [Td 7c 5s]
Naebushkin: bets $27
iviz21: folds 
Uncalled bet ($27) returned to Naebushkin
Naebushkin collected $43.50 from pot
Naebushkin: doesn't show hand 
*** SUMMARY ***
Total pot $45 | Rake $1.50 
Board [Td 7c 5s]
Seat 1: noeljohn250 (big blind) folded before Flop
Seat 3: Naebushkin collected ($43.50)
Seat 4: iviz21 (button) folded on the Flop
Seat 5: king10clubs (small blind) folded before Flop


PokerStars Game #102594185469:  Hold'em No Limit ($3/$6 USD) - 2013/08/11 3:00:21 ET
Table 'Hakone VI 40-100 bb' 6-max Seat #5 is the button
Seat 1: noeljohn250 ($229 in chips) 
Seat 2: vjxbkf ($770.78 in chips) 
Seat 3: Naebushkin ($625.50 in chips) 
Seat 4: iviz21 ($189 in chips) 
Seat 5: king10clubs ($645.28 in chips) 
noeljohn250: posts small blind $3
vjxbkf: posts big blind $6
*** HOLE CARDS ***
Naebushkin: folds 
iviz21: folds 
king10clubs: raises $6 to $12
noeljohn250: calls $9
vjxbkf: folds 
*** FLOP *** [4c 8d 9s]
noeljohn250: checks 
king10clubs: checks 
*** TURN *** [4c 8d 9s] [6c]
noeljohn250: bets $24
king10clubs: folds 
Uncalled bet ($24) returned to noeljohn250
noeljohn250 collected $28.65 from pot
*** SUMMARY ***
Total pot $30 | Rake $1.35 
Board [4c 8d 9s 6c]
Seat 1: noeljohn250 (small blind) collected ($28.65)
Seat 2: vjxbkf (big blind) folded before Flop
Seat 3: Naebushkin folded before Flop (didn't bet)
Seat 4: iviz21 folded before Flop (didn't bet)
Seat 5: king10clubs (button) folded on the Turn


PokerStars Game #102594192179:  Hold'em No Limit ($3/$6 USD) - 2013/08/11 3:00:49 ET
Table 'Hakone VI 40-100 bb' 6-max Seat #1 is the button
Seat 1: noeljohn250 ($245.65 in chips) 
Seat 2: vjxbkf ($764.78 in chips) 
Seat 3: Naebushkin ($625.50 in chips) 
Seat 4: iviz21 ($189 in chips) 
Seat 5: king10clubs ($633.28 in chips) 
vjxbkf: posts small blind $3
Naebushkin: posts big blind $6
*** HOLE CARDS ***
iviz21: folds 
king10clubs: folds 
noeljohn250: folds 
vjxbkf: folds 
Uncalled bet ($3) returned to Naebushkin
Naebushkin collected $6 from pot
Naebushkin: doesn't show hand 
*** SUMMARY ***
Total pot $6 | Rake $0 
Seat 1: noeljohn250 (button) folded before Flop (didn't bet)
Seat 2: vjxbkf (small blind) folded before Flop
Seat 3: Naebushkin (big blind) collected ($6)
Seat 4: iviz21 folded before Flop (didn't bet)
Seat 5: king10clubs folded before Flop (didn't bet)


PokerStars Game #102594195722:  Hold'em No Limit ($3/$6 USD) - 2013/08/11 3:01:03 ET
Table 'Hakone VI 40-100 bb' 6-max Seat #2 is the button
Seat 1: noeljohn250 ($245.65 in chips) 
Seat 2: vjxbkf ($761.78 in chips) 
Seat 3: Naebushkin ($628.50 in chips) 
Seat 4: iviz21 ($189 in chips) 
Seat 5: king10clubs ($633.28 in chips) 
Naebushkin: posts small blind $3
iviz21: posts big blind $6
*** HOLE CARDS ***
king10clubs: folds 
noeljohn250: folds 
vjxbkf: folds 
Naebushkin: raises $6 to $12
iviz21: calls $6
*** FLOP *** [Qs 5c Ts]
Naebushkin: checks 
iviz21: bets $18
Naebushkin: calls $18
*** TURN *** [Qs 5c Ts] [Ks]
Naebushkin: checks 
iviz21: checks 
*** RIVER *** [Qs 5c Ts Ks] [6d]
Naebushkin: checks 
iviz21: checks 
*** SHOW DOWN ***
Naebushkin: shows [Jc Qc] (a pair of Queens)
iviz21: mucks hand 
Naebushkin collected $57.30 from pot
*** SUMMARY ***
Total pot $60 | Rake $2.70 
Board [Qs 5c Ts Ks 6d]
Seat 1: noeljohn250 folded before Flop (didn't bet)
Seat 2: vjxbkf (button) folded before Flop (didn't bet)
Seat 3: Naebushkin (small blind) showed [Jc Qc] and won ($57.30) with a pair of Queens
Seat 4: iviz21 (big blind) mucked
Seat 5: king10clubs folded before Flop (didn't bet)


PokerStars Game #102594210303:  Hold'em No Limit ($3/$6 USD) - 2013/08/11 3:01:58 ET
Table 'Hakone VI 40-100 bb' 6-max Seat #3 is the button
Seat 1: noeljohn250 ($245.65 in chips) 
Seat 2: vjxbkf ($761.78 in chips) 
Seat 3: Naebushkin ($655.80 in chips) 
Seat 4: iviz21 ($159 in chips) 
Seat 5: king10clubs ($633.28 in chips) 
iviz21: posts small blind $3
king10clubs: posts big blind $6
*** HOLE CARDS ***
noeljohn250: raises $12 to $18
vjxbkf: folds 
Naebushkin: folds 
iviz21: raises $12 to $30
king10clubs: folds 
noeljohn250: calls $12
*** FLOP *** [Ks 6c Td]
iviz21: bets $30
noeljohn250: calls $30
*** TURN *** [Ks 6c Td] [2c]
iviz21: bets $99 and is all-in
noeljohn250: calls $99
*** RIVER *** [Ks 6c Td 2c] [3d]
*** SHOW DOWN ***
iviz21: shows [Kc As] (a pair of Kings)
noeljohn250: shows [Qh Kd] (a pair of Kings - lower kicker)
iviz21 collected $321.20 from pot
*** SUMMARY ***
Total pot $324 | Rake $2.80 
Board [Ks 6c Td 2c 3d]
Seat 1: noeljohn250 showed [Qh Kd] and lost with a pair of Kings
Seat 2: vjxbkf folded before Flop (didn't bet)
Seat 3: Naebushkin (button) folded before Flop (didn't bet)
Seat 4: iviz21 (small blind) showed [Kc As] and won ($321.20) with a pair of Kings
Seat 5: king10clubs (big blind) folded before Flop


PokerStars Game #102594221935:  Hold'em No Limit ($3/$6 USD) - 2013/08/11 3:02:41 ET
Table 'Hakone VI 40-100 bb' 6-max Seat #4 is the button
Seat 1: noeljohn250 ($86.65 in chips) 
Seat 2: vjxbkf ($761.78 in chips) 
Seat 3: Naebushkin ($655.80 in chips) 
Seat 4: iviz21 ($321.20 in chips) 
Seat 5: king10clubs ($627.28 in chips) 
Seat 6: NutPopper ($240 in chips) 
king10clubs: posts small blind $3
NutPopper: posts big blind $6
*** HOLE CARDS ***
noeljohn250: folds 
vjxbkf: folds 
Naebushkin: folds 
iviz21: raises $6 to $12
king10clubs: folds 
NutPopper: folds 
Uncalled bet ($6) returned to iviz21
iviz21 collected $15 from pot
*** SUMMARY ***
Total pot $15 | Rake $0 
Seat 1: noeljohn250 folded before Flop (didn't bet)
Seat 2: vjxbkf folded before Flop (didn't bet)
Seat 3: Naebushkin folded before Flop (didn't bet)
Seat 4: iviz21 (button) collected ($15)
Seat 5: king10clubs (small blind) folded before Flop
Seat 6: NutPopper (big blind) folded before Flop


PokerStars Game #102594229245:  Hold'em No Limit ($3/$6 USD) - 2013/08/11 3:03:09 ET
Table 'Hakone VI 40-100 bb' 6-max Seat #5 is the button
Seat 1: noeljohn250 ($86.65 in chips) 
Seat 2: vjxbkf ($761.78 in chips) 
Seat 3: Naebushkin ($655.80 in chips) 
Seat 4: iviz21 ($330.20 in chips) 
Seat 5: king10clubs ($624.28 in chips) 
Seat 6: NutPopper ($234 in chips) 
NutPopper: posts small blind $3
noeljohn250: posts big blind $6
*** HOLE CARDS ***
vjxbkf: raises $15 to $21
Naebushkin: folds 
iviz21: folds 
king10clubs: folds 
NutPopper: folds 
noeljohn250: calls $15
*** FLOP *** [3s Qh Ah]
noeljohn250: checks 
vjxbkf: checks 
*** TURN *** [3s Qh Ah] [4s]
noeljohn250: bets $12
vjxbkf: calls $12
*** RIVER *** [3s Qh Ah 4s] [5c]
noeljohn250: checks 
vjxbkf: bets $728.78 and is all-in
noeljohn250: calls $53.65 and is all-in
Uncalled bet ($675.13) returned to vjxbkf
*** SHOW DOWN ***
vjxbkf: shows [As Qd] (two pair, Aces and Queens)
noeljohn250: shows [Qs Jc] (a pair of Queens)
vjxbkf collected $173.50 from pot
*** SUMMARY ***
Total pot $176.30 | Rake $2.80 
Board [3s Qh Ah 4s 5c]
Seat 1: noeljohn250 (big blind) showed [Qs Jc] and lost with a pair of Queens
Seat 2: vjxbkf showed [As Qd] and won ($173.50) with two pair, Aces and Queens
Seat 3: Naebushkin folded before Flop (didn't bet)
Seat 4: iviz21 folded before Flop (didn't bet)
Seat 5: king10clubs (button) folded before Flop (didn't bet)
Seat 6: NutPopper (small blind) folded before Flop


PokerStars Game #102594255712:  Hold'em No Limit ($3/$6 USD) - 2013/08/11 3:04:43 ET
Table 'Hakone VI 40-100 bb' 6-max Seat #6 is the button
Seat 1: noeljohn250 ($240 in chips) 
Seat 2: vjxbkf ($848.63 in chips) 
Seat 3: Naebushkin ($655.80 in chips) 
Seat 4: iviz21 ($330.20 in chips) 
Seat 5: king10clubs ($624.28 in chips) 
Seat 6: NutPopper ($231 in chips) 
noeljohn250: posts small blind $3
vjxbkf: posts big blind $6
*** HOLE CARDS ***
Naebushkin: raises $12 to $18
iviz21: folds 
king10clubs: folds 
NutPopper: folds 
noeljohn250: raises $36 to $54
vjxbkf: folds 
Naebushkin: raises $57 to $111
noeljohn250: raises $129 to $240 and is all-in
Naebushkin: calls $129
*** FLOP *** [7c 8s 8d]
*** TURN *** [7c 8s 8d] [4s]
*** RIVER *** [7c 8s 8d 4s] [2d]
*** SHOW DOWN ***
noeljohn250: shows [Ac Kh] (a pair of Eights)
Naebushkin: shows [As Ah] (two pair, Aces and Eights)
Naebushkin collected $483.20 from pot
*** SUMMARY ***
Total pot $486 | Rake $2.80 
Board [7c 8s 8d 4s 2d]
Seat 1: noeljohn250 (small blind) showed [Ac Kh] and lost with a pair of Eights
Seat 2: vjxbkf (big blind) folded before Flop
Seat 3: Naebushkin showed [As Ah] and won ($483.20) with two pair, Aces and Eights
Seat 4: iviz21 folded before Flop (didn't bet)
Seat 5: king10clubs folded before Flop (didn't bet)
Seat 6: NutPopper (button) folded before Flop (didn't bet)


PokerStars Game #102594130831:  Hold'em No Limit ($3/$6 USD) - 2013/08/11 2:56:10 ET
Table 'Hakone VI 40-100 bb' 6-max Seat #5 is the button
Seat 2: vjxbkf ($757 in chips) 
Seat 5: king10clubs ($600 in chips) 
king10clubs: posts small blind $3
vjxbkf: posts big blind $6
*** HOLE CARDS ***
king10clubs: raises $6 to $12
vjxbkf: folds 
Uncalled bet ($6) returned to king10clubs
king10clubs collected $12 from pot
king10clubs: doesn't show hand 
*** SUMMARY ***
Total pot $12 | Rake $0 
Seat 2: vjxbkf (big blind) folded before Flop
Seat 5: king10clubs (button) (small blind) collected ($12)


PokerStars Game #102594132479:  Hold'em No Limit ($3/$6 USD) - 2013/08/11 2:56:18 ET
Table 'Hakone VI 40-100 bb' 6-max Seat #2 is the button
Seat 2: vjxbkf ($751 in chips) 
Seat 5: king10clubs ($606 in chips) 
vjxbkf: posts small blind $3
king10clubs: posts big blind $6
*** HOLE CARDS ***
vjxbkf: raises $6 to $12
king10clubs: folds 
Uncalled bet ($6) returned to vjxbkf
vjxbkf collected $12 from pot
vjxbkf: doesn't show hand 
*** SUMMARY ***
Total pot $12 | Rake $0 
Seat 2: vjxbkf (button) (small blind) collected ($12)
Seat 5: king10clubs (big blind) folded before Flop


PokerStars Game #102594135194:  Hold'em No Limit ($3/$6 USD) - 2013/08/11 2:56:31 ET
Table 'Hakone VI 40-100 bb' 6-max Seat #5 is the button
Seat 2: vjxbkf ($757 in chips) 
Seat 5: king10clubs ($600 in chips) 
king10clubs: posts small blind $3
vjxbkf: posts big blind $6
*** HOLE CARDS ***
king10clubs: raises $6 to $12
vjxbkf: folds 
Uncalled bet ($6) returned to king10clubs
king10clubs collected $12 from pot
king10clubs: doesn't show hand 
*** SUMMARY ***
Total pot $12 | Rake $0 
Seat 2: vjxbkf (big blind) folded before Flop
Seat 5: king10clubs (button) (small blind) collected ($12)


PokerStars Game #102594137329:  Hold'em No Limit ($3/$6 USD) - 2013/08/11 2:56:41 ET
Table 'Hakone VI 40-100 bb' 6-max Seat #2 is the button
Seat 2: vjxbkf ($751 in chips) 
Seat 5: king10clubs ($606 in chips) 
vjxbkf: posts small blind $3
king10clubs: posts big blind $6
*** HOLE CARDS ***
vjxbkf: raises $6 to $12
king10clubs: folds 
Uncalled bet ($6) returned to vjxbkf
noeljohn250 joins the table at seat #1 
vjxbkf collected $12 from pot
vjxbkf: doesn't show hand 
*** SUMMARY ***
Total pot $12 | Rake $0 
Seat 2: vjxbkf (button) (small blind) collected ($12)
Seat 5: king10clubs (big blind) folded before Flop


PokerStars Game #102594638246:  Hold'em No Limit ($3/$6 USD) - 2013/08/11 3:25:32 ET
Table 'Hakone VI 40-100 bb' 6-max Seat #3 is the button
Seat 1: leo 32824 ($459.65 in chips) 
Seat 2: vjxbkf ($846.47 in chips) 
Seat 3: checkitout12 ($254.08 in chips) 
Seat 4: iviz21 ($268.36 in chips) 
Seat 5: king10clubs ($656.33 in chips) 
Seat 6: NutPopper ($223.16 in chips) 
iviz21: posts small blind $3
king10clubs: posts big blind $6
*** HOLE CARDS ***
NutPopper: raises $6 to $12
leo 32824: folds 
vjxbkf: folds 
checkitout12: folds 
iviz21: folds 
king10clubs: raises $30 to $42
NutPopper: folds 
Uncalled bet ($30) returned to king10clubs
king10clubs collected $27 from pot
king10clubs: doesn't show hand 
*** SUMMARY ***
Total pot $27 | Rake $0 
Seat 1: leo 32824 folded before Flop (didn't bet)
Seat 2: vjxbkf folded before Flop (didn't bet)
Seat 3: checkitout12 (button) folded before Flop (didn't bet)
Seat 4: iviz21 (small blind) folded before Flop
Seat 5: king10clubs (big blind) collected ($27)
Seat 6: NutPopper folded before Flop


PokerStars Game #102594647628:  Hold'em No Limit ($3/$6 USD) - 2013/08/11 3:26:00 ET
Table 'Hakone VI 40-100 bb' 6-max Seat #4 is the button
Seat 1: leo 32824 ($459.65 in chips) 
Seat 2: vjxbkf ($846.47 in chips) 
Seat 3: checkitout12 ($254.08 in chips) 
Seat 4: iviz21 ($265.36 in chips) 
Seat 5: king10clubs ($671.33 in chips) 
Seat 6: NutPopper ($211.16 in chips) 
king10clubs: posts small blind $3
NutPopper: posts big blind $6
*** HOLE CARDS ***
leo 32824: raises $6 to $12
vjxbkf: folds 
checkitout12: folds 
iviz21: folds 
king10clubs: folds 
NutPopper: folds 
Uncalled bet ($6) returned to leo 32824
leo 32824 collected $15 from pot
*** SUMMARY ***
Total pot $15 | Rake $0 
Seat 1: leo 32824 collected ($15)
Seat 2: vjxbkf folded before Flop (didn't bet)
Seat 3: checkitout12 folded before Flop (didn't bet)
Seat 4: iviz21 (button) folded before Flop (didn't bet)
Seat 5: king10clubs (small blind) folded before Flop
Seat 6: NutPopper (big blind) folded before Flop


PokerStars Game #102594666036:  Hold'em No Limit ($3/$6 USD) - 2013/08/11 3:26:55 ET
Table 'Hakone VI 40-100 bb' 6-max Seat #5 is the button
Seat 1: leo 32824 ($468.65 in chips) 
Seat 2: vjxbkf ($846.47 in chips) 
Seat 3: checkitout12 ($254.08 in chips) 
Seat 4: iviz21 ($265.36 in chips) 
Seat 5: king10clubs ($668.33 in chips) 
Seat 6: NutPopper ($205.16 in chips) 
NutPopper: posts small blind $3
leo 32824: posts big blind $6
*** HOLE CARDS ***
vjxbkf: folds 
checkitout12: raises $6.18 to $12.18
iviz21: calls $12.18
king10clubs: folds 
NutPopper: folds 
leo 32824: folds 
*** FLOP *** [7d Ad 5d]
checkitout12: bets $22.30
iviz21: folds 
Uncalled bet ($22.30) returned to checkitout12
checkitout12 collected $31.86 from pot
checkitout12: doesn't show hand 
*** SUMMARY ***
Total pot $33.36 | Rake $1.50 
Board [7d Ad 5d]
Seat 1: leo 32824 (big blind) folded before Flop
Seat 2: vjxbkf folded before Flop (didn't bet)
Seat 3: checkitout12 collected ($31.86)
Seat 4: iviz21 folded on the Flop
Seat 5: king10clubs (button) folded before Flop (didn't bet)
Seat 6: NutPopper (small blind) folded before Flop


PokerStars Game #102594683992:  Hold'em No Limit ($3/$6 USD) - 2013/08/11 3:27:49 ET
Table 'Hakone VI 40-100 bb' 6-max Seat #6 is the button
Seat 1: leo 32824 ($462.65 in chips) 
Seat 2: vjxbkf ($846.47 in chips) 
Seat 3: checkitout12 ($273.76 in chips) 
Seat 4: iviz21 ($253.18 in chips) 
Seat 5: king10clubs ($668.33 in chips) 
Seat 6: NutPopper ($202.16 in chips) 
leo 32824: posts small blind $3
vjxbkf: posts big blind $6
*** HOLE CARDS ***
checkitout12: folds 
iviz21: calls $6
king10clubs: raises $12 to $18
NutPopper: folds 
leo 32824: folds 
vjxbkf: folds 
iviz21: calls $12
*** FLOP *** [3c 6d 8h]
iviz21: bets $24
king10clubs: calls $24
*** TURN *** [3c 6d 8h] [3d]
iviz21: checks 
king10clubs: checks 
*** RIVER *** [3c 6d 8h 3d] [4c]
iviz21: checks 
king10clubs: bets $48
iviz21: folds 
Uncalled bet ($48) returned to king10clubs
king10clubs collected $90.20 from pot
king10clubs: doesn't show hand 
*** SUMMARY ***
Total pot $93 | Rake $2.80 
Board [3c 6d 8h 3d 4c]
Seat 1: leo 32824 (small blind) folded before Flop
Seat 2: vjxbkf (big blind) folded before Flop
Seat 3: checkitout12 folded before Flop (didn't bet)
Seat 4: iviz21 folded on the River
Seat 5: king10clubs collected ($90.20)
Seat 6: NutPopper (button) folded before Flop (didn't bet)


PokerStars Game #102594710365:  Hold'em No Limit ($3/$6 USD) - 2013/08/11 3:29:09 ET
Table 'Hakone VI 40-100 bb' 6-max Seat #1 is the button
Seat 1: leo 32824 ($459.65 in chips) 
Seat 2: vjxbkf ($840.47 in chips) 
Seat 3: checkitout12 ($273.76 in chips) 
Seat 4: iviz21 ($211.18 in chips) 
Seat 5: king10clubs ($716.53 in chips) 
Seat 6: NutPopper ($202.16 in chips) 
vjxbkf: posts small blind $3
checkitout12: posts big blind $6
*** HOLE CARDS ***
iviz21: folds 
king10clubs: folds 
NutPopper: folds 
leo 32824: raises $6 to $12
vjxbkf: folds 
checkitout12: calls $6
*** FLOP *** [5c 8s 2s]
checkitout12: checks 
leo 32824: bets $18
checkitout12: folds 
Uncalled bet ($18) returned to leo 32824
leo 32824 collected $25.78 from pot
*** SUMMARY ***
Total pot $27 | Rake $1.22 
Board [5c 8s 2s]
Seat 1: leo 32824 (button) collected ($25.78)
Seat 2: vjxbkf (small blind) folded before Flop
Seat 3: checkitout12 (big blind) folded on the Flop
Seat 4: iviz21 folded before Flop (didn't bet)
Seat 5: king10clubs folded before Flop (didn't bet)
Seat 6: NutPopper folded before Flop (didn't bet)


PokerStars Game #102594533668:  Hold'em No Limit ($3/$6 USD) - 2013/08/11 3:20:10 ET
Table 'Hakone VI 40-100 bb' 6-max Seat #5 is the button
Seat 1: leo 32824 ($501.65 in chips) 
Seat 2: vjxbkf ($821.63 in chips) 
Seat 3: Naebushkin ($926.98 in chips) 
Seat 4: iviz21 ($271.54 in chips) 
Seat 5: king10clubs ($635.13 in chips) 
Seat 6: NutPopper ($253.16 in chips) 
NutPopper: posts small blind $3
leo 32824: posts big blind $6
*** HOLE CARDS ***
vjxbkf: raises $15 to $21
Naebushkin: folds 
iviz21: folds 
king10clubs: folds 
NutPopper: calls $18
leo 32824: folds 
*** FLOP *** [Td Qh 8h]
NutPopper: checks 
vjxbkf: bets $23
NutPopper: folds 
Uncalled bet ($23) returned to vjxbkf
vjxbkf collected $45.84 from pot
vjxbkf: doesn't show hand 
*** SUMMARY ***
Total pot $48 | Rake $2.16 
Board [Td Qh 8h]
Seat 1: leo 32824 (big blind) folded before Flop
Seat 2: vjxbkf collected ($45.84)
Seat 3: Naebushkin folded before Flop (didn't bet)
Seat 4: iviz21 folded before Flop (didn't bet)
Seat 5: king10clubs (button) folded before Flop (didn't bet)
Seat 6: NutPopper (small blind) folded on the Flop


PokerStars Game #102594557238:  Hold'em No Limit ($3/$6 USD) - 2013/08/11 3:21:26 ET
Table 'Hakone VI 40-100 bb' 6-max Seat #6 is the button
Seat 1: leo 32824 ($495.65 in chips) 
Seat 2: vjxbkf ($846.47 in chips) 
Seat 3: Naebushkin ($926.98 in chips) 
Seat 4: iviz21 ($271.54 in chips) 
Seat 5: king10clubs ($635.13 in chips) 
Seat 6: NutPopper ($232.16 in chips) 
leo 32824: posts small blind $3
vjxbkf: posts big blind $6
*** HOLE CARDS ***
Naebushkin: raises $12 to $18
iviz21: folds 
king10clubs: folds 
NutPopper: folds 
leo 32824: folds 
vjxbkf: folds 
Uncalled bet ($12) returned to Naebushkin
Naebushkin collected $15 from pot
Naebushkin: doesn't show hand 
*** SUMMARY ***
Total pot $15 | Rake $0 
Seat 1: leo 32824 (small blind) folded before Flop
Seat 2: vjxbkf (big blind) folded before Flop
Seat 3: Naebushkin collected ($15)
Seat 4: iviz21 folded before Flop (didn't bet)
Seat 5: king10clubs folded before Flop (didn't bet)
Seat 6: NutPopper (button) folded before Flop (didn't bet)


PokerStars Game #102594565658:  Hold'em No Limit ($3/$6 USD) - 2013/08/11 3:21:52 ET
Table 'Hakone VI 40-100 bb' 6-max Seat #1 is the button
Seat 1: leo 32824 ($492.65 in chips) 
Seat 2: vjxbkf ($840.47 in chips) 
Seat 4: iviz21 ($271.54 in chips) 
Seat 5: king10clubs ($635.13 in chips) 
Seat 6: NutPopper ($232.16 in chips) 
vjxbkf: posts small blind $3
Naebushkin: is sitting out 
iviz21: posts big blind $6
*** HOLE CARDS ***
Naebushkin leaves the table
king10clubs: folds 
NutPopper: folds 
leo 32824: folds 
vjxbkf: folds 
Uncalled bet ($3) returned to iviz21
iviz21 collected $6 from pot
*** SUMMARY ***
Total pot $6 | Rake $0 
Seat 1: leo 32824 (button) folded before Flop (didn't bet)
Seat 2: vjxbkf (small blind) folded before Flop
Seat 4: iviz21 (big blind) collected ($6)
Seat 5: king10clubs folded before Flop (didn't bet)
Seat 6: NutPopper folded before Flop (didn't bet)


PokerStars Game #102594571512:  Hold'em No Limit ($3/$6 USD) - 2013/08/11 3:22:08 ET
Table 'Hakone VI 40-100 bb' 6-max Seat #2 is the button
Seat 1: leo 32824 ($492.65 in chips) 
Seat 2: vjxbkf ($837.47 in chips) 
Seat 4: iviz21 ($274.54 in chips) 
Seat 5: king10clubs ($635.13 in chips) 
Seat 6: NutPopper ($232.16 in chips) 
iviz21: posts small blind $3
king10clubs: posts big blind $6
*** HOLE CARDS ***
NutPopper: folds 
leo 32824: folds 
vjxbkf: raises $6 to $12
iviz21: folds 
king10clubs: folds 
Uncalled bet ($6) returned to vjxbkf
vjxbkf collected $15 from pot
vjxbkf: doesn't show hand 
*** SUMMARY ***
Total pot $15 | Rake $0 
Seat 1: leo 32824 folded before Flop (didn't bet)
Seat 2: vjxbkf (button) collected ($15)
Seat 4: iviz21 (small blind) folded before Flop
Seat 5: king10clubs (big blind) folded before Flop
Seat 6: NutPopper folded before Flop (didn't bet)


PokerStars Game #102594578878:  Hold'em No Limit ($3/$6 USD) - 2013/08/11 3:22:32 ET
Table 'Hakone VI 40-100 bb' 6-max Seat #4 is the button
Seat 1: leo 32824 ($492.65 in chips) 
Seat 2: vjxbkf ($846.47 in chips) 
Seat 4: iviz21 ($271.54 in chips) 
Seat 5: king10clubs ($629.13 in chips) 
Seat 6: NutPopper ($232.16 in chips) 
king10clubs: posts small blind $3
NutPopper: posts big blind $6
*** HOLE CARDS ***
leo 32824: folds 
vjxbkf: raises $12 to $18
iviz21: folds 
king10clubs: folds 
NutPopper: folds 
Uncalled bet ($12) returned to vjxbkf
vjxbkf collected $15 from pot
vjxbkf: doesn't show hand 
*** SUMMARY ***
Total pot $15 | Rake $0 
Seat 1: leo 32824 folded before Flop (didn't bet)
Seat 2: vjxbkf collected ($15)
Seat 4: iviz21 (button) folded before Flop (didn't bet)
Seat 5: king10clubs (small blind) folded before Flop
Seat 6: NutPopper (big blind) folded before Flop


PokerStars Game #102594587396:  Hold'em No Limit ($3/$6 USD) - 2013/08/11 3:22:58 ET
Table 'Hakone VI 40-100 bb' 6-max Seat #5 is the button
Seat 1: leo 32824 ($492.65 in chips) 
Seat 2: vjxbkf ($855.47 in chips) 
Seat 4: iviz21 ($271.54 in chips) 
Seat 5: king10clubs ($626.13 in chips) 
Seat 6: NutPopper ($226.16 in chips) 
NutPopper: posts small blind $3
leo 32824: posts big blind $6
*** HOLE CARDS ***
vjxbkf: folds 
iviz21: folds 
king10clubs: raises $6 to $12
NutPopper: folds 
leo 32824: calls $6
*** FLOP *** [7h 8d Ac]
leo 32824: bets $18
checkitout12 joins the table at seat #3 
king10clubs: calls $18
*** TURN *** [7h 8d Ac] [Jd]
leo 32824: checks 
king10clubs: checks 
*** RIVER *** [7h 8d Ac Jd] [6s]
leo 32824: checks 
king10clubs: checks 
*** SHOW DOWN ***
leo 32824: shows [Tc Ks] (high card Ace)
king10clubs: shows [8c 5c] (a pair of Eights)
king10clubs collected $60.20 from pot
*** SUMMARY ***
Total pot $63 | Rake $2.80 
Board [7h 8d Ac Jd 6s]
Seat 1: leo 32824 (big blind) showed [Tc Ks] and lost with high card Ace
Seat 2: vjxbkf folded before Flop (didn't bet)
Seat 4: iviz21 folded before Flop (didn't bet)
Seat 5: king10clubs (button) showed [8c 5c] and won ($60.20) with a pair of Eights
Seat 6: NutPopper (small blind) folded before Flop


PokerStars Game #102594603851:  Hold'em No Limit ($3/$6 USD) - 2013/08/11 3:23:48 ET
Table 'Hakone VI 40-100 bb' 6-max Seat #6 is the button
Seat 1: leo 32824 ($462.65 in chips) 
Seat 2: vjxbkf ($855.47 in chips) 
Seat 4: iviz21 ($271.54 in chips) 
Seat 5: king10clubs ($656.33 in chips) 
Seat 6: NutPopper ($223.16 in chips) 
leo 32824: posts small blind $3
vjxbkf: posts big blind $6
checkitout12: sits out 
*** HOLE CARDS ***
iviz21: raises $6 to $12
king10clubs: folds 
NutPopper: folds 
leo 32824: folds 
vjxbkf: folds 
Uncalled bet ($6) returned to iviz21
iviz21 collected $15 from pot
*** SUMMARY ***
Total pot $15 | Rake $0 
Seat 1: leo 32824 (small blind) folded before Flop
Seat 2: vjxbkf (big blind) folded before Flop
Seat 4: iviz21 collected ($15)
Seat 5: king10clubs folded before Flop (didn't bet)
Seat 6: NutPopper (button) folded before Flop (didn't bet)


PokerStars Game #102594613519:  Hold'em No Limit ($3/$6 USD) - 2013/08/11 3:24:17 ET
Table 'Hakone VI 40-100 bb' 6-max Seat #1 is the button
Seat 1: leo 32824 ($459.65 in chips) 
Seat 2: vjxbkf ($849.47 in chips) 
Seat 3: checkitout12 ($240 in chips) 
Seat 4: iviz21 ($280.54 in chips) 
Seat 5: king10clubs ($656.33 in chips) 
Seat 6: NutPopper ($223.16 in chips) 
vjxbkf: posts small blind $3
checkitout12: posts big blind $6
*** HOLE CARDS ***
iviz21: folds 
king10clubs: folds 
NutPopper: folds 
leo 32824: folds 
vjxbkf: folds 
Uncalled bet ($3) returned to checkitout12
checkitout12 collected $6 from pot
checkitout12: doesn't show hand 
*** SUMMARY ***
Total pot $6 | Rake $0 
Seat 1: leo 32824 (button) folded before Flop (didn't bet)
Seat 2: vjxbkf (small blind) folded before Flop
Seat 3: checkitout12 (big blind) collected ($6)
Seat 4: iviz21 folded before Flop (didn't bet)
Seat 5: king10clubs folded before Flop (didn't bet)
Seat 6: NutPopper folded before Flop (didn't bet)


PokerStars Game #102594620109:  Hold'em No Limit ($3/$6 USD) - 2013/08/11 3:24:37 ET
Table 'Hakone VI 40-100 bb' 6-max Seat #2 is the button
Seat 1: leo 32824 ($459.65 in chips) 
Seat 2: vjxbkf ($846.47 in chips) 
Seat 3: checkitout12 ($243 in chips) 
Seat 4: iviz21 ($280.54 in chips) 
Seat 5: king10clubs ($656.33 in chips) 
Seat 6: NutPopper ($223.16 in chips) 
checkitout12: posts small blind $3
iviz21: posts big blind $6
*** HOLE CARDS ***
king10clubs: folds 
NutPopper: folds 
leo 32824: folds 
vjxbkf: folds 
checkitout12: raises $6.18 to $12.18
iviz21: calls $6.18
*** FLOP *** [Qh 4d 7d]
checkitout12: bets $16.28
iviz21: folds 
Uncalled bet ($16.28) returned to checkitout12
checkitout12 collected $23.26 from pot
checkitout12: doesn't show hand 
*** SUMMARY ***
Total pot $24.36 | Rake $1.10 
Board [Qh 4d 7d]
Seat 1: leo 32824 folded before Flop (didn't bet)
Seat 2: vjxbkf (button) folded before Flop (didn't bet)
Seat 3: checkitout12 (small blind) collected ($23.26)
Seat 4: iviz21 (big blind) folded on the Flop
Seat 5: king10clubs folded before Flop (didn't bet)
Seat 6: NutPopper folded before Flop (didn't bet)


PokerStars Game #102594438504:  Hold'em No Limit ($3/$6 USD) - 2013/08/11 3:15:03 ET
Table 'Hakone VI 40-100 bb' 6-max Seat #2 is the button
Seat 1: leo 32824 ($501.65 in chips) 
Seat 2: vjxbkf ($812.63 in chips) 
Seat 3: Naebushkin ($905 in chips) 
Seat 4: iviz21 ($271.34 in chips) 
Seat 5: king10clubs ($701.13 in chips) 
Seat 6: NutPopper ($225.19 in chips) 
Naebushkin: posts small blind $3
iviz21: posts big blind $6
*** HOLE CARDS ***
king10clubs: folds 
NutPopper: folds 
leo 32824: folds 
vjxbkf: raises $6 to $12
Naebushkin: folds 
iviz21: folds 
Uncalled bet ($6) returned to vjxbkf
vjxbkf collected $15 from pot
vjxbkf: doesn't show hand 
*** SUMMARY ***
Total pot $15 | Rake $0 
Seat 1: leo 32824 folded before Flop (didn't bet)
Seat 2: vjxbkf (button) collected ($15)
Seat 3: Naebushkin (small blind) folded before Flop
Seat 4: iviz21 (big blind) folded before Flop
Seat 5: king10clubs folded before Flop (didn't bet)
Seat 6: NutPopper folded before Flop (didn't bet)


PokerStars Game #102594446186:  Hold'em No Limit ($3/$6 USD) - 2013/08/11 3:15:28 ET
Table 'Hakone VI 40-100 bb' 6-max Seat #3 is the button
Seat 1: leo 32824 ($501.65 in chips) 
Seat 2: vjxbkf ($821.63 in chips) 
Seat 3: Naebushkin ($902 in chips) 
Seat 4: iviz21 ($265.34 in chips) 
Seat 5: king10clubs ($701.13 in chips) 
Seat 6: NutPopper ($225.19 in chips) 
iviz21: posts small blind $3
king10clubs: posts big blind $6
*** HOLE CARDS ***
NutPopper: folds 
leo 32824: folds 
vjxbkf: raises $9 to $15
Naebushkin: folds 
iviz21: folds 
king10clubs: folds 
Uncalled bet ($9) returned to vjxbkf
vjxbkf collected $15 from pot
vjxbkf: doesn't show hand 
*** SUMMARY ***
Total pot $15 | Rake $0 
Seat 1: leo 32824 folded before Flop (didn't bet)
Seat 2: vjxbkf collected ($15)
Seat 3: Naebushkin (button) folded before Flop (didn't bet)
Seat 4: iviz21 (small blind) folded before Flop
Seat 5: king10clubs (big blind) folded before Flop
Seat 6: NutPopper folded before Flop (didn't bet)


PokerStars Game #102594452793:  Hold'em No Limit ($3/$6 USD) - 2013/08/11 3:15:50 ET
Table 'Hakone VI 40-100 bb' 6-max Seat #4 is the button
Seat 1: leo 32824 ($501.65 in chips) 
Seat 2: vjxbkf ($830.63 in chips) 
Seat 3: Naebushkin ($902 in chips) 
Seat 4: iviz21 ($262.34 in chips) 
Seat 5: king10clubs ($695.13 in chips) 
Seat 6: NutPopper ($225.19 in chips) 
king10clubs: posts small blind $3
NutPopper: posts big blind $6
*** HOLE CARDS ***
leo 32824: folds 
vjxbkf: folds 
Naebushkin: folds 
iviz21: raises $6 to $12
king10clubs: folds 
NutPopper: calls $6
*** FLOP *** [6c 3s Jh]
NutPopper: checks 
iviz21: checks 
*** TURN *** [6c 3s Jh] [5d]
NutPopper: bets $18
iviz21: folds 
Uncalled bet ($18) returned to NutPopper
NutPopper collected $25.78 from pot
NutPopper: doesn't show hand 
*** SUMMARY ***
Total pot $27 | Rake $1.22 
Board [6c 3s Jh 5d]
Seat 1: leo 32824 folded before Flop (didn't bet)
Seat 2: vjxbkf folded before Flop (didn't bet)
Seat 3: Naebushkin folded before Flop (didn't bet)
Seat 4: iviz21 (button) folded on the Turn
Seat 5: king10clubs (small blind) folded before Flop
Seat 6: NutPopper (big blind) collected ($25.78)


PokerStars Game #102594464579:  Hold'em No Limit ($3/$6 USD) - 2013/08/11 3:16:28 ET
Table 'Hakone VI 40-100 bb' 6-max Seat #5 is the button
Seat 1: leo 32824 ($501.65 in chips) 
Seat 2: vjxbkf ($830.63 in chips) 
Seat 3: Naebushkin ($902 in chips) 
Seat 4: iviz21 ($250.34 in chips) 
Seat 5: king10clubs ($692.13 in chips) 
Seat 6: NutPopper ($238.97 in chips) 
NutPopper: posts small blind $3
leo 32824: posts big blind $6
*** HOLE CARDS ***
vjxbkf: folds 
Naebushkin: folds 
iviz21: calls $6
king10clubs: folds 
NutPopper: calls $3
leo 32824: checks 
*** FLOP *** [Js 5c 3c]
NutPopper: checks 
leo 32824: checks 
iviz21: checks 
*** TURN *** [Js 5c 3c] [2c]
NutPopper: bets $8
leo 32824: folds 
iviz21: folds 
Uncalled bet ($8) returned to NutPopper
NutPopper collected $17.19 from pot
NutPopper: doesn't show hand 
*** SUMMARY ***
Total pot $18 | Rake $0.81 
Board [Js 5c 3c 2c]
Seat 1: leo 32824 (big blind) folded on the Turn
Seat 2: vjxbkf folded before Flop (didn't bet)
Seat 3: Naebushkin folded before Flop (didn't bet)
Seat 4: iviz21 folded on the Turn
Seat 5: king10clubs (button) folded before Flop (didn't bet)
Seat 6: NutPopper (small blind) collected ($17.19)


PokerStars Game #102594483408:  Hold'em No Limit ($3/$6 USD) - 2013/08/11 3:17:29 ET
Table 'Hakone VI 40-100 bb' 6-max Seat #6 is the button
Seat 1: leo 32824 ($495.65 in chips) 
Seat 2: vjxbkf ($830.63 in chips) 
Seat 3: Naebushkin ($902 in chips) 
Seat 4: iviz21 ($244.34 in chips) 
Seat 5: king10clubs ($692.13 in chips) 
Seat 6: NutPopper ($250.16 in chips) 
leo 32824: posts small blind $3
vjxbkf: posts big blind $6
*** HOLE CARDS ***
Naebushkin is connected 
Naebushkin: raises $12 to $18
iviz21: folds 
king10clubs: calls $18
NutPopper: folds 
leo 32824: folds 
vjxbkf: folds 
*** FLOP *** [3s Ad Kh]
Naebushkin: bets $27
king10clubs: folds 
Uncalled bet ($27) returned to Naebushkin
Naebushkin collected $42.98 from pot
Naebushkin: doesn't show hand 
*** SUMMARY ***
Total pot $45 | Rake $2.02 
Board [3s Ad Kh]
Seat 1: leo 32824 (small blind) folded before Flop
Seat 2: vjxbkf (big blind) folded before Flop
Seat 3: Naebushkin collected ($42.98)
Seat 4: iviz21 folded before Flop (didn't bet)
Seat 5: king10clubs folded on the Flop
Seat 6: NutPopper (button) folded before Flop (didn't bet)


PokerStars Game #102594502245:  Hold'em No Limit ($3/$6 USD) - 2013/08/11 3:18:29 ET
Table 'Hakone VI 40-100 bb' 6-max Seat #1 is the button
Seat 1: leo 32824 ($492.65 in chips) 
Seat 2: vjxbkf ($824.63 in chips) 
Seat 3: Naebushkin ($926.98 in chips) 
Seat 4: iviz21 ($244.34 in chips) 
Seat 5: king10clubs ($674.13 in chips) 
Seat 6: NutPopper ($250.16 in chips) 
vjxbkf: posts small blind $3
Naebushkin: posts big blind $6
*** HOLE CARDS ***
iviz21: folds 
king10clubs: folds 
NutPopper: folds 
leo 32824: folds 
vjxbkf: folds 
Uncalled bet ($3) returned to Naebushkin
Naebushkin collected $6 from pot
Naebushkin: doesn't show hand 
*** SUMMARY ***
Total pot $6 | Rake $0 
Seat 1: leo 32824 (button) folded before Flop (didn't bet)
Seat 2: vjxbkf (small blind) folded before Flop
Seat 3: Naebushkin (big blind) collected ($6)
Seat 4: iviz21 folded before Flop (didn't bet)
Seat 5: king10clubs folded before Flop (didn't bet)
Seat 6: NutPopper folded before Flop (didn't bet)


PokerStars Game #102594509591:  Hold'em No Limit ($3/$6 USD) - 2013/08/11 3:18:53 ET
Table 'Hakone VI 40-100 bb' 6-max Seat #2 is the button
Seat 1: leo 32824 ($492.65 in chips) 
Seat 2: vjxbkf ($821.63 in chips) 
Seat 3: Naebushkin ($929.98 in chips) 
Seat 4: iviz21 ($244.34 in chips) 
Seat 5: king10clubs ($674.13 in chips) 
Seat 6: NutPopper ($250.16 in chips) 
Naebushkin: posts small blind $3
iviz21: posts big blind $6
*** HOLE CARDS ***
king10clubs: folds 
NutPopper: folds 
leo 32824: raises $9 to $15
vjxbkf: folds 
Naebushkin: folds 
iviz21: folds 
Uncalled bet ($9) returned to leo 32824
leo 32824 collected $15 from pot
*** SUMMARY ***
Total pot $15 | Rake $0 
Seat 1: leo 32824 collected ($15)
Seat 2: vjxbkf (button) folded before Flop (didn't bet)
Seat 3: Naebushkin (small blind) folded before Flop
Seat 4: iviz21 (big blind) folded before Flop
Seat 5: king10clubs folded before Flop (didn't bet)
Seat 6: NutPopper folded before Flop (didn't bet)


PokerStars Game #102594514979:  Hold'em No Limit ($3/$6 USD) - 2013/08/11 3:19:10 ET
Table 'Hakone VI 40-100 bb' 6-max Seat #3 is the button
Seat 1: leo 32824 ($501.65 in chips) 
Seat 2: vjxbkf ($821.63 in chips) 
Seat 3: Naebushkin ($926.98 in chips) 
Seat 4: iviz21 ($238.34 in chips) 
Seat 5: king10clubs ($674.13 in chips) 
Seat 6: NutPopper ($250.16 in chips) 
iviz21: posts small blind $3
king10clubs: posts big blind $6
*** HOLE CARDS ***
NutPopper: folds 
leo 32824: folds 
vjxbkf: folds 
Naebushkin: folds 
iviz21: raises $6 to $12
king10clubs: calls $6
*** FLOP *** [Qs 3d 5c]
iviz21: bets $24
king10clubs: calls $24
*** TURN *** [Qs 3d 5c] [8d]
iviz21: checks 
king10clubs: checks 
*** RIVER *** [Qs 3d 5c 8d] [Th]
iviz21: bets $24
king10clubs: folds 
Uncalled bet ($24) returned to iviz21
iviz21 collected $69.20 from pot
iviz21: doesn't show hand 
*** SUMMARY ***
Total pot $72 | Rake $2.80 
Board [Qs 3d 5c 8d Th]
Seat 1: leo 32824 folded before Flop (didn't bet)
Seat 2: vjxbkf folded before Flop (didn't bet)
Seat 3: Naebushkin (button) folded before Flop (didn't bet)
Seat 4: iviz21 (small blind) collected ($69.20)
Seat 5: king10clubs (big blind) folded on the River
Seat 6: NutPopper folded before Flop (didn't bet)


PokerStars Game #102594529545:  Hold'em No Limit ($3/$6 USD) - 2013/08/11 3:19:57 ET
Table 'Hakone VI 40-100 bb' 6-max Seat #4 is the button
Seat 1: leo 32824 ($501.65 in chips) 
Seat 2: vjxbkf ($821.63 in chips) 
Seat 3: Naebushkin ($926.98 in chips) 
Seat 4: iviz21 ($271.54 in chips) 
Seat 5: king10clubs ($638.13 in chips) 
Seat 6: NutPopper ($250.16 in chips) 
king10clubs: posts small blind $3
NutPopper: posts big blind $6
*** HOLE CARDS ***
leo 32824: folds 
vjxbkf: folds 
Naebushkin: folds 
iviz21: folds 
king10clubs: folds 
Uncalled bet ($3) returned to NutPopper
NutPopper collected $6 from pot
NutPopper: doesn't show hand 
*** SUMMARY ***
Total pot $6 | Rake $0 
Seat 1: leo 32824 folded before Flop (didn't bet)
Seat 2: vjxbkf folded before Flop (didn't bet)
Seat 3: Naebushkin folded before Flop (didn't bet)
Seat 4: iviz21 (button) folded before Flop (didn't bet)
Seat 5: king10clubs (small blind) folded before Flop
Seat 6: NutPopper (big blind) collected ($6)


PokerStars Game #102594934632:  Hold'em No Limit ($3/$6 USD) - 2013/08/11 3:40:11 ET
Table 'Hakone VI 40-100 bb' 6-max Seat #6 is the button
Seat 1: leo 32824 ($410.43 in chips) 
Seat 2: vjxbkf ($807.47 in chips) 
Seat 3: checkitout12 ($249.58 in chips) 
Seat 4: iviz21 ($232.51 in chips) 
Seat 5: king10clubs ($994.29 in chips) 
Seat 6: NutPopper ($237 in chips) 
leo 32824: posts small blind $3
vjxbkf: posts big blind $6
*** HOLE CARDS ***
checkitout12: raises $6.18 to $12.18
iviz21: folds 
king10clubs: raises $23.82 to $36
NutPopper: folds 
leo 32824: calls $33
vjxbkf: folds 
checkitout12: calls $23.82
*** FLOP *** [6h 9d 9c]
leo 32824: checks 
checkitout12: checks 
king10clubs: checks 
*** TURN *** [6h 9d 9c] [4h]
leo 32824: checks 
checkitout12: checks 
king10clubs: checks 
*** RIVER *** [6h 9d 9c 4h] [8d]
leo 32824: checks 
checkitout12: checks 
king10clubs: checks 
*** SHOW DOWN ***
leo 32824: shows [Ts Th] (two pair, Tens and Nines)
checkitout12: mucks hand 
king10clubs: mucks hand 
leo 32824 collected $111.20 from pot
*** SUMMARY ***
Total pot $114 | Rake $2.80 
Board [6h 9d 9c 4h 8d]
Seat 1: leo 32824 (small blind) showed [Ts Th] and won ($111.20) with two pair, Tens and Nines
Seat 2: vjxbkf (big blind) folded before Flop
Seat 3: checkitout12 mucked
Seat 4: iviz21 folded before Flop (didn't bet)
Seat 5: king10clubs mucked
Seat 6: NutPopper (button) folded before Flop (didn't bet)


PokerStars Game #102594973668:  Hold'em No Limit ($3/$6 USD) - 2013/08/11 3:42:03 ET
Table 'Hakone VI 40-100 bb' 6-max Seat #1 is the button
Seat 1: leo 32824 ($485.63 in chips) 
Seat 2: vjxbkf ($801.47 in chips) 
Seat 3: checkitout12 ($240 in chips) 
Seat 4: iviz21 ($232.51 in chips) 
Seat 5: king10clubs ($958.29 in chips) 
Seat 6: NutPopper ($237 in chips) 
vjxbkf: posts small blind $3
checkitout12: posts big blind $6
*** HOLE CARDS ***
iviz21: folds 
king10clubs: folds 
NutPopper: folds 
leo 32824: folds 
vjxbkf: raises $12 to $18
checkitout12: folds 
Uncalled bet ($12) returned to vjxbkf
vjxbkf collected $12 from pot
vjxbkf: doesn't show hand 
*** SUMMARY ***
Total pot $12 | Rake $0 
Seat 1: leo 32824 (button) folded before Flop (didn't bet)
Seat 2: vjxbkf (small blind) collected ($12)
Seat 3: checkitout12 (big blind) folded before Flop
Seat 4: iviz21 folded before Flop (didn't bet)
Seat 5: king10clubs folded before Flop (didn't bet)
Seat 6: NutPopper folded before Flop (didn't bet)


PokerStars Game #102594984202:  Hold'em No Limit ($3/$6 USD) - 2013/08/11 3:42:33 ET
Table 'Hakone VI 40-100 bb' 6-max Seat #2 is the button
Seat 1: leo 32824 ($485.63 in chips) 
Seat 2: vjxbkf ($807.47 in chips) 
Seat 3: checkitout12 ($240 in chips) 
Seat 4: iviz21 ($232.51 in chips) 
Seat 5: king10clubs ($958.29 in chips) 
Seat 6: NutPopper ($237 in chips) 
checkitout12: posts small blind $3
iviz21: posts big blind $6
*** HOLE CARDS ***
king10clubs: folds 
NutPopper: folds 
leo 32824: raises $6 to $12
vjxbkf: folds 
checkitout12: raises $18.60 to $30.60
iviz21: folds 
leo 32824: calls $18.60
*** FLOP *** [2d Td Js]
checkitout12: bets $25.76
leo 32824: calls $25.76
*** TURN *** [2d Td Js] [4h]
checkitout12: checks 
leo 32824: checks 
*** RIVER *** [2d Td Js 4h] [Ah]
checkitout12: checks 
leo 32824: checks 
*** SHOW DOWN ***
checkitout12: shows [5s Ad] (a pair of Aces)
leo 32824: mucks hand 
checkitout12 collected $115.92 from pot
*** SUMMARY ***
Total pot $118.72 | Rake $2.80 
Board [2d Td Js 4h Ah]
Seat 1: leo 32824 mucked
Seat 2: vjxbkf (button) folded before Flop (didn't bet)
Seat 3: checkitout12 (small blind) showed [5s Ad] and won ($115.92) with a pair of Aces
Seat 4: iviz21 (big blind) folded before Flop
Seat 5: king10clubs folded before Flop (didn't bet)
Seat 6: NutPopper folded before Flop (didn't bet)


PokerStars Game #102595007881:  Hold'em No Limit ($3/$6 USD) - 2013/08/11 3:43:42 ET
Table 'Hakone VI 40-100 bb' 6-max Seat #3 is the button
Seat 1: leo 32824 ($429.27 in chips) 
Seat 2: vjxbkf ($807.47 in chips) 
Seat 3: checkitout12 ($299.56 in chips) 
Seat 4: iviz21 ($226.51 in chips) 
Seat 5: king10clubs ($958.29 in chips) 
Seat 6: NutPopper ($237 in chips) 
iviz21: posts small blind $3
king10clubs: posts big blind $6
*** HOLE CARDS ***
NutPopper: folds 
leo 32824: folds 
vjxbkf: raises $6 to $12
checkitout12: folds 
iviz21: folds 
king10clubs: folds 
Uncalled bet ($6) returned to vjxbkf
vjxbkf collected $15 from pot
vjxbkf: doesn't show hand 
*** SUMMARY ***
Total pot $15 | Rake $0 
Seat 1: leo 32824 folded before Flop (didn't bet)
Seat 2: vjxbkf collected ($15)
Seat 3: checkitout12 (button) folded before Flop (didn't bet)
Seat 4: iviz21 (small blind) folded before Flop
Seat 5: king10clubs (big blind) folded before Flop
Seat 6: NutPopper folded before Flop (didn't bet)


PokerStars Game #102595018048:  Hold'em No Limit ($3/$6 USD) - 2013/08/11 3:44:11 ET
Table 'Hakone VI 40-100 bb' 6-max Seat #4 is the button
Seat 1: leo 32824 ($429.27 in chips) 
Seat 2: vjxbkf ($816.47 in chips) 
Seat 3: checkitout12 ($299.56 in chips) 
Seat 4: iviz21 ($223.51 in chips) 
Seat 5: king10clubs ($952.29 in chips) 
Seat 6: NutPopper ($237 in chips) 
king10clubs: posts small blind $3
NutPopper: posts big blind $6
*** HOLE CARDS ***
leo 32824: raises $6 to $12
vjxbkf: folds 
checkitout12: folds 
iviz21: folds 
king10clubs: folds 
NutPopper: folds 
Uncalled bet ($6) returned to leo 32824
leo 32824 collected $15 from pot
*** SUMMARY ***
Total pot $15 | Rake $0 
Seat 1: leo 32824 collected ($15)
Seat 2: vjxbkf folded before Flop (didn't bet)
Seat 3: checkitout12 folded before Flop (didn't bet)
Seat 4: iviz21 (button) folded before Flop (didn't bet)
Seat 5: king10clubs (small blind) folded before Flop
Seat 6: NutPopper (big blind) folded before Flop


PokerStars Game #102595027215:  Hold'em No Limit ($3/$6 USD) - 2013/08/11 3:44:38 ET
Table 'Hakone VI 40-100 bb' 6-max Seat #5 is the button
Seat 1: leo 32824 ($438.27 in chips) 
Seat 2: vjxbkf ($816.47 in chips) 
Seat 3: checkitout12 ($299.56 in chips) 
Seat 4: iviz21 ($223.51 in chips) 
Seat 5: king10clubs ($949.29 in chips) 
Seat 6: NutPopper ($231 in chips) 
NutPopper: posts small blind $3
leo 32824: posts big blind $6
*** HOLE CARDS ***
vjxbkf: folds 
checkitout12: folds 
iviz21: raises $12 to $18
king10clubs: folds 
NutPopper: folds 
leo 32824: folds 
Uncalled bet ($12) returned to iviz21
iviz21 collected $15 from pot
iviz21: doesn't show hand 
*** SUMMARY ***
Total pot $15 | Rake $0 
Seat 1: leo 32824 (big blind) folded before Flop
Seat 2: vjxbkf folded before Flop (didn't bet)
Seat 3: checkitout12 folded before Flop (didn't bet)
Seat 4: iviz21 collected ($15)
Seat 5: king10clubs (button) folded before Flop (didn't bet)
Seat 6: NutPopper (small blind) folded before Flop


PokerStars Game #102594830239:  Hold'em No Limit ($3/$6 USD) - 2013/08/11 3:35:06 ET
Table 'Hakone VI 40-100 bb' 6-max Seat #4 is the button
Seat 1: leo 32824 ($437.43 in chips) 
Seat 2: vjxbkf ($816.47 in chips) 
Seat 3: checkitout12 ($258.58 in chips) 
Seat 4: iviz21 ($221.99 in chips) 
Seat 5: king10clubs ($731.73 in chips) 
Seat 6: NutPopper ($229.36 in chips) 
king10clubs: posts small blind $3
NutPopper: posts big blind $6
*** HOLE CARDS ***
leo 32824: folds 
vjxbkf: folds 
checkitout12: folds 
iviz21: folds 
king10clubs: raises $9 to $15
NutPopper: raises $18 to $33
king10clubs: raises $42 to $75
NutPopper: raises $154.36 to $229.36 and is all-in
king10clubs: calls $154.36
*** FIRST FLOP *** [As 2s 8s]
*** FIRST TURN *** [As 2s 8s] [8h]
*** FIRST RIVER *** [As 2s 8s 8h] [Jc]
*** SECOND FLOP *** [6h Qc 8d]
*** SECOND TURN *** [6h Qc 8d] [Ah]
*** SECOND RIVER *** [6h Qc 8d Ah] [3c]
*** FIRST SHOW DOWN ***
king10clubs: shows [Qh Ad] (two pair, Aces and Eights)
NutPopper: shows [Kd Ks] (two pair, Kings and Eights)
king10clubs collected $227.96 from pot
*** SECOND SHOW DOWN ***
king10clubs: shows [Qh Ad] (two pair, Aces and Queens)
NutPopper: shows [Kd Ks] (a pair of Kings)
king10clubs collected $227.96 from pot
*** SUMMARY ***
Total pot $458.72 | Rake $2.80 
Hand was run twice
FIRST Board [As 2s 8s 8h Jc]
SECOND Board [6h Qc 8d Ah 3c]
Seat 1: leo 32824 folded before Flop (didn't bet)
Seat 2: vjxbkf folded before Flop (didn't bet)
Seat 3: checkitout12 folded before Flop (didn't bet)
Seat 4: iviz21 (button) folded before Flop (didn't bet)
Seat 5: king10clubs (small blind) showed [Qh Ad] and won ($227.96) with two pair, Aces and Eights, and won ($227.96) with two pair, Aces and Queens
Seat 6: NutPopper (big blind) showed [Kd Ks] and lost with two pair, Kings and Eights, and lost with a pair of Kings


PokerStars Game #102594850910:  Hold'em No Limit ($3/$6 USD) - 2013/08/11 3:36:07 ET
Table 'Hakone VI 40-100 bb' 6-max Seat #5 is the button
Seat 1: leo 32824 ($437.43 in chips) 
Seat 2: vjxbkf ($816.47 in chips) 
Seat 3: checkitout12 ($258.58 in chips) 
Seat 4: iviz21 ($221.99 in chips) 
Seat 5: king10clubs ($958.29 in chips) 
Seat 6: NutPopper ($240 in chips) 
NutPopper: posts small blind $3
leo 32824: posts big blind $6
*** HOLE CARDS ***
vjxbkf: folds 
checkitout12: folds 
iviz21 has timed out
iviz21: folds 
king10clubs: raises $6 to $12
NutPopper: folds 
leo 32824: folds 
Uncalled bet ($6) returned to king10clubs
king10clubs collected $15 from pot
king10clubs: doesn't show hand 
*** SUMMARY ***
Total pot $15 | Rake $0 
Seat 1: leo 32824 (big blind) folded before Flop
Seat 2: vjxbkf folded before Flop (didn't bet)
Seat 3: checkitout12 folded before Flop (didn't bet)
Seat 4: iviz21 folded before Flop (didn't bet)
Seat 5: king10clubs (button) collected ($15)
Seat 6: NutPopper (small blind) folded before Flop


PokerStars Game #102594863736:  Hold'em No Limit ($3/$6 USD) - 2013/08/11 3:36:44 ET
Table 'Hakone VI 40-100 bb' 6-max Seat #6 is the button
Seat 1: leo 32824 ($431.43 in chips) 
Seat 2: vjxbkf ($816.47 in chips) 
Seat 3: checkitout12 ($258.58 in chips) 
Seat 4: iviz21 ($221.99 in chips) 
Seat 5: king10clubs ($967.29 in chips) 
Seat 6: NutPopper ($237 in chips) 
leo 32824: posts small blind $3
vjxbkf: posts big blind $6
*** HOLE CARDS ***
checkitout12: folds 
iviz21: folds 
king10clubs: raises $9 to $15
NutPopper: folds 
leo 32824: folds 
vjxbkf: folds 
Uncalled bet ($9) returned to king10clubs
king10clubs collected $15 from pot
king10clubs: doesn't show hand 
*** SUMMARY ***
Total pot $15 | Rake $0 
Seat 1: leo 32824 (small blind) folded before Flop
Seat 2: vjxbkf (big blind) folded before Flop
Seat 3: checkitout12 folded before Flop (didn't bet)
Seat 4: iviz21 folded before Flop (didn't bet)
Seat 5: king10clubs collected ($15)
Seat 6: NutPopper (button) folded before Flop (didn't bet)


PokerStars Game #102594876823:  Hold'em No Limit ($3/$6 USD) - 2013/08/11 3:37:22 ET
Table 'Hakone VI 40-100 bb' 6-max Seat #1 is the button
Seat 1: leo 32824 ($428.43 in chips) 
Seat 2: vjxbkf ($810.47 in chips) 
Seat 3: checkitout12 ($258.58 in chips) 
Seat 4: iviz21 ($221.99 in chips) 
Seat 5: king10clubs ($976.29 in chips) 
Seat 6: NutPopper ($237 in chips) 
vjxbkf: posts small blind $3
checkitout12: posts big blind $6
*** HOLE CARDS ***
iviz21: raises $6 to $12
king10clubs: folds 
NutPopper: folds 
leo 32824: calls $12
vjxbkf: folds 
checkitout12: folds 
*** FLOP *** [Qs Jc Jd]
iviz21: bets $12
leo 32824: folds 
Uncalled bet ($12) returned to iviz21
iviz21 collected $31.52 from pot
iviz21: doesn't show hand 
*** SUMMARY ***
Total pot $33 | Rake $1.48 
Board [Qs Jc Jd]
Seat 1: leo 32824 (button) folded on the Flop
Seat 2: vjxbkf (small blind) folded before Flop
Seat 3: checkitout12 (big blind) folded before Flop
Seat 4: iviz21 collected ($31.52)
Seat 5: king10clubs folded before Flop (didn't bet)
Seat 6: NutPopper folded before Flop (didn't bet)


PokerStars Game #102594890832:  Hold'em No Limit ($3/$6 USD) - 2013/08/11 3:38:03 ET
Table 'Hakone VI 40-100 bb' 6-max Seat #2 is the button
Seat 1: leo 32824 ($416.43 in chips) 
Seat 2: vjxbkf ($807.47 in chips) 
Seat 3: checkitout12 ($252.58 in chips) 
Seat 4: iviz21 ($241.51 in chips) 
Seat 5: king10clubs ($976.29 in chips) 
Seat 6: NutPopper ($237 in chips) 
checkitout12: posts small blind $3
iviz21: posts big blind $6
*** HOLE CARDS ***
king10clubs: raises $9 to $15
NutPopper: folds 
leo 32824: folds 
vjxbkf: folds 
checkitout12: folds 
iviz21: folds 
Uncalled bet ($9) returned to king10clubs
king10clubs collected $15 from pot
king10clubs: doesn't show hand 
*** SUMMARY ***
Total pot $15 | Rake $0 
Seat 1: leo 32824 folded before Flop (didn't bet)
Seat 2: vjxbkf (button) folded before Flop (didn't bet)
Seat 3: checkitout12 (small blind) folded before Flop
Seat 4: iviz21 (big blind) folded before Flop
Seat 5: king10clubs collected ($15)
Seat 6: NutPopper folded before Flop (didn't bet)


PokerStars Game #102594899283:  Hold'em No Limit ($3/$6 USD) - 2013/08/11 3:38:28 ET
Table 'Hakone VI 40-100 bb' 6-max Seat #3 is the button
Seat 1: leo 32824 ($416.43 in chips) 
Seat 2: vjxbkf ($807.47 in chips) 
Seat 3: checkitout12 ($249.58 in chips) 
Seat 4: iviz21 ($235.51 in chips) 
Seat 5: king10clubs ($985.29 in chips) 
Seat 6: NutPopper ($237 in chips) 
iviz21: posts small blind $3
king10clubs: posts big blind $6
*** HOLE CARDS ***
NutPopper: folds 
leo 32824: folds 
vjxbkf: folds 
checkitout12: folds 
iviz21: folds 
Uncalled bet ($3) returned to king10clubs
king10clubs collected $6 from pot
king10clubs: doesn't show hand 
*** SUMMARY ***
Total pot $6 | Rake $0 
Seat 1: leo 32824 folded before Flop (didn't bet)
Seat 2: vjxbkf folded before Flop (didn't bet)
Seat 3: checkitout12 (button) folded before Flop (didn't bet)
Seat 4: iviz21 (small blind) folded before Flop
Seat 5: king10clubs (big blind) collected ($6)
Seat 6: NutPopper folded before Flop (didn't bet)


PokerStars Game #102594908524:  Hold'em No Limit ($3/$6 USD) - 2013/08/11 3:38:55 ET
Table 'Hakone VI 40-100 bb' 6-max Seat #4 is the button
Seat 1: leo 32824 ($416.43 in chips) 
Seat 2: vjxbkf ($807.47 in chips) 
Seat 3: checkitout12 ($249.58 in chips) 
Seat 4: iviz21 ($232.51 in chips) 
Seat 5: king10clubs ($988.29 in chips) 
Seat 6: NutPopper ($237 in chips) 
king10clubs: posts small blind $3
NutPopper: posts big blind $6
*** HOLE CARDS ***
leo 32824: folds 
vjxbkf: folds 
checkitout12: folds 
iviz21: folds 
king10clubs: folds 
Uncalled bet ($3) returned to NutPopper
NutPopper collected $6 from pot
NutPopper: doesn't show hand 
*** SUMMARY ***
Total pot $6 | Rake $0 
Seat 1: leo 32824 folded before Flop (didn't bet)
Seat 2: vjxbkf folded before Flop (didn't bet)
Seat 3: checkitout12 folded before Flop (didn't bet)
Seat 4: iviz21 (button) folded before Flop (didn't bet)
Seat 5: king10clubs (small blind) folded before Flop
Seat 6: NutPopper (big blind) collected ($6)


PokerStars Game #102594917518:  Hold'em No Limit ($3/$6 USD) - 2013/08/11 3:39:21 ET
Table 'Hakone VI 40-100 bb' 6-max Seat #5 is the button
Seat 1: leo 32824 ($416.43 in chips) 
Seat 2: vjxbkf ($807.47 in chips) 
Seat 3: checkitout12 ($249.58 in chips) 
Seat 4: iviz21 ($232.51 in chips) 
Seat 5: king10clubs ($985.29 in chips) 
Seat 6: NutPopper ($240 in chips) 
NutPopper: posts small blind $3
leo 32824: posts big blind $6
*** HOLE CARDS ***
vjxbkf: folds 
checkitout12: folds 
iviz21: folds 
king10clubs: raises $6 to $12
NutPopper: folds 
leo 32824: folds 
Uncalled bet ($6) returned to king10clubs
king10clubs collected $15 from pot
king10clubs: doesn't show hand 
*** SUMMARY ***
Total pot $15 | Rake $0 
Seat 1: leo 32824 (big blind) folded before Flop
Seat 2: vjxbkf folded before Flop (didn't bet)
Seat 3: checkitout12 folded before Flop (didn't bet)
Seat 4: iviz21 folded before Flop (didn't bet)
Seat 5: king10clubs (button) collected ($15)
Seat 6: NutPopper (small blind) folded before Flop


PokerStars Game #102594727353:  Hold'em No Limit ($3/$6 USD) - 2013/08/11 3:30:00 ET
Table 'Hakone VI 40-100 bb' 6-max Seat #2 is the button
Seat 1: leo 32824 ($473.43 in chips) 
Seat 2: vjxbkf ($837.47 in chips) 
Seat 3: checkitout12 ($261.76 in chips) 
Seat 4: iviz21 ($211.18 in chips) 
Seat 5: king10clubs ($716.53 in chips) 
Seat 6: NutPopper ($202.16 in chips) 
checkitout12: posts small blind $3
iviz21: posts big blind $6
*** HOLE CARDS ***
king10clubs: folds 
NutPopper: folds 
leo 32824: folds 
vjxbkf: raises $6 to $12
checkitout12: raises $18.60 to $30.60
iviz21: folds 
vjxbkf: folds 
Uncalled bet ($18.60) returned to checkitout12
checkitout12 collected $30 from pot
checkitout12: doesn't show hand 
*** SUMMARY ***
Total pot $30 | Rake $0 
Seat 1: leo 32824 folded before Flop (didn't bet)
Seat 2: vjxbkf (button) folded before Flop
Seat 3: checkitout12 (small blind) collected ($30)
Seat 4: iviz21 (big blind) folded before Flop
Seat 5: king10clubs folded before Flop (didn't bet)
Seat 6: NutPopper folded before Flop (didn't bet)


PokerStars Game #102594739067:  Hold'em No Limit ($3/$6 USD) - 2013/08/11 3:30:35 ET
Table 'Hakone VI 40-100 bb' 6-max Seat #3 is the button
Seat 1: leo 32824 ($473.43 in chips) 
Seat 2: vjxbkf ($825.47 in chips) 
Seat 3: checkitout12 ($279.76 in chips) 
Seat 4: iviz21 ($205.18 in chips) 
Seat 5: king10clubs ($716.53 in chips) 
Seat 6: NutPopper ($202.16 in chips) 
iviz21: posts small blind $3
king10clubs: posts big blind $6
*** HOLE CARDS ***
NutPopper: folds 
leo 32824: folds 
vjxbkf: folds 
checkitout12: raises $6.18 to $12.18
iviz21: calls $9.18
king10clubs: folds 
*** FLOP *** [Qd 8c Th]
iviz21: bets $18
checkitout12: folds 
Uncalled bet ($18) returned to iviz21
iviz21 collected $28.99 from pot
iviz21: doesn't show hand 
*** SUMMARY ***
Total pot $30.36 | Rake $1.37 
Board [Qd 8c Th]
Seat 1: leo 32824 folded before Flop (didn't bet)
Seat 2: vjxbkf folded before Flop (didn't bet)
Seat 3: checkitout12 (button) folded on the Flop
Seat 4: iviz21 (small blind) collected ($28.99)
Seat 5: king10clubs (big blind) folded before Flop
Seat 6: NutPopper folded before Flop (didn't bet)


PokerStars Game #102594753814:  Hold'em No Limit ($3/$6 USD) - 2013/08/11 3:31:19 ET
Table 'Hakone VI 40-100 bb' 6-max Seat #4 is the button
Seat 1: leo 32824 ($473.43 in chips) 
Seat 2: vjxbkf ($825.47 in chips) 
Seat 3: checkitout12 ($267.58 in chips) 
Seat 4: iviz21 ($221.99 in chips) 
Seat 5: king10clubs ($710.53 in chips) 
Seat 6: NutPopper ($202.16 in chips) 
king10clubs: posts small blind $3
NutPopper: posts big blind $6
*** HOLE CARDS ***
leo 32824: folds 
vjxbkf: folds 
checkitout12: folds 
iviz21: folds 
king10clubs: raises $9 to $15
NutPopper: raises $18 to $33
king10clubs: calls $18
*** FLOP *** [8s 6d 7c]
king10clubs: checks 
NutPopper: bets $42
king10clubs: folds 
Uncalled bet ($42) returned to NutPopper
NutPopper collected $63.20 from pot
NutPopper: doesn't show hand 
*** SUMMARY ***
Total pot $66 | Rake $2.80 
Board [8s 6d 7c]
Seat 1: leo 32824 folded before Flop (didn't bet)
Seat 2: vjxbkf folded before Flop (didn't bet)
Seat 3: checkitout12 folded before Flop (didn't bet)
Seat 4: iviz21 (button) folded before Flop (didn't bet)
Seat 5: king10clubs (small blind) folded on the Flop
Seat 6: NutPopper (big blind) collected ($63.20)


PokerStars Game #102594767549:  Hold'em No Limit ($3/$6 USD) - 2013/08/11 3:32:00 ET
Table 'Hakone VI 40-100 bb' 6-max Seat #5 is the button
Seat 1: leo 32824 ($473.43 in chips) 
Seat 2: vjxbkf ($825.47 in chips) 
Seat 3: checkitout12 ($267.58 in chips) 
Seat 4: iviz21 ($221.99 in chips) 
Seat 5: king10clubs ($677.53 in chips) 
Seat 6: NutPopper ($232.36 in chips) 
NutPopper: posts small blind $3
leo 32824: posts big blind $6
*** HOLE CARDS ***
vjxbkf: folds 
checkitout12: folds 
iviz21: raises $12 to $18
king10clubs: folds 
NutPopper: folds 
leo 32824: folds 
Uncalled bet ($12) returned to iviz21
iviz21 collected $15 from pot
iviz21: doesn't show hand 
*** SUMMARY ***
Total pot $15 | Rake $0 
Seat 1: leo 32824 (big blind) folded before Flop
Seat 2: vjxbkf folded before Flop (didn't bet)
Seat 3: checkitout12 folded before Flop (didn't bet)
Seat 4: iviz21 collected ($15)
Seat 5: king10clubs (button) folded before Flop (didn't bet)
Seat 6: NutPopper (small blind) folded before Flop


PokerStars Game #102594776311:  Hold'em No Limit ($3/$6 USD) - 2013/08/11 3:32:26 ET
Table 'Hakone VI 40-100 bb' 6-max Seat #6 is the button
Seat 1: leo 32824 ($467.43 in chips) 
Seat 2: vjxbkf ($825.47 in chips) 
Seat 3: checkitout12 ($267.58 in chips) 
Seat 4: iviz21 ($230.99 in chips) 
Seat 5: king10clubs ($677.53 in chips) 
Seat 6: NutPopper ($229.36 in chips) 
leo 32824: posts small blind $3
vjxbkf: posts big blind $6
*** HOLE CARDS ***
checkitout12: folds 
iviz21: folds 
king10clubs: raises $9 to $15
NutPopper: folds 
leo 32824: folds 
vjxbkf: folds 
Uncalled bet ($9) returned to king10clubs
king10clubs collected $15 from pot
king10clubs: doesn't show hand 
*** SUMMARY ***
Total pot $15 | Rake $0 
Seat 1: leo 32824 (small blind) folded before Flop
Seat 2: vjxbkf (big blind) folded before Flop
Seat 3: checkitout12 folded before Flop (didn't bet)
Seat 4: iviz21 folded before Flop (didn't bet)
Seat 5: king10clubs collected ($15)
Seat 6: NutPopper (button) folded before Flop (didn't bet)


PokerStars Game #102594791144:  Hold'em No Limit ($3/$6 USD) - 2013/08/11 3:33:11 ET
Table 'Hakone VI 40-100 bb' 6-max Seat #1 is the button
Seat 1: leo 32824 ($464.43 in chips) 
Seat 2: vjxbkf ($819.47 in chips) 
Seat 3: checkitout12 ($267.58 in chips) 
Seat 4: iviz21 ($230.99 in chips) 
Seat 5: king10clubs ($686.53 in chips) 
Seat 6: NutPopper ($229.36 in chips) 
vjxbkf: posts small blind $3
checkitout12: posts big blind $6
*** HOLE CARDS ***
iviz21: folds 
king10clubs: raises $9 to $15
NutPopper: folds 
leo 32824: calls $15
vjxbkf: folds 
checkitout12: folds 
*** FLOP *** [3d 7c 9c]
king10clubs: bets $30
leo 32824: calls $30
*** TURN *** [3d 7c 9c] [Th]
king10clubs: checks 
leo 32824: checks 
*** RIVER *** [3d 7c 9c Th] [3h]
king10clubs: bets $66
leo 32824: folds 
Uncalled bet ($66) returned to king10clubs
king10clubs collected $96.20 from pot
king10clubs: doesn't show hand 
*** SUMMARY ***
Total pot $99 | Rake $2.80 
Board [3d 7c 9c Th 3h]
Seat 1: leo 32824 (button) folded on the River
Seat 2: vjxbkf (small blind) folded before Flop
Seat 3: checkitout12 (big blind) folded before Flop
Seat 4: iviz21 folded before Flop (didn't bet)
Seat 5: king10clubs collected ($96.20)
Seat 6: NutPopper folded before Flop (didn't bet)


PokerStars Game #102594813875:  Hold'em No Limit ($3/$6 USD) - 2013/08/11 3:34:18 ET
Table 'Hakone VI 40-100 bb' 6-max Seat #2 is the button
Seat 1: leo 32824 ($419.43 in chips) 
Seat 2: vjxbkf ($816.47 in chips) 
Seat 3: checkitout12 ($261.58 in chips) 
Seat 4: iviz21 ($230.99 in chips) 
Seat 5: king10clubs ($737.73 in chips) 
Seat 6: NutPopper ($229.36 in chips) 
checkitout12: posts small blind $3
iviz21: posts big blind $6
*** HOLE CARDS ***
king10clubs: folds 
NutPopper: folds 
leo 32824: raises $9 to $15
vjxbkf: folds 
checkitout12: folds 
iviz21: folds 
Uncalled bet ($9) returned to leo 32824
leo 32824 collected $15 from pot
*** SUMMARY ***
Total pot $15 | Rake $0 
Seat 1: leo 32824 collected ($15)
Seat 2: vjxbkf (button) folded before Flop (didn't bet)
Seat 3: checkitout12 (small blind) folded before Flop
Seat 4: iviz21 (big blind) folded before Flop
Seat 5: king10clubs folded before Flop (didn't bet)
Seat 6: NutPopper folded before Flop (didn't bet)


PokerStars Game #102594821009:  Hold'em No Limit ($3/$6 USD) - 2013/08/11 3:34:39 ET
Table 'Hakone VI 40-100 bb' 6-max Seat #3 is the button
Seat 1: leo 32824 ($428.43 in chips) 
Seat 2: vjxbkf ($816.47 in chips) 
Seat 3: checkitout12 ($258.58 in chips) 
Seat 4: iviz21 ($224.99 in chips) 
Seat 5: king10clubs ($737.73 in chips) 
Seat 6: NutPopper ($229.36 in chips) 
iviz21: posts small blind $3
king10clubs: posts big blind $6
*** HOLE CARDS ***
NutPopper: folds 
leo 32824: raises $9 to $15
vjxbkf: folds 
checkitout12: folds 
iviz21: folds 
king10clubs: folds 
Uncalled bet ($9) returned to leo 32824
leo 32824 collected $15 from pot
*** SUMMARY ***
Total pot $15 | Rake $0 
Seat 1: leo 32824 collected ($15)
Seat 2: vjxbkf folded before Flop (didn't bet)
Seat 3: checkitout12 (button) folded before Flop (didn't bet)
Seat 4: iviz21 (small blind) folded before Flop
Seat 5: king10clubs (big blind) folded before Flop
Seat 6: NutPopper folded before Flop (didn't bet)


PokerStars Game #102595146821:  Hold'em No Limit ($3/$6 USD) - 2013/08/11 3:50:20 ET
Table 'Hakone VI 40-100 bb' 6-max Seat #5 is the button
Seat 1: leo 32824 ($429.27 in chips) 
Seat 2: vjxbkf ($804.47 in chips) 
Seat 3: checkitout12 ($323.56 in chips) 
Seat 5: king10clubs ($943.29 in chips) 
Seat 6: NutPopper ($186 in chips) 
NutPopper: posts small blind $3
leo 32824: posts big blind $6
*** HOLE CARDS ***
vjxbkf: folds 
checkitout12: folds 
king10clubs: folds 
NutPopper: raises $6 to $12
leo 32824: folds 
Uncalled bet ($6) returned to NutPopper
NutPopper collected $12 from pot
NutPopper: doesn't show hand 
*** SUMMARY ***
Total pot $12 | Rake $0 
Seat 1: leo 32824 (big blind) folded before Flop
Seat 2: vjxbkf folded before Flop (didn't bet)
Seat 3: checkitout12 folded before Flop (didn't bet)
Seat 5: king10clubs (button) folded before Flop (didn't bet)
Seat 6: NutPopper (small blind) collected ($12)


PokerStars Game #102595155377:  Hold'em No Limit ($3/$6 USD) - 2013/08/11 3:50:44 ET
Table 'Hakone VI 40-100 bb' 6-max Seat #6 is the button
Seat 1: leo 32824 ($423.27 in chips) 
Seat 2: vjxbkf ($804.47 in chips) 
Seat 3: checkitout12 ($323.56 in chips) 
Seat 5: king10clubs ($943.29 in chips) 
Seat 6: NutPopper ($192 in chips) 
leo 32824: posts small blind $3
vjxbkf: posts big blind $6
*** HOLE CARDS ***
checkitout12: folds 
king10clubs: raises $9 to $15
NutPopper: folds 
leo 32824: folds 
vjxbkf: folds 
Uncalled bet ($9) returned to king10clubs
king10clubs collected $15 from pot
king10clubs: doesn't show hand 
*** SUMMARY ***
Total pot $15 | Rake $0 
Seat 1: leo 32824 (small blind) folded before Flop
Seat 2: vjxbkf (big blind) folded before Flop
Seat 3: checkitout12 folded before Flop (didn't bet)
Seat 5: king10clubs collected ($15)
Seat 6: NutPopper (button) folded before Flop (didn't bet)


PokerStars Game #102595168659:  Hold'em No Limit ($3/$6 USD) - 2013/08/11 3:51:22 ET
Table 'Hakone VI 40-100 bb' 6-max Seat #1 is the button
Seat 1: leo 32824 ($420.27 in chips) 
Seat 2: vjxbkf ($798.47 in chips) 
Seat 3: checkitout12 ($323.56 in chips) 
Seat 5: king10clubs ($952.29 in chips) 
Seat 6: NutPopper ($192 in chips) 
vjxbkf: posts small blind $3
checkitout12: posts big blind $6
*** HOLE CARDS ***
king10clubs: folds 
NutPopper: folds 
leo 32824: folds 
vjxbkf: raises $12 to $18
checkitout12: calls $12
*** FLOP *** [Kd 4d Qc]
vjxbkf: bets $27
checkitout12: calls $27
*** TURN *** [Kd 4d Qc] [2d]
vjxbkf: bets $69
checkitout12: calls $69
*** RIVER *** [Kd 4d Qc 2d] [Qs]
vjxbkf: checks 
checkitout12: checks 
*** SHOW DOWN ***
vjxbkf: shows [Ad Jh] (a pair of Queens)
checkitout12: shows [Kc 7c] (two pair, Kings and Queens)
checkitout12 collected $225.20 from pot
*** SUMMARY ***
Total pot $228 | Rake $2.80 
Board [Kd 4d Qc 2d Qs]
Seat 1: leo 32824 (button) folded before Flop (didn't bet)
Seat 2: vjxbkf (small blind) showed [Ad Jh] and lost with a pair of Queens
Seat 3: checkitout12 (big blind) showed [Kc 7c] and won ($225.20) with two pair, Kings and Queens
Seat 5: king10clubs folded before Flop (didn't bet)
Seat 6: NutPopper folded before Flop (didn't bet)


PokerStars Game #102595208478:  Hold'em No Limit ($3/$6 USD) - 2013/08/11 3:53:14 ET
Table 'Hakone VI 40-100 bb' 6-max Seat #2 is the button
Seat 1: leo 32824 ($420.27 in chips) 
Seat 2: vjxbkf ($684.47 in chips) 
Seat 3: checkitout12 ($434.76 in chips) 
Seat 5: king10clubs ($952.29 in chips) 
Seat 6: NutPopper ($192 in chips) 
checkitout12: posts small blind $3
king10clubs: posts big blind $6
*** HOLE CARDS ***
NutPopper: folds 
leo 32824: folds 
vjxbkf: raises $6 to $12
checkitout12: folds 
king10clubs: raises $36 to $48
vjxbkf: folds 
Uncalled bet ($36) returned to king10clubs
king10clubs collected $27 from pot
king10clubs: doesn't show hand 
*** SUMMARY ***
Total pot $27 | Rake $0 
Seat 1: leo 32824 folded before Flop (didn't bet)
Seat 2: vjxbkf (button) folded before Flop
Seat 3: checkitout12 (small blind) folded before Flop
Seat 5: king10clubs (big blind) collected ($27)
Seat 6: NutPopper folded before Flop (didn't bet)


PokerStars Game #102595232161:  Hold'em No Limit ($3/$6 USD) - 2013/08/11 3:54:21 ET
Table 'Hakone VI 40-100 bb' 6-max Seat #3 is the button
Seat 1: leo 32824 ($420.27 in chips) 
Seat 2: vjxbkf ($672.47 in chips) 
Seat 3: checkitout12 ($431.76 in chips) 
Seat 5: king10clubs ($967.29 in chips) 
Seat 6: NutPopper ($192 in chips) 
iviz21 will be allowed to play after the button
king10clubs: posts small blind $3
NutPopper: posts big blind $6
*** HOLE CARDS ***
leo 32824: folds 
vjxbkf: folds 
checkitout12: raises $6.18 to $12.18
king10clubs: folds 
NutPopper: folds 
Uncalled bet ($6.18) returned to checkitout12
checkitout12 collected $15 from pot
checkitout12: doesn't show hand 
*** SUMMARY ***
Total pot $15 | Rake $0 
Seat 1: leo 32824 folded before Flop (didn't bet)
Seat 2: vjxbkf folded before Flop (didn't bet)
Seat 3: checkitout12 (button) collected ($15)
Seat 5: king10clubs (small blind) folded before Flop
Seat 6: NutPopper (big blind) folded before Flop


PokerStars Game #102595243962:  Hold'em No Limit ($3/$6 USD) - 2013/08/11 3:54:53 ET
Table 'Hakone VI 40-100 bb' 6-max Seat #5 is the button
Seat 1: leo 32824 ($420.27 in chips) 
Seat 2: vjxbkf ($672.47 in chips) 
Seat 3: checkitout12 ($440.76 in chips) 
Seat 5: king10clubs ($964.29 in chips) 
Seat 6: NutPopper ($186 in chips) 
NutPopper: posts small blind $3
leo 32824: posts big blind $6
iviz21: sits out 
*** HOLE CARDS ***
vjxbkf: folds 
checkitout12: folds 
king10clubs: raises $6 to $12
NutPopper: folds 
leo 32824: raises $24 to $36
king10clubs: folds 
Uncalled bet ($24) returned to leo 32824
leo 32824 collected $27 from pot
*** SUMMARY ***
Total pot $27 | Rake $0 
Seat 1: leo 32824 (big blind) collected ($27)
Seat 2: vjxbkf folded before Flop (didn't bet)
Seat 3: checkitout12 folded before Flop (didn't bet)
Seat 5: king10clubs (button) folded before Flop
Seat 6: NutPopper (small blind) folded before Flop


PokerStars Game #102595038503:  Hold'em No Limit ($3/$6 USD) - 2013/08/11 3:45:10 ET
Table 'Hakone VI 40-100 bb' 6-max Seat #6 is the button
Seat 1: leo 32824 ($432.27 in chips) 
Seat 2: vjxbkf ($816.47 in chips) 
Seat 3: checkitout12 ($299.56 in chips) 
Seat 4: iviz21 ($232.51 in chips) 
Seat 6: NutPopper ($228 in chips) 
leo 32824: posts small blind $3
vjxbkf: posts big blind $6
*** HOLE CARDS ***
checkitout12: folds 
iviz21: folds 
NutPopper: raises $6 to $12
leo 32824: folds 
vjxbkf: raises $18 to $30
NutPopper: folds 
Uncalled bet ($18) returned to vjxbkf
vjxbkf collected $27 from pot
vjxbkf: doesn't show hand 
*** SUMMARY ***
Total pot $27 | Rake $0 
Seat 1: leo 32824 (small blind) folded before Flop
Seat 2: vjxbkf (big blind) collected ($27)
Seat 3: checkitout12 folded before Flop (didn't bet)
Seat 4: iviz21 folded before Flop (didn't bet)
Seat 6: NutPopper (button) folded before Flop


PokerStars Game #102595060496:  Hold'em No Limit ($3/$6 USD) - 2013/08/11 3:46:13 ET
Table 'Hakone VI 40-100 bb' 6-max Seat #1 is the button
Seat 1: leo 32824 ($429.27 in chips) 
Seat 2: vjxbkf ($831.47 in chips) 
Seat 3: checkitout12 ($299.56 in chips) 
Seat 4: iviz21 ($232.51 in chips) 
Seat 6: NutPopper ($216 in chips) 
vjxbkf: posts small blind $3
checkitout12: posts big blind $6
*** HOLE CARDS ***
iviz21: raises $12 to $18
NutPopper: calls $18
leo 32824: folds 
vjxbkf: folds 
checkitout12: folds 
*** FLOP *** [5c 8h As]
iviz21: bets $24
NutPopper: folds 
Uncalled bet ($24) returned to iviz21
iviz21 collected $42.98 from pot
iviz21: doesn't show hand 
*** SUMMARY ***
Total pot $45 | Rake $2.02 
Board [5c 8h As]
Seat 1: leo 32824 (button) folded before Flop (didn't bet)
Seat 2: vjxbkf (small blind) folded before Flop
Seat 3: checkitout12 (big blind) folded before Flop
Seat 4: iviz21 collected ($42.98)
Seat 6: NutPopper folded on the Flop


PokerStars Game #102595074450:  Hold'em No Limit ($3/$6 USD) - 2013/08/11 3:46:53 ET
Table 'Hakone VI 40-100 bb' 6-max Seat #2 is the button
Seat 1: leo 32824 ($429.27 in chips) 
Seat 2: vjxbkf ($828.47 in chips) 
Seat 3: checkitout12 ($293.56 in chips) 
Seat 4: iviz21 ($257.49 in chips) 
Seat 6: NutPopper ($198 in chips) 
checkitout12: posts small blind $3
iviz21: posts big blind $6
*** HOLE CARDS ***
NutPopper: folds 
leo 32824: folds 
vjxbkf: raises $6 to $12
checkitout12: folds 
iviz21: calls $6
*** FLOP *** [Ks Qh 4s]
iviz21: checks 
vjxbkf: checks 
*** TURN *** [Ks Qh 4s] [Ah]
iviz21: checks 
vjxbkf: checks 
*** RIVER *** [Ks Qh 4s Ah] [Td]
iviz21: bets $30
vjxbkf: folds 
Uncalled bet ($30) returned to iviz21
iviz21 collected $25.78 from pot
iviz21: doesn't show hand 
*** SUMMARY ***
Total pot $27 | Rake $1.22 
Board [Ks Qh 4s Ah Td]
Seat 1: leo 32824 folded before Flop (didn't bet)
Seat 2: vjxbkf (button) folded on the River
Seat 3: checkitout12 (small blind) folded before Flop
Seat 4: iviz21 (big blind) collected ($25.78)
Seat 6: NutPopper folded before Flop (didn't bet)


PokerStars Game #102595098927:  Hold'em No Limit ($3/$6 USD) - 2013/08/11 3:48:03 ET
Table 'Hakone VI 40-100 bb' 6-max Seat #3 is the button
Seat 1: leo 32824 ($429.27 in chips) 
Seat 2: vjxbkf ($816.47 in chips) 
Seat 3: checkitout12 ($290.56 in chips) 
Seat 4: iviz21 ($271.27 in chips) 
Seat 5: king10clubs ($949.29 in chips) 
Seat 6: NutPopper ($198 in chips) 
iviz21: posts small blind $3
king10clubs: posts big blind $6
*** HOLE CARDS ***
NutPopper: raises $6 to $12
leo 32824: folds 
vjxbkf: calls $12
checkitout12: raises $28.24 to $40.24
iviz21 is disconnected 
iviz21 has timed out while disconnected
iviz21: folds 
king10clubs: folds 
NutPopper: folds 
vjxbkf: folds 
Uncalled bet ($28.24) returned to checkitout12
checkitout12 collected $45 from pot
checkitout12: doesn't show hand 
*** SUMMARY ***
Total pot $45 | Rake $0 
Seat 1: leo 32824 folded before Flop (didn't bet)
Seat 2: vjxbkf folded before Flop
Seat 3: checkitout12 (button) collected ($45)
Seat 4: iviz21 (small blind) folded before Flop
Seat 5: king10clubs (big blind) folded before Flop
Seat 6: NutPopper folded before Flop


PokerStars Game #102595576320:  Hold'em No Limit ($3/$6 USD) - 2013/08/11 4:10:50 ET
Table 'Hakone VI 40-100 bb' 6-max Seat #2 is the button
Seat 1: leo 32824 ($801.74 in chips) 
Seat 2: floriiiiider ($600 in chips) 
Seat 3: mustanggino ($450 in chips) 
Seat 4: JulyShort ($255.20 in chips) 
Seat 5: king10clubs ($799.48 in chips) 
Seat 6: ZarubaNT ($651.20 in chips) 
mustanggino: posts small blind $3
JulyShort: posts big blind $6
*** HOLE CARDS ***
king10clubs: folds 
ZarubaNT: folds 
leo 32824: folds 
floriiiiider: folds 
mustanggino: raises $6 to $12
JulyShort: raises $21 to $33
mustanggino: folds 
Uncalled bet ($21) returned to JulyShort
JulyShort collected $24 from pot
JulyShort: doesn't show hand 
*** SUMMARY ***
Total pot $24 | Rake $0 
Seat 1: leo 32824 folded before Flop (didn't bet)
Seat 2: floriiiiider (button) folded before Flop (didn't bet)
Seat 3: mustanggino (small blind) folded before Flop
Seat 4: JulyShort (big blind) collected ($24)
Seat 5: king10clubs folded before Flop (didn't bet)
Seat 6: ZarubaNT folded before Flop (didn't bet)


PokerStars Game #102595602769:  Hold'em No Limit ($3/$6 USD) - 2013/08/11 4:12:04 ET
Table 'Hakone VI 40-100 bb' 6-max Seat #3 is the button
Seat 1: leo 32824 ($801.74 in chips) 
Seat 2: floriiiiider ($600 in chips) 
Seat 3: mustanggino ($450 in chips) 
Seat 4: JulyShort ($267.20 in chips) 
Seat 5: king10clubs ($799.48 in chips) 
Seat 6: ZarubaNT ($651.20 in chips) 
JulyShort: posts small blind $3
king10clubs: posts big blind $6
*** HOLE CARDS ***
ZarubaNT: folds 
leo 32824: folds 
floriiiiider: folds 
mustanggino: folds 
JulyShort: folds 
Uncalled bet ($3) returned to king10clubs
king10clubs collected $6 from pot
king10clubs: doesn't show hand 
*** SUMMARY ***
Total pot $6 | Rake $0 
Seat 1: leo 32824 folded before Flop (didn't bet)
Seat 2: floriiiiider folded before Flop (didn't bet)
Seat 3: mustanggino (button) folded before Flop (didn't bet)
Seat 4: JulyShort (small blind) folded before Flop
Seat 5: king10clubs (big blind) collected ($6)
Seat 6: ZarubaNT folded before Flop (didn't bet)


PokerStars Game #102595611250:  Hold'em No Limit ($3/$6 USD) - 2013/08/11 4:12:28 ET
Table 'Hakone VI 40-100 bb' 6-max Seat #4 is the button
Seat 1: leo 32824 ($801.74 in chips) 
Seat 2: floriiiiider ($600 in chips) 
Seat 3: mustanggino ($450 in chips) 
Seat 4: JulyShort ($264.20 in chips) 
Seat 5: king10clubs ($802.48 in chips) 
Seat 6: ZarubaNT ($651.20 in chips) 
king10clubs: posts small blind $3
ZarubaNT: posts big blind $6
*** HOLE CARDS ***
leo 32824: folds 
floriiiiider: raises $12 to $18
mustanggino: folds 
JulyShort: folds 
king10clubs: raises $42 to $60
ZarubaNT: folds 
floriiiiider: folds 
Uncalled bet ($42) returned to king10clubs
king10clubs collected $42 from pot
king10clubs: doesn't show hand 
*** SUMMARY ***
Total pot $42 | Rake $0 
Seat 1: leo 32824 folded before Flop (didn't bet)
Seat 2: floriiiiider folded before Flop
Seat 3: mustanggino folded before Flop (didn't bet)
Seat 4: JulyShort (button) folded before Flop (didn't bet)
Seat 5: king10clubs (small blind) collected ($42)
Seat 6: ZarubaNT (big blind) folded before Flop


PokerStars Game #102595633639:  Hold'em No Limit ($3/$6 USD) - 2013/08/11 4:13:31 ET
Table 'Hakone VI 40-100 bb' 6-max Seat #5 is the button
Seat 1: leo 32824 ($801.74 in chips) 
Seat 2: floriiiiider ($600 in chips) 
Seat 3: mustanggino ($450 in chips) 
Seat 4: JulyShort ($264.20 in chips) 
Seat 5: king10clubs ($826.48 in chips) 
Seat 6: ZarubaNT ($645.20 in chips) 
ZarubaNT: posts small blind $3
leo 32824: posts big blind $6
*** HOLE CARDS ***
floriiiiider: folds 
mustanggino: folds 
JulyShort: folds 
king10clubs: raises $6 to $12
ZarubaNT: folds 
leo 32824: folds 
Uncalled bet ($6) returned to king10clubs
king10clubs collected $15 from pot
king10clubs: doesn't show hand 
*** SUMMARY ***
Total pot $15 | Rake $0 
Seat 1: leo 32824 (big blind) folded before Flop
Seat 2: floriiiiider folded before Flop (didn't bet)
Seat 3: mustanggino folded before Flop (didn't bet)
Seat 4: JulyShort folded before Flop (didn't bet)
Seat 5: king10clubs (button) collected ($15)
Seat 6: ZarubaNT (small blind) folded before Flop


PokerStars Game #102595643648:  Hold'em No Limit ($3/$6 USD) - 2013/08/11 4:13:59 ET
Table 'Hakone VI 40-100 bb' 6-max Seat #6 is the button
Seat 1: leo 32824 ($795.74 in chips) 
Seat 2: floriiiiider ($600 in chips) 
Seat 3: mustanggino ($450 in chips) 
Seat 4: JulyShort ($264.20 in chips) 
Seat 5: king10clubs ($835.48 in chips) 
Seat 6: ZarubaNT ($642.20 in chips) 
leo 32824: posts small blind $3
floriiiiider: posts big blind $6
*** HOLE CARDS ***
mustanggino: folds 
JulyShort: folds 
king10clubs: raises $9 to $15
ZarubaNT: folds 
leo 32824: folds 
floriiiiider: folds 
Uncalled bet ($9) returned to king10clubs
king10clubs collected $15 from pot
king10clubs: doesn't show hand 
*** SUMMARY ***
Total pot $15 | Rake $0 
Seat 1: leo 32824 (small blind) folded before Flop
Seat 2: floriiiiider (big blind) folded before Flop
Seat 3: mustanggino folded before Flop (didn't bet)
Seat 4: JulyShort folded before Flop (didn't bet)
Seat 5: king10clubs collected ($15)
Seat 6: ZarubaNT (button) folded before Flop (didn't bet)


PokerStars Game #102595652134:  Hold'em No Limit ($3/$6 USD) - 2013/08/11 4:14:23 ET
Table 'Hakone VI 40-100 bb' 6-max Seat #1 is the button
Seat 1: leo 32824 ($792.74 in chips) 
Seat 2: floriiiiider ($600 in chips) 
Seat 3: mustanggino ($450 in chips) 
Seat 4: JulyShort ($264.20 in chips) 
Seat 5: king10clubs ($844.48 in chips) 
Seat 6: ZarubaNT ($642.20 in chips) 
floriiiiider: posts small blind $3
mustanggino: posts big blind $6
*** HOLE CARDS ***
JulyShort: folds 
king10clubs: folds 
ZarubaNT: folds 
leo 32824: folds 
floriiiiider: raises $12 to $18
mustanggino: folds 
Uncalled bet ($12) returned to floriiiiider
floriiiiider collected $12 from pot
floriiiiider: doesn't show hand 
*** SUMMARY ***
Total pot $12 | Rake $0 
Seat 1: leo 32824 (button) folded before Flop (didn't bet)
Seat 2: floriiiiider (small blind) collected ($12)
Seat 3: mustanggino (big blind) folded before Flop
Seat 4: JulyShort folded before Flop (didn't bet)
Seat 5: king10clubs folded before Flop (didn't bet)
Seat 6: ZarubaNT folded before Flop (didn't bet)


PokerStars Game #102595465600:  Hold'em No Limit ($3/$6 USD) - 2013/08/11 4:05:48 ET
Table 'Hakone VI 40-100 bb' 6-max Seat #1 is the button
Seat 1: leo 32824 ($819.74 in chips) 
Seat 2: floriiiiider ($600 in chips) 
Seat 3: checkitout12 ($603.45 in chips) 
Seat 4: JulyShort ($270.20 in chips) 
Seat 5: king10clubs ($805.04 in chips) 
Seat 6: NutPopper ($165 in chips) 
floriiiiider: posts small blind $3
checkitout12: posts big blind $6
*** HOLE CARDS ***
JulyShort: raises $9 to $15
king10clubs: folds 
NutPopper: folds 
leo 32824: folds 
floriiiiider: folds 
checkitout12: folds 
Uncalled bet ($9) returned to JulyShort
JulyShort collected $15 from pot
JulyShort: doesn't show hand 
*** SUMMARY ***
Total pot $15 | Rake $0 
Seat 1: leo 32824 (button) folded before Flop (didn't bet)
Seat 2: floriiiiider (small blind) folded before Flop
Seat 3: checkitout12 (big blind) folded before Flop
Seat 4: JulyShort collected ($15)
Seat 5: king10clubs folded before Flop (didn't bet)
Seat 6: NutPopper folded before Flop (didn't bet)


PokerStars Game #102595474656:  Hold'em No Limit ($3/$6 USD) - 2013/08/11 4:06:12 ET
Table 'Hakone VI 40-100 bb' 6-max Seat #2 is the button
Seat 1: leo 32824 ($819.74 in chips) 
Seat 2: floriiiiider ($600 in chips) 
Seat 3: checkitout12 ($597.45 in chips) 
Seat 4: JulyShort ($279.20 in chips) 
Seat 5: king10clubs ($805.04 in chips) 
Seat 6: NutPopper ($165 in chips) 
checkitout12: posts small blind $3
JulyShort: posts big blind $6
*** HOLE CARDS ***
king10clubs: folds 
NutPopper: folds 
leo 32824: folds 
floriiiiider: folds 
checkitout12: folds 
Uncalled bet ($3) returned to JulyShort
JulyShort collected $6 from pot
JulyShort: doesn't show hand 
*** SUMMARY ***
Total pot $6 | Rake $0 
Seat 1: leo 32824 folded before Flop (didn't bet)
Seat 2: floriiiiider (button) folded before Flop (didn't bet)
Seat 3: checkitout12 (small blind) folded before Flop
Seat 4: JulyShort (big blind) collected ($6)
Seat 5: king10clubs folded before Flop (didn't bet)
Seat 6: NutPopper folded before Flop (didn't bet)


PokerStars Game #102595480062:  Hold'em No Limit ($3/$6 USD) - 2013/08/11 4:06:27 ET
Table 'Hakone VI 40-100 bb' 6-max Seat #3 is the button
Seat 1: leo 32824 ($819.74 in chips) 
Seat 2: floriiiiider ($600 in chips) 
Seat 3: checkitout12 ($594.45 in chips) 
Seat 4: JulyShort ($282.20 in chips) 
Seat 5: king10clubs ($805.04 in chips) 
Seat 6: NutPopper ($165 in chips) 
JulyShort: posts small blind $3
king10clubs: posts big blind $6
*** HOLE CARDS ***
NutPopper: folds 
leo 32824: folds 
floriiiiider: folds 
checkitout12: folds 
JulyShort: folds 
Uncalled bet ($3) returned to king10clubs
king10clubs collected $6 from pot
king10clubs: doesn't show hand 
*** SUMMARY ***
Total pot $6 | Rake $0 
Seat 1: leo 32824 folded before Flop (didn't bet)
Seat 2: floriiiiider folded before Flop (didn't bet)
Seat 3: checkitout12 (button) folded before Flop (didn't bet)
Seat 4: JulyShort (small blind) folded before Flop
Seat 5: king10clubs (big blind) collected ($6)
Seat 6: NutPopper folded before Flop (didn't bet)


PokerStars Game #102595492032:  Hold'em No Limit ($3/$6 USD) - 2013/08/11 4:06:58 ET
Table 'Hakone VI 40-100 bb' 6-max Seat #4 is the button
Seat 1: leo 32824 ($819.74 in chips) 
Seat 2: floriiiiider ($600 in chips) 
Seat 3: checkitout12 ($594.45 in chips) 
Seat 4: JulyShort ($279.20 in chips) 
Seat 5: king10clubs ($808.04 in chips) 
king10clubs: posts small blind $3
NutPopper: is sitting out 
NutPopper leaves the table
leo 32824: posts big blind $6
*** HOLE CARDS ***
floriiiiider: raises $12 to $18
checkitout12: folds 
JulyShort: folds 
ZarubaNT joins the table at seat #6 
king10clubs: folds 
leo 32824: folds 
Uncalled bet ($12) returned to floriiiiider
floriiiiider collected $15 from pot
floriiiiider: doesn't show hand 
*** SUMMARY ***
Total pot $15 | Rake $0 
Seat 1: leo 32824 (big blind) folded before Flop
Seat 2: floriiiiider collected ($15)
Seat 3: checkitout12 folded before Flop (didn't bet)
Seat 4: JulyShort (button) folded before Flop (didn't bet)
Seat 5: king10clubs (small blind) folded before Flop


PokerStars Game #102595498793:  Hold'em No Limit ($3/$6 USD) - 2013/08/11 4:07:17 ET
Table 'Hakone VI 40-100 bb' 6-max Seat #5 is the button
Seat 1: leo 32824 ($813.74 in chips) 
Seat 2: floriiiiider ($609 in chips) 
Seat 3: checkitout12 ($594.45 in chips) 
Seat 4: JulyShort ($279.20 in chips) 
Seat 5: king10clubs ($805.04 in chips) 
ZarubaNT will be allowed to play after the button
leo 32824: posts small blind $3
floriiiiider: posts big blind $6
*** HOLE CARDS ***
checkitout12: folds 
JulyShort: folds 
king10clubs: raises $6 to $12
leo 32824: folds 
floriiiiider: folds 
Uncalled bet ($6) returned to king10clubs
king10clubs collected $15 from pot
king10clubs: doesn't show hand 
*** SUMMARY ***
Total pot $15 | Rake $0 
Seat 1: leo 32824 (small blind) folded before Flop
Seat 2: floriiiiider (big blind) folded before Flop
Seat 3: checkitout12 folded before Flop (didn't bet)
Seat 4: JulyShort folded before Flop (didn't bet)
Seat 5: king10clubs (button) collected ($15)


PokerStars Game #102595504126:  Hold'em No Limit ($3/$6 USD) - 2013/08/11 4:07:31 ET
Table 'Hakone VI 40-100 bb' 6-max Seat #1 is the button
Seat 1: leo 32824 ($810.74 in chips) 
Seat 2: floriiiiider ($603 in chips) 
Seat 4: JulyShort ($279.20 in chips) 
Seat 5: king10clubs ($814.04 in chips) 
floriiiiider: posts small blind $3
checkitout12: is sitting out 
JulyShort: posts big blind $6
ZarubaNT: sits out 
*** HOLE CARDS ***
king10clubs: folds 
leo 32824: folds 
checkitout12 leaves the table
floriiiiider: raises $12 to $18
mustanggino joins the table at seat #3 
JulyShort: folds 
Uncalled bet ($12) returned to floriiiiider
floriiiiider collected $12 from pot
floriiiiider: doesn't show hand 
*** SUMMARY ***
Total pot $12 | Rake $0 
Seat 1: leo 32824 (button) folded before Flop (didn't bet)
Seat 2: floriiiiider (small blind) collected ($12)
Seat 4: JulyShort (big blind) folded before Flop
Seat 5: king10clubs folded before Flop (didn't bet)


PokerStars Game #102595512260:  Hold'em No Limit ($3/$6 USD) - 2013/08/11 4:07:53 ET
Table 'Hakone VI 40-100 bb' 6-max Seat #2 is the button
Seat 1: leo 32824 ($810.74 in chips) 
Seat 2: floriiiiider ($609 in chips) 
Seat 4: JulyShort ($273.20 in chips) 
Seat 5: king10clubs ($814.04 in chips) 
mustanggino will be allowed to play after the button
JulyShort: posts small blind $3
king10clubs: posts big blind $6
ZarubaNT: sits out 
*** HOLE CARDS ***
leo 32824: folds 
floriiiiider: folds 
JulyShort: folds 
Uncalled bet ($3) returned to king10clubs
king10clubs collected $6 from pot
king10clubs: doesn't show hand 
*** SUMMARY ***
Total pot $6 | Rake $0 
Seat 1: leo 32824 folded before Flop (didn't bet)
Seat 2: floriiiiider (button) folded before Flop (didn't bet)
Seat 4: JulyShort (small blind) folded before Flop
Seat 5: king10clubs (big blind) collected ($6)


PokerStars Game #102595518716:  Hold'em No Limit ($3/$6 USD) - 2013/08/11 4:08:10 ET
Table 'Hakone VI 40-100 bb' 6-max Seat #4 is the button
Seat 1: leo 32824 ($810.74 in chips) 
Seat 2: floriiiiider ($609 in chips) 
Seat 4: JulyShort ($270.20 in chips) 
Seat 5: king10clubs ($817.04 in chips) 
Seat 6: ZarubaNT ($600 in chips) 
king10clubs: posts small blind $3
ZarubaNT: posts big blind $6
mustanggino: sits out 
*** HOLE CARDS ***
leo 32824: folds 
floriiiiider: folds 
JulyShort: folds 
king10clubs: folds 
Uncalled bet ($3) returned to ZarubaNT
ZarubaNT collected $6 from pot
ZarubaNT: doesn't show hand 
*** SUMMARY ***
Total pot $6 | Rake $0 
Seat 1: leo 32824 folded before Flop (didn't bet)
Seat 2: floriiiiider folded before Flop (didn't bet)
Seat 4: JulyShort (button) folded before Flop (didn't bet)
Seat 5: king10clubs (small blind) folded before Flop
Seat 6: ZarubaNT (big blind) collected ($6)


PokerStars Game #102595523473:  Hold'em No Limit ($3/$6 USD) - 2013/08/11 4:08:23 ET
Table 'Hakone VI 40-100 bb' 6-max Seat #5 is the button
Seat 1: leo 32824 ($810.74 in chips) 
Seat 2: floriiiiider ($609 in chips) 
Seat 4: JulyShort ($270.20 in chips) 
Seat 5: king10clubs ($814.04 in chips) 
Seat 6: ZarubaNT ($603 in chips) 
ZarubaNT: posts small blind $3
leo 32824: posts big blind $6
mustanggino: sits out 
*** HOLE CARDS ***
floriiiiider: folds 
JulyShort: raises $6 to $12
king10clubs: calls $12
ZarubaNT: folds 
leo 32824: folds 
*** FLOP *** [Jh 9s Ad]
JulyShort: bets $12
king10clubs: calls $12
*** TURN *** [Jh 9s Ad] [6s]
JulyShort: checks 
king10clubs: bets $48
JulyShort: folds 
Uncalled bet ($48) returned to king10clubs
king10clubs collected $54.44 from pot
king10clubs: doesn't show hand 
*** SUMMARY ***
Total pot $57 | Rake $2.56 
Board [Jh 9s Ad 6s]
Seat 1: leo 32824 (big blind) folded before Flop
Seat 2: floriiiiider folded before Flop (didn't bet)
Seat 4: JulyShort folded on the Turn
Seat 5: king10clubs (button) collected ($54.44)
Seat 6: ZarubaNT (small blind) folded before Flop


PokerStars Game #102595541008:  Hold'em No Limit ($3/$6 USD) - 2013/08/11 4:09:11 ET
Table 'Hakone VI 40-100 bb' 6-max Seat #6 is the button
Seat 1: leo 32824 ($804.74 in chips) 
Seat 2: floriiiiider ($609 in chips) 
Seat 4: JulyShort ($246.20 in chips) 
Seat 5: king10clubs ($844.48 in chips) 
Seat 6: ZarubaNT ($600 in chips) 
leo 32824: posts small blind $3
floriiiiider: posts big blind $6
mustanggino: sits out 
*** HOLE CARDS ***
JulyShort: raises $9 to $15
king10clubs: folds 
ZarubaNT: folds 
leo 32824: folds 
floriiiiider: folds 
Uncalled bet ($9) returned to JulyShort
JulyShort collected $15 from pot
JulyShort: doesn't show hand 
*** SUMMARY ***
Total pot $15 | Rake $0 
Seat 1: leo 32824 (small blind) folded before Flop
Seat 2: floriiiiider (big blind) folded before Flop
Seat 4: JulyShort collected ($15)
Seat 5: king10clubs folded before Flop (didn't bet)
Seat 6: ZarubaNT (button) folded before Flop (didn't bet)


PokerStars Game #102595548170:  Hold'em No Limit ($3/$6 USD) - 2013/08/11 4:09:31 ET
Table 'Hakone VI 40-100 bb' 6-max Seat #1 is the button
Seat 1: leo 32824 ($801.74 in chips) 
Seat 2: floriiiiider ($603 in chips) 
Seat 3: mustanggino ($450 in chips) 
Seat 4: JulyShort ($255.20 in chips) 
Seat 5: king10clubs ($844.48 in chips) 
Seat 6: ZarubaNT ($600 in chips) 
floriiiiider: posts small blind $3
mustanggino: posts big blind $6
*** HOLE CARDS ***
JulyShort: folds 
king10clubs: raises $9 to $15
ZarubaNT: raises $30 to $45
leo 32824: folds 
floriiiiider: folds 
mustanggino: folds 
king10clubs: calls $30
*** FLOP *** [9c Ac 6c]
king10clubs: checks 
ZarubaNT: checks 
*** TURN *** [9c Ac 6c] [Kd]
king10clubs: checks 
ZarubaNT: checks 
*** RIVER *** [9c Ac 6c Kd] [Qh]
king10clubs: checks 
ZarubaNT: bets $147
king10clubs: folds 
Uncalled bet ($147) returned to ZarubaNT
ZarubaNT collected $96.20 from pot
ZarubaNT: doesn't show hand 
*** SUMMARY ***
Total pot $99 | Rake $2.80 
Board [9c Ac 6c Kd Qh]
Seat 1: leo 32824 (button) folded before Flop (didn't bet)
Seat 2: floriiiiider (small blind) folded before Flop
Seat 3: mustanggino (big blind) folded before Flop
Seat 4: JulyShort folded before Flop (didn't bet)
Seat 5: king10clubs folded on the River
Seat 6: ZarubaNT collected ($96.20)


PokerStars Game #102595359900:  Hold'em No Limit ($3/$6 USD) - 2013/08/11 4:01:05 ET
Table 'Hakone VI 40-100 bb' 6-max Seat #6 is the button
Seat 1: leo 32824 ($435.27 in chips) 
Seat 3: checkitout12 ($633.63 in chips) 
Seat 5: king10clubs ($776.34 in chips) 
Seat 6: NutPopper ($174 in chips) 
leo 32824: posts small blind $3
vjxbkf: is sitting out 
checkitout12: posts big blind $6
JulyShort: sits out 
*** HOLE CARDS ***
king10clubs: raises $9 to $15
NutPopper: folds 
leo 32824: folds 
checkitout12: calls $9
*** FLOP *** [6s 2c 5d]
checkitout12: checks 
king10clubs: bets $21
checkitout12: folds 
Uncalled bet ($21) returned to king10clubs
king10clubs collected $31.52 from pot
king10clubs: doesn't show hand 
*** SUMMARY ***
Total pot $33 | Rake $1.48 
Board [6s 2c 5d]
Seat 1: leo 32824 (small blind) folded before Flop
Seat 3: checkitout12 (big blind) folded on the Flop
Seat 5: king10clubs collected ($31.52)
Seat 6: NutPopper (button) folded before Flop (didn't bet)


PokerStars Game #102595375331:  Hold'em No Limit ($3/$6 USD) - 2013/08/11 4:01:48 ET
Table 'Hakone VI 40-100 bb' 6-max Seat #1 is the button
Seat 1: leo 32824 ($432.27 in chips) 
Seat 3: checkitout12 ($618.63 in chips) 
Seat 4: JulyShort ($240 in chips) 
Seat 5: king10clubs ($792.86 in chips) 
Seat 6: NutPopper ($174 in chips) 
checkitout12: posts small blind $3
JulyShort: posts big blind $6
*** HOLE CARDS ***
king10clubs: folds 
vjxbkf leaves the table
NutPopper: folds 
leo 32824: folds 
checkitout12: folds 
Uncalled bet ($3) returned to JulyShort
JulyShort collected $6 from pot
JulyShort: doesn't show hand 
*** SUMMARY ***
Total pot $6 | Rake $0 
Seat 1: leo 32824 (button) folded before Flop (didn't bet)
Seat 3: checkitout12 (small blind) folded before Flop
Seat 4: JulyShort (big blind) collected ($6)
Seat 5: king10clubs folded before Flop (didn't bet)
Seat 6: NutPopper folded before Flop (didn't bet)


PokerStars Game #102595384712:  Hold'em No Limit ($3/$6 USD) - 2013/08/11 4:02:12 ET
Table 'Hakone VI 40-100 bb' 6-max Seat #3 is the button
Seat 1: leo 32824 ($432.27 in chips) 
Seat 3: checkitout12 ($615.63 in chips) 
Seat 4: JulyShort ($243 in chips) 
Seat 5: king10clubs ($792.86 in chips) 
Seat 6: NutPopper ($174 in chips) 
JulyShort: posts small blind $3
king10clubs: posts big blind $6
*** HOLE CARDS ***
NutPopper: folds 
leo 32824: folds 
checkitout12: raises $6.18 to $12.18
JulyShort: folds 
king10clubs: raises $35.82 to $48
checkitout12: folds 
Uncalled bet ($35.82) returned to king10clubs
king10clubs collected $27.36 from pot
king10clubs: doesn't show hand 
*** SUMMARY ***
Total pot $27.36 | Rake $0 
Seat 1: leo 32824 folded before Flop (didn't bet)
Seat 3: checkitout12 (button) folded before Flop
Seat 4: JulyShort (small blind) folded before Flop
Seat 5: king10clubs (big blind) collected ($27.36)
Seat 6: NutPopper folded before Flop (didn't bet)


PokerStars Game #102595402604:  Hold'em No Limit ($3/$6 USD) - 2013/08/11 4:02:59 ET
Table 'Hakone VI 40-100 bb' 6-max Seat #4 is the button
Seat 1: leo 32824 ($432.27 in chips) 
Seat 3: checkitout12 ($603.45 in chips) 
Seat 4: JulyShort ($240 in chips) 
Seat 5: king10clubs ($808.04 in chips) 
Seat 6: NutPopper ($174 in chips) 
king10clubs: posts small blind $3
NutPopper: posts big blind $6
*** HOLE CARDS ***
leo 32824: raises $6 to $12
checkitout12: folds 
JulyShort: folds 
king10clubs: folds 
NutPopper: folds 
Uncalled bet ($6) returned to leo 32824
leo 32824 collected $15 from pot
*** SUMMARY ***
Total pot $15 | Rake $0 
Seat 1: leo 32824 collected ($15)
Seat 3: checkitout12 folded before Flop (didn't bet)
Seat 4: JulyShort (button) folded before Flop (didn't bet)
Seat 5: king10clubs (small blind) folded before Flop
Seat 6: NutPopper (big blind) folded before Flop


PokerStars Game #102595414850:  Hold'em No Limit ($3/$6 USD) - 2013/08/11 4:03:32 ET
Table 'Hakone VI 40-100 bb' 6-max Seat #5 is the button
Seat 1: leo 32824 ($441.27 in chips) 
Seat 3: checkitout12 ($603.45 in chips) 
Seat 4: JulyShort ($240 in chips) 
Seat 5: king10clubs ($805.04 in chips) 
Seat 6: NutPopper ($168 in chips) 
NutPopper: posts small blind $3
leo 32824: posts big blind $6
*** HOLE CARDS ***
checkitout12: folds 
JulyShort: raises $6 to $12
king10clubs: folds 
NutPopper: folds 
leo 32824: calls $6
*** FLOP *** [Tc 6d 5c]
floriiiiider joins the table at seat #2 
leo 32824: bets $18
JulyShort: calls $18
*** TURN *** [Tc 6d 5c] [Qd]
leo 32824: checks 
JulyShort: checks 
*** RIVER *** [Tc 6d 5c Qd] [5d]
leo 32824: checks 
JulyShort: checks 
*** SHOW DOWN ***
leo 32824: shows [4s 4h] (two pair, Fives and Fours)
JulyShort: shows [7s 7c] (two pair, Sevens and Fives)
JulyShort collected $60.20 from pot
*** SUMMARY ***
Total pot $63 | Rake $2.80 
Board [Tc 6d 5c Qd 5d]
Seat 1: leo 32824 (big blind) showed [4s 4h] and lost with two pair, Fives and Fours
Seat 3: checkitout12 folded before Flop (didn't bet)
Seat 4: JulyShort showed [7s 7c] and won ($60.20) with two pair, Sevens and Fives
Seat 5: king10clubs (button) folded before Flop (didn't bet)
Seat 6: NutPopper (small blind) folded before Flop


PokerStars Game #102595434563:  Hold'em No Limit ($3/$6 USD) - 2013/08/11 4:04:25 ET
Table 'Hakone VI 40-100 bb' 6-max Seat #6 is the button
Seat 1: leo 32824 ($411.27 in chips) 
Seat 2: floriiiiider ($600 in chips) 
Seat 3: checkitout12 ($603.45 in chips) 
Seat 4: JulyShort ($270.20 in chips) 
Seat 5: king10clubs ($805.04 in chips) 
Seat 6: NutPopper ($165 in chips) 
leo 32824: posts small blind $3
floriiiiider: posts big blind $6
*** HOLE CARDS ***
checkitout12: folds 
JulyShort: folds 
king10clubs: folds 
NutPopper: folds 
leo 32824: raises $6 to $12
floriiiiider: calls $6
*** FLOP *** [Ks 8c 7c]
leo 32824: bets $18
floriiiiider: calls $18
*** TURN *** [Ks 8c 7c] [6d]
leo 32824: bets $30
floriiiiider: raises $81 to $111
leo 32824: calls $81
*** RIVER *** [Ks 8c 7c 6d] [Th]
leo 32824: checks 
floriiiiider: bets $279
leo 32824: calls $270.27 and is all-in
Uncalled bet ($8.73) returned to floriiiiider
*** SHOW DOWN ***
floriiiiider: shows [4c 3c] (high card King)
leo 32824: shows [Kc 9s] (a straight, Six to Ten)
leo 32824 collected $819.74 from pot
*** SUMMARY ***
Total pot $822.54 | Rake $2.80 
Board [Ks 8c 7c 6d Th]
Seat 1: leo 32824 (small blind) showed [Kc 9s] and won ($819.74) with a straight, Six to Ten
Seat 2: floriiiiider (big blind) showed [4c 3c] and lost with high card King
Seat 3: checkitout12 folded before Flop (didn't bet)
Seat 4: JulyShort folded before Flop (didn't bet)
Seat 5: king10clubs folded before Flop (didn't bet)
Seat 6: NutPopper (button) folded before Flop (didn't bet)


PokerStars Game #102595256335:  Hold'em No Limit ($3/$6 USD) - 2013/08/11 3:55:32 ET
Table 'Hakone VI 40-100 bb' 6-max Seat #6 is the button
Seat 1: leo 32824 ($435.27 in chips) 
Seat 2: vjxbkf ($672.47 in chips) 
Seat 3: checkitout12 ($440.76 in chips) 
Seat 5: king10clubs ($952.29 in chips) 
Seat 6: NutPopper ($183 in chips) 
leo 32824: posts small blind $3
vjxbkf: posts big blind $6
iviz21: sits out 
*** HOLE CARDS ***
checkitout12: folds 
king10clubs: raises $9 to $15
NutPopper: folds 
leo 32824: folds 
vjxbkf: calls $9
*** FLOP *** [7s 5c Ad]
vjxbkf: checks 
king10clubs: bets $21
vjxbkf: folds 
Uncalled bet ($21) returned to king10clubs
king10clubs collected $31.52 from pot
king10clubs: doesn't show hand 
*** SUMMARY ***
Total pot $33 | Rake $1.48 
Board [7s 5c Ad]
Seat 1: leo 32824 (small blind) folded before Flop
Seat 2: vjxbkf (big blind) folded on the Flop
Seat 3: checkitout12 folded before Flop (didn't bet)
Seat 5: king10clubs collected ($31.52)
Seat 6: NutPopper (button) folded before Flop (didn't bet)


PokerStars Game #102595280042:  Hold'em No Limit ($3/$6 USD) - 2013/08/11 3:56:51 ET
Table 'Hakone VI 40-100 bb' 6-max Seat #1 is the button
Seat 1: leo 32824 ($432.27 in chips) 
Seat 2: vjxbkf ($657.47 in chips) 
Seat 3: checkitout12 ($440.76 in chips) 
Seat 5: king10clubs ($968.81 in chips) 
Seat 6: NutPopper ($183 in chips) 
vjxbkf: posts small blind $3
checkitout12: posts big blind $6
iviz21: sits out 
*** HOLE CARDS ***
king10clubs: raises $9 to $15
NutPopper: folds 
leo 32824: folds 
vjxbkf: folds 
checkitout12: raises $30.92 to $45.92
king10clubs: raises $49.08 to $95
checkitout12: raises $345.76 to $440.76 and is all-in
king10clubs: calls $345.76
*** FIRST FLOP *** [4s 9d Kc]
*** FIRST TURN *** [4s 9d Kc] [6c]
*** FIRST RIVER *** [4s 9d Kc 6c] [5c]
*** SECOND FLOP *** [2d Qs 8s]
*** SECOND TURN *** [2d Qs 8s] [8d]
*** SECOND RIVER *** [2d Qs 8s 8d] [5d]
*** FIRST SHOW DOWN ***
checkitout12: shows [Ac Ks] (a pair of Kings)
king10clubs: shows [Kh Ah] (a pair of Kings)
checkitout12 collected $220.43 from pot
king10clubs collected $220.43 from pot
*** SECOND SHOW DOWN ***
checkitout12: shows [Ac Ks] (a pair of Eights)
king10clubs: shows [Kh Ah] (a pair of Eights)
checkitout12 collected $220.43 from pot
king10clubs collected $220.43 from pot
*** SUMMARY ***
Total pot $884.52 | Rake $2.80 
Hand was run twice
FIRST Board [4s 9d Kc 6c 5c]
SECOND Board [2d Qs 8s 8d 5d]
Seat 1: leo 32824 (button) folded before Flop (didn't bet)
Seat 2: vjxbkf (small blind) folded before Flop
Seat 3: checkitout12 (big blind) showed [Ac Ks] and won ($220.43) with a pair of Kings, and won ($220.43) with a pair of Eights
Seat 5: king10clubs showed [Kh Ah] and won ($220.43) with a pair of Kings, and won ($220.43) with a pair of Eights
Seat 6: NutPopper folded before Flop (didn't bet)


PokerStars Game #102595294989:  Hold'em No Limit ($3/$6 USD) - 2013/08/11 3:57:41 ET
Table 'Hakone VI 40-100 bb' 6-max Seat #2 is the button
Seat 1: leo 32824 ($432.27 in chips) 
Seat 2: vjxbkf ($654.47 in chips) 
Seat 3: checkitout12 ($440.86 in chips) 
Seat 4: iviz21 ($268.27 in chips) 
Seat 5: king10clubs ($968.91 in chips) 
Seat 6: NutPopper ($183 in chips) 
checkitout12: posts small blind $3
iviz21: posts big blind $6
*** HOLE CARDS ***
king10clubs: folds 
NutPopper: folds 
leo 32824: folds 
vjxbkf: raises $6 to $12
checkitout12: folds 
iviz21: raises $12 to $24
vjxbkf: calls $12
*** FLOP *** [3c 3h Qs]
iviz21: bets $18
vjxbkf: calls $18
*** TURN *** [3c 3h Qs] [4s]
iviz21: bets $30
vjxbkf: raises $45 to $75
iviz21: calls $45
*** RIVER *** [3c 3h Qs 4s] [6h]
iviz21: checks 
vjxbkf: bets $537.47 and is all-in
iviz21: calls $151.27 and is all-in
Uncalled bet ($386.20) returned to vjxbkf
*** SHOW DOWN ***
vjxbkf: shows [9d 3d] (three of a kind, Threes)
iviz21: shows [Ad As] (two pair, Aces and Threes)
vjxbkf collected $536.74 from pot
*** SUMMARY ***
Total pot $539.54 | Rake $2.80 
Board [3c 3h Qs 4s 6h]
Seat 1: leo 32824 folded before Flop (didn't bet)
Seat 2: vjxbkf (button) showed [9d 3d] and won ($536.74) with three of a kind, Threes
Seat 3: checkitout12 (small blind) folded before Flop
Seat 4: iviz21 (big blind) showed [Ad As] and lost with two pair, Aces and Threes
Seat 5: king10clubs folded before Flop (didn't bet)
Seat 6: NutPopper folded before Flop (didn't bet)


PokerStars Game #102595326427:  Hold'em No Limit ($3/$6 USD) - 2013/08/11 3:59:25 ET
Table 'Hakone VI 40-100 bb' 6-max Seat #3 is the button
Seat 1: leo 32824 ($432.27 in chips) 
Seat 2: vjxbkf ($922.94 in chips) 
Seat 3: checkitout12 ($437.86 in chips) 
Seat 5: king10clubs ($968.91 in chips) 
Seat 6: NutPopper ($183 in chips) 
king10clubs: posts small blind $3
NutPopper: posts big blind $6
*** HOLE CARDS ***
leo 32824: raises $9 to $15
iviz21 leaves the table
vjxbkf: folds 
JulyShort joins the table at seat #4 
checkitout12: folds 
king10clubs: folds 
NutPopper: folds 
Uncalled bet ($9) returned to leo 32824
leo 32824 collected $15 from pot
*** SUMMARY ***
Total pot $15 | Rake $0 
Seat 1: leo 32824 collected ($15)
Seat 2: vjxbkf folded before Flop (didn't bet)
Seat 3: checkitout12 (button) folded before Flop (didn't bet)
Seat 5: king10clubs (small blind) folded before Flop
Seat 6: NutPopper (big blind) folded before Flop


PokerStars Game #102595333142:  Hold'em No Limit ($3/$6 USD) - 2013/08/11 3:59:45 ET
Table 'Hakone VI 40-100 bb' 6-max Seat #5 is the button
Seat 1: leo 32824 ($441.27 in chips) 
Seat 2: vjxbkf ($922.94 in chips) 
Seat 3: checkitout12 ($437.86 in chips) 
Seat 5: king10clubs ($965.91 in chips) 
Seat 6: NutPopper ($177 in chips) 
NutPopper: posts small blind $3
leo 32824: posts big blind $6
JulyShort: sits out 
*** HOLE CARDS ***
vjxbkf: folds 
checkitout12: raises $6.18 to $12.18
king10clubs: calls $12.18
NutPopper: folds 
leo 32824: folds 
*** FLOP *** [4h 7d 5c]
checkitout12: bets $22.30
king10clubs: raises $42.70 to $65
checkitout12: calls $42.70
*** TURN *** [4h 7d 5c] [6d]
checkitout12: checks 
king10clubs: checks 
*** RIVER *** [4h 7d 5c 6d] [Qh]
checkitout12: bets $112.39
king10clubs: calls $112.39
*** SHOW DOWN ***
checkitout12: shows [8c 8s] (a straight, Four to Eight)
king10clubs: mucks hand 
checkitout12 collected $385.34 from pot
*** SUMMARY ***
Total pot $388.14 | Rake $2.80 
Board [4h 7d 5c 6d Qh]
Seat 1: leo 32824 (big blind) folded before Flop
Seat 2: vjxbkf folded before Flop (didn't bet)
Seat 3: checkitout12 showed [8c 8s] and won ($385.34) with a straight, Four to Eight
Seat 5: king10clubs (button) mucked
Seat 6: NutPopper (small blind) folded before Flop


PokerStars Game #102595881749:  Hold'em No Limit ($3/$6 USD) - 2013/08/11 4:25:13 ET
Table 'Hakone VI 40-100 bb' 6-max Seat #2 is the button
Seat 1: leo 32824 ($866.72 in chips) 
Seat 2: floriiiiider ($600 in chips) 
Seat 3: mustanggino ($493.72 in chips) 
Seat 4: JulyShort ($150.20 in chips) 
Seat 5: king10clubs ($694.48 in chips) 
Seat 6: ZarubaNT ($823.84 in chips) 
mustanggino: posts small blind $3
JulyShort: posts big blind $6
*** HOLE CARDS ***
king10clubs: folds 
ZarubaNT: folds 
leo 32824: folds 
floriiiiider: raises $6 to $12
mustanggino: folds 
JulyShort: folds 
Uncalled bet ($6) returned to floriiiiider
floriiiiider collected $15 from pot
floriiiiider: doesn't show hand 
*** SUMMARY ***
Total pot $15 | Rake $0 
Seat 1: leo 32824 folded before Flop (didn't bet)
Seat 2: floriiiiider (button) collected ($15)
Seat 3: mustanggino (small blind) folded before Flop
Seat 4: JulyShort (big blind) folded before Flop
Seat 5: king10clubs folded before Flop (didn't bet)
Seat 6: ZarubaNT folded before Flop (didn't bet)


PokerStars Game #102595891299:  Hold'em No Limit ($3/$6 USD) - 2013/08/11 4:25:41 ET
Table 'Hakone VI 40-100 bb' 6-max Seat #3 is the button
Seat 1: leo 32824 ($866.72 in chips) 
Seat 2: floriiiiider ($609 in chips) 
Seat 3: mustanggino ($490.72 in chips) 
Seat 4: JulyShort ($144.20 in chips) 
Seat 5: king10clubs ($694.48 in chips) 
Seat 6: ZarubaNT ($823.84 in chips) 
JulyShort: posts small blind $3
king10clubs: posts big blind $6
*** HOLE CARDS ***
ZarubaNT: folds 
leo 32824: folds 
floriiiiider: folds 
mustanggino: folds 
JulyShort: folds 
Uncalled bet ($3) returned to king10clubs
king10clubs collected $6 from pot
king10clubs: doesn't show hand 
*** SUMMARY ***
Total pot $6 | Rake $0 
Seat 1: leo 32824 folded before Flop (didn't bet)
Seat 2: floriiiiider folded before Flop (didn't bet)
Seat 3: mustanggino (button) folded before Flop (didn't bet)
Seat 4: JulyShort (small blind) folded before Flop
Seat 5: king10clubs (big blind) collected ($6)
Seat 6: ZarubaNT folded before Flop (didn't bet)


PokerStars Game #102595896137:  Hold'em No Limit ($3/$6 USD) - 2013/08/11 4:25:55 ET
Table 'Hakone VI 40-100 bb' 6-max Seat #4 is the button
Seat 1: leo 32824 ($866.72 in chips) 
Seat 2: floriiiiider ($609 in chips) 
Seat 3: mustanggino ($490.72 in chips) 
Seat 4: JulyShort ($141.20 in chips) 
Seat 5: king10clubs ($697.48 in chips) 
Seat 6: ZarubaNT ($823.84 in chips) 
king10clubs: posts small blind $3
ZarubaNT: posts big blind $6
*** HOLE CARDS ***
leo 32824: folds 
floriiiiider: folds 
mustanggino: folds 
JulyShort: folds 
king10clubs: raises $6 to $12
ZarubaNT: calls $6
*** FLOP *** [9s 3c 7h]
king10clubs: checks 
ZarubaNT: checks 
*** TURN *** [9s 3c 7h] [4s]
king10clubs: checks 
ZarubaNT: bets $18
king10clubs: calls $18
*** RIVER *** [9s 3c 7h 4s] [Jh]
king10clubs: checks 
ZarubaNT: checks 
*** SHOW DOWN ***
king10clubs: shows [6s Ad] (high card Ace)
ZarubaNT: shows [8d 7d] (a pair of Sevens)
ZarubaNT collected $57.30 from pot
*** SUMMARY ***
Total pot $60 | Rake $2.70 
Board [9s 3c 7h 4s Jh]
Seat 1: leo 32824 folded before Flop (didn't bet)
Seat 2: floriiiiider folded before Flop (didn't bet)
Seat 3: mustanggino folded before Flop (didn't bet)
Seat 4: JulyShort (button) folded before Flop (didn't bet)
Seat 5: king10clubs (small blind) showed [6s Ad] and lost with high card Ace
Seat 6: ZarubaNT (big blind) showed [8d 7d] and won ($57.30) with a pair of Sevens


PokerStars Game #102595919155:  Hold'em No Limit ($3/$6 USD) - 2013/08/11 4:27:01 ET
Table 'Hakone VI 40-100 bb' 6-max Seat #5 is the button
Seat 1: leo 32824 ($866.72 in chips) 
Seat 2: floriiiiider ($609 in chips) 
Seat 3: mustanggino ($490.72 in chips) 
Seat 4: JulyShort ($141.20 in chips) 
Seat 5: king10clubs ($667.48 in chips) 
Seat 6: ZarubaNT ($851.14 in chips) 
ZarubaNT: posts small blind $3
leo 32824: posts big blind $6
*** HOLE CARDS ***
floriiiiider: folds 
mustanggino: raises $6 to $12
JulyShort: folds 
king10clubs: folds 
ZarubaNT: folds 
leo 32824: folds 
Uncalled bet ($6) returned to mustanggino
mustanggino collected $15 from pot
mustanggino: doesn't show hand 
*** SUMMARY ***
Total pot $15 | Rake $0 
Seat 1: leo 32824 (big blind) folded before Flop
Seat 2: floriiiiider folded before Flop (didn't bet)
Seat 3: mustanggino collected ($15)
Seat 4: JulyShort folded before Flop (didn't bet)
Seat 5: king10clubs (button) folded before Flop (didn't bet)
Seat 6: ZarubaNT (small blind) folded before Flop


PokerStars Game #102595927736:  Hold'em No Limit ($3/$6 USD) - 2013/08/11 4:27:26 ET
Table 'Hakone VI 40-100 bb' 6-max Seat #6 is the button
Seat 1: leo 32824 ($860.72 in chips) 
Seat 2: floriiiiider ($609 in chips) 
Seat 3: mustanggino ($499.72 in chips) 
Seat 4: JulyShort ($141.20 in chips) 
Seat 5: king10clubs ($667.48 in chips) 
Seat 6: ZarubaNT ($848.14 in chips) 
leo 32824: posts small blind $3
floriiiiider: posts big blind $6
*** HOLE CARDS ***
mustanggino: folds 
JulyShort: folds 
king10clubs: folds 
ZarubaNT: folds 
leo 32824: folds 
Uncalled bet ($3) returned to floriiiiider
floriiiiider collected $6 from pot
floriiiiider: doesn't show hand 
*** SUMMARY ***
Total pot $6 | Rake $0 
Seat 1: leo 32824 (small blind) folded before Flop
Seat 2: floriiiiider (big blind) collected ($6)
Seat 3: mustanggino folded before Flop (didn't bet)
Seat 4: JulyShort folded before Flop (didn't bet)
Seat 5: king10clubs folded before Flop (didn't bet)
Seat 6: ZarubaNT (button) folded before Flop (didn't bet)


PokerStars Game #102595936515:  Hold'em No Limit ($3/$6 USD) - 2013/08/11 4:27:51 ET
Table 'Hakone VI 40-100 bb' 6-max Seat #1 is the button
Seat 1: leo 32824 ($857.72 in chips) 
Seat 2: floriiiiider ($612 in chips) 
Seat 3: mustanggino ($499.72 in chips) 
Seat 4: JulyShort ($141.20 in chips) 
Seat 5: king10clubs ($667.48 in chips) 
Seat 6: ZarubaNT ($848.14 in chips) 
floriiiiider: posts small blind $3
mustanggino: posts big blind $6
*** HOLE CARDS ***
JulyShort: folds 
king10clubs: folds 
ZarubaNT: raises $9 to $15
leo 32824: folds 
floriiiiider: folds 
mustanggino: folds 
Uncalled bet ($9) returned to ZarubaNT
ZarubaNT collected $15 from pot
ZarubaNT: doesn't show hand 
*** SUMMARY ***
Total pot $15 | Rake $0 
Seat 1: leo 32824 (button) folded before Flop (didn't bet)
Seat 2: floriiiiider (small blind) folded before Flop
Seat 3: mustanggino (big blind) folded before Flop
Seat 4: JulyShort folded before Flop (didn't bet)
Seat 5: king10clubs folded before Flop (didn't bet)
Seat 6: ZarubaNT collected ($15)


PokerStars Game #102595945303:  Hold'em No Limit ($3/$6 USD) - 2013/08/11 4:28:16 ET
Table 'Hakone VI 40-100 bb' 6-max Seat #2 is the button
Seat 1: leo 32824 ($857.72 in chips) 
Seat 2: floriiiiider ($609 in chips) 
Seat 3: mustanggino ($493.72 in chips) 
Seat 4: JulyShort ($141.20 in chips) 
Seat 5: king10clubs ($667.48 in chips) 
Seat 6: ZarubaNT ($857.14 in chips) 
mustanggino: posts small blind $3
JulyShort: posts big blind $6
*** HOLE CARDS ***
king10clubs: folds 
ZarubaNT: raises $12 to $18
leo 32824: folds 
floriiiiider: folds 
mustanggino: raises $48 to $66
JulyShort: folds 
ZarubaNT: folds 
Uncalled bet ($48) returned to mustanggino
mustanggino collected $42 from pot
mustanggino: doesn't show hand 
*** SUMMARY ***
Total pot $42 | Rake $0 
Seat 1: leo 32824 folded before Flop (didn't bet)
Seat 2: floriiiiider (button) folded before Flop (didn't bet)
Seat 3: mustanggino (small blind) collected ($42)
Seat 4: JulyShort (big blind) folded before Flop
Seat 5: king10clubs folded before Flop (didn't bet)
Seat 6: ZarubaNT folded before Flop


PokerStars Game #102595965096:  Hold'em No Limit ($3/$6 USD) - 2013/08/11 4:29:14 ET
Table 'Hakone VI 40-100 bb' 6-max Seat #3 is the button
Seat 1: leo 32824 ($857.72 in chips) 
Seat 2: floriiiiider ($609 in chips) 
Seat 3: mustanggino ($517.72 in chips) 
Seat 4: JulyShort ($135.20 in chips) 
Seat 5: king10clubs ($667.48 in chips) 
Seat 6: ZarubaNT ($839.14 in chips) 
JulyShort: posts small blind $3
king10clubs: posts big blind $6
*** HOLE CARDS ***
ZarubaNT: folds 
leo 32824: folds 
floriiiiider: folds 
mustanggino: raises $6 to $12
JulyShort: folds 
king10clubs: calls $6
*** FLOP *** [6s Qs Ac]
king10clubs: checks 
mustanggino: bets $12
king10clubs: raises $36 to $48
mustanggino: folds 
Uncalled bet ($36) returned to king10clubs
king10clubs collected $48.70 from pot
king10clubs: doesn't show hand 
*** SUMMARY ***
Total pot $51 | Rake $2.30 
Board [6s Qs Ac]
Seat 1: leo 32824 folded before Flop (didn't bet)
Seat 2: floriiiiider folded before Flop (didn't bet)
Seat 3: mustanggino (button) folded on the Flop
Seat 4: JulyShort (small blind) folded before Flop
Seat 5: king10clubs (big blind) collected ($48.70)
Seat 6: ZarubaNT folded before Flop (didn't bet)


PokerStars Game #102595786644:  Hold'em No Limit ($3/$6 USD) - 2013/08/11 4:20:41 ET
Table 'Hakone VI 40-100 bb' 6-max Seat #3 is the button
Seat 1: leo 32824 ($848.52 in chips) 
Seat 2: floriiiiider ($600 in chips) 
Seat 3: mustanggino ($520.72 in chips) 
Seat 4: JulyShort ($153.20 in chips) 
Seat 5: king10clubs ($685.48 in chips) 
Seat 6: ZarubaNT ($787.64 in chips) 
JulyShort: posts small blind $3
king10clubs: posts big blind $6
*** HOLE CARDS ***
ZarubaNT: folds 
leo 32824: folds 
floriiiiider: folds 
mustanggino: folds 
JulyShort: folds 
Uncalled bet ($3) returned to king10clubs
king10clubs collected $6 from pot
king10clubs: doesn't show hand 
*** SUMMARY ***
Total pot $6 | Rake $0 
Seat 1: leo 32824 folded before Flop (didn't bet)
Seat 2: floriiiiider folded before Flop (didn't bet)
Seat 3: mustanggino (button) folded before Flop (didn't bet)
Seat 4: JulyShort (small blind) folded before Flop
Seat 5: king10clubs (big blind) collected ($6)
Seat 6: ZarubaNT folded before Flop (didn't bet)


PokerStars Game #102595800980:  Hold'em No Limit ($3/$6 USD) - 2013/08/11 4:21:21 ET
Table 'Hakone VI 40-100 bb' 6-max Seat #4 is the button
Seat 1: leo 32824 ($848.52 in chips) 
Seat 2: floriiiiider ($600 in chips) 
Seat 3: mustanggino ($520.72 in chips) 
Seat 4: JulyShort ($150.20 in chips) 
Seat 5: king10clubs ($688.48 in chips) 
Seat 6: ZarubaNT ($787.64 in chips) 
king10clubs: posts small blind $3
ZarubaNT: posts big blind $6
*** HOLE CARDS ***
leo 32824: folds 
floriiiiider: folds 
mustanggino: folds 
JulyShort: folds 
king10clubs: raises $9 to $15
ZarubaNT: folds 
Uncalled bet ($9) returned to king10clubs
king10clubs collected $12 from pot
king10clubs: doesn't show hand 
*** SUMMARY ***
Total pot $12 | Rake $0 
Seat 1: leo 32824 folded before Flop (didn't bet)
Seat 2: floriiiiider folded before Flop (didn't bet)
Seat 3: mustanggino folded before Flop (didn't bet)
Seat 4: JulyShort (button) folded before Flop (didn't bet)
Seat 5: king10clubs (small blind) collected ($12)
Seat 6: ZarubaNT (big blind) folded before Flop


PokerStars Game #102595817104:  Hold'em No Limit ($3/$6 USD) - 2013/08/11 4:22:07 ET
Table 'Hakone VI 40-100 bb' 6-max Seat #5 is the button
Seat 1: leo 32824 ($848.52 in chips) 
Seat 2: floriiiiider ($600 in chips) 
Seat 3: mustanggino ($520.72 in chips) 
Seat 4: JulyShort ($150.20 in chips) 
Seat 5: king10clubs ($694.48 in chips) 
Seat 6: ZarubaNT ($781.64 in chips) 
ZarubaNT: posts small blind $3
leo 32824: posts big blind $6
*** HOLE CARDS ***
floriiiiider: folds 
mustanggino: raises $6 to $12
JulyShort: folds 
king10clubs: folds 
ZarubaNT: folds 
leo 32824 is disconnected 
leo 32824 is connected 
leo 32824: calls $6
*** FLOP *** [Qs 7d 5c]
leo 32824: bets $18
mustanggino: calls $18
*** TURN *** [Qs 7d 5c] [3c]
leo 32824: checks 
mustanggino: checks 
*** RIVER *** [Qs 7d 5c 3c] [5d]
leo 32824: checks 
mustanggino: checks 
*** SHOW DOWN ***
leo 32824: shows [7c Tc] (two pair, Sevens and Fives)
mustanggino: mucks hand 
leo 32824 collected $60.20 from pot
*** SUMMARY ***
Total pot $63 | Rake $2.80 
Board [Qs 7d 5c 3c 5d]
Seat 1: leo 32824 (big blind) showed [7c Tc] and won ($60.20) with two pair, Sevens and Fives
Seat 2: floriiiiider folded before Flop (didn't bet)
Seat 3: mustanggino mucked
Seat 4: JulyShort folded before Flop (didn't bet)
Seat 5: king10clubs (button) folded before Flop (didn't bet)
Seat 6: ZarubaNT (small blind) folded before Flop


PokerStars Game #102595853941:  Hold'em No Limit ($3/$6 USD) - 2013/08/11 4:23:53 ET
Table 'Hakone VI 40-100 bb' 6-max Seat #6 is the button
Seat 1: leo 32824 ($878.72 in chips) 
Seat 2: floriiiiider ($600 in chips) 
Seat 3: mustanggino ($490.72 in chips) 
Seat 4: JulyShort ($150.20 in chips) 
Seat 5: king10clubs ($694.48 in chips) 
Seat 6: ZarubaNT ($778.64 in chips) 
leo 32824: posts small blind $3
floriiiiider: posts big blind $6
*** HOLE CARDS ***
mustanggino: folds 
JulyShort: folds 
king10clubs: folds 
ZarubaNT: raises $6 to $12
leo 32824: calls $9
floriiiiider: calls $6
*** FLOP *** [9d 3d 2d]
leo 32824: checks 
floriiiiider: checks 
ZarubaNT: checks 
*** TURN *** [9d 3d 2d] [6h]
leo 32824: checks 
floriiiiider: bets $24
ZarubaNT: calls $24
leo 32824: folds 
*** RIVER *** [9d 3d 2d 6h] [Ts]
floriiiiider: checks 
ZarubaNT: checks 
*** SHOW DOWN ***
floriiiiider: shows [4s 4h] (a pair of Fours)
ZarubaNT: shows [7h 7s] (a pair of Sevens)
ZarubaNT collected $81.20 from pot
*** SUMMARY ***
Total pot $84 | Rake $2.80 
Board [9d 3d 2d 6h Ts]
Seat 1: leo 32824 (small blind) folded on the Turn
Seat 2: floriiiiider (big blind) showed [4s 4h] and lost with a pair of Fours
Seat 3: mustanggino folded before Flop (didn't bet)
Seat 4: JulyShort folded before Flop (didn't bet)
Seat 5: king10clubs folded before Flop (didn't bet)
Seat 6: ZarubaNT (button) showed [7h 7s] and won ($81.20) with a pair of Sevens


PokerStars Game #102595875927:  Hold'em No Limit ($3/$6 USD) - 2013/08/11 4:24:57 ET
Table 'Hakone VI 40-100 bb' 6-max Seat #1 is the button
Seat 1: leo 32824 ($866.72 in chips) 
Seat 2: floriiiiider ($600 in chips) 
Seat 3: mustanggino ($490.72 in chips) 
Seat 4: JulyShort ($150.20 in chips) 
Seat 5: king10clubs ($694.48 in chips) 
Seat 6: ZarubaNT ($823.84 in chips) 
floriiiiider: posts small blind $3
mustanggino: posts big blind $6
*** HOLE CARDS ***
JulyShort: folds 
king10clubs: folds 
ZarubaNT: folds 
leo 32824: folds 
floriiiiider: folds 
Uncalled bet ($3) returned to mustanggino
mustanggino collected $6 from pot
mustanggino: doesn't show hand 
*** SUMMARY ***
Total pot $6 | Rake $0 
Seat 1: leo 32824 (button) folded before Flop (didn't bet)
Seat 2: floriiiiider (small blind) folded before Flop
Seat 3: mustanggino (big blind) collected ($6)
Seat 4: JulyShort folded before Flop (didn't bet)
Seat 5: king10clubs folded before Flop (didn't bet)
Seat 6: ZarubaNT folded before Flop (didn't bet)


PokerStars Game #102595665220:  Hold'em No Limit ($3/$6 USD) - 2013/08/11 4:15:00 ET
Table 'Hakone VI 40-100 bb' 6-max Seat #2 is the button
Seat 1: leo 32824 ($792.74 in chips) 
Seat 2: floriiiiider ($606 in chips) 
Seat 3: mustanggino ($450 in chips) 
Seat 4: JulyShort ($264.20 in chips) 
Seat 5: king10clubs ($844.48 in chips) 
Seat 6: ZarubaNT ($642.20 in chips) 
mustanggino: posts small blind $3
JulyShort: posts big blind $6
*** HOLE CARDS ***
king10clubs: folds 
ZarubaNT: folds 
leo 32824: raises $6 to $12
floriiiiider: folds 
mustanggino: folds 
JulyShort: folds 
Uncalled bet ($6) returned to leo 32824
leo 32824 collected $15 from pot
*** SUMMARY ***
Total pot $15 | Rake $0 
Seat 1: leo 32824 collected ($15)
Seat 2: floriiiiider (button) folded before Flop (didn't bet)
Seat 3: mustanggino (small blind) folded before Flop
Seat 4: JulyShort (big blind) folded before Flop
Seat 5: king10clubs folded before Flop (didn't bet)
Seat 6: ZarubaNT folded before Flop (didn't bet)


PokerStars Game #102595676320:  Hold'em No Limit ($3/$6 USD) - 2013/08/11 4:15:30 ET
Table 'Hakone VI 40-100 bb' 6-max Seat #3 is the button
Seat 1: leo 32824 ($801.74 in chips) 
Seat 2: floriiiiider ($606 in chips) 
Seat 3: mustanggino ($450 in chips) 
Seat 4: JulyShort ($258.20 in chips) 
Seat 5: king10clubs ($844.48 in chips) 
Seat 6: ZarubaNT ($642.20 in chips) 
JulyShort: posts small blind $3
king10clubs: posts big blind $6
*** HOLE CARDS ***
ZarubaNT: raises $12 to $18
leo 32824: folds 
floriiiiider: folds 
mustanggino: folds 
JulyShort: folds 
king10clubs: raises $42 to $60
ZarubaNT: calls $42
*** FLOP *** [Qh 3c 6c]
king10clubs: checks 
ZarubaNT: checks 
*** TURN *** [Qh 3c 6c] [Kh]
king10clubs: checks 
ZarubaNT: checks 
*** RIVER *** [Qh 3c 6c Kh] [3d]
king10clubs: bets $72
ZarubaNT: calls $72
*** SHOW DOWN ***
king10clubs: shows [9d Ad] (a pair of Threes)
ZarubaNT: shows [Qs Ac] (two pair, Queens and Threes)
ZarubaNT collected $264.20 from pot
*** SUMMARY ***
Total pot $267 | Rake $2.80 
Board [Qh 3c 6c Kh 3d]
Seat 1: leo 32824 folded before Flop (didn't bet)
Seat 2: floriiiiider folded before Flop (didn't bet)
Seat 3: mustanggino (button) folded before Flop (didn't bet)
Seat 4: JulyShort (small blind) folded before Flop
Seat 5: king10clubs (big blind) showed [9d Ad] and lost with a pair of Threes
Seat 6: ZarubaNT showed [Qs Ac] and won ($264.20) with two pair, Queens and Threes


PokerStars Game #102595701120:  Hold'em No Limit ($3/$6 USD) - 2013/08/11 4:16:40 ET
Table 'Hakone VI 40-100 bb' 6-max Seat #4 is the button
Seat 1: leo 32824 ($801.74 in chips) 
Seat 2: floriiiiider ($606 in chips) 
Seat 3: mustanggino ($450 in chips) 
Seat 4: JulyShort ($255.20 in chips) 
Seat 5: king10clubs ($712.48 in chips) 
Seat 6: ZarubaNT ($774.40 in chips) 
king10clubs: posts small blind $3
ZarubaNT: posts big blind $6
*** HOLE CARDS ***
leo 32824: raises $9 to $15
floriiiiider: folds 
mustanggino: folds 
JulyShort: raises $27 to $42
king10clubs: folds 
ZarubaNT: folds 
leo 32824: raises $54 to $96
JulyShort: folds 
Uncalled bet ($54) returned to leo 32824
leo 32824 collected $93 from pot
*** SUMMARY ***
Total pot $93 | Rake $0 
Seat 1: leo 32824 collected ($93)
Seat 2: floriiiiider folded before Flop (didn't bet)
Seat 3: mustanggino folded before Flop (didn't bet)
Seat 4: JulyShort (button) folded before Flop
Seat 5: king10clubs (small blind) folded before Flop
Seat 6: ZarubaNT (big blind) folded before Flop


PokerStars Game #102595717988:  Hold'em No Limit ($3/$6 USD) - 2013/08/11 4:17:27 ET
Table 'Hakone VI 40-100 bb' 6-max Seat #5 is the button
Seat 1: leo 32824 ($852.74 in chips) 
Seat 2: floriiiiider ($606 in chips) 
Seat 3: mustanggino ($450 in chips) 
Seat 4: JulyShort ($213.20 in chips) 
Seat 5: king10clubs ($709.48 in chips) 
Seat 6: ZarubaNT ($768.40 in chips) 
ZarubaNT: posts small blind $3
leo 32824: posts big blind $6
*** HOLE CARDS ***
floriiiiider: folds 
mustanggino: folds 
JulyShort: folds 
king10clubs: raises $6 to $12
ZarubaNT: folds 
leo 32824: calls $6
*** FLOP *** [Kc 7d 5d]
leo 32824: bets $24
king10clubs: folds 
Uncalled bet ($24) returned to leo 32824
leo 32824 collected $25.78 from pot
*** SUMMARY ***
Total pot $27 | Rake $1.22 
Board [Kc 7d 5d]
Seat 1: leo 32824 (big blind) collected ($25.78)
Seat 2: floriiiiider folded before Flop (didn't bet)
Seat 3: mustanggino folded before Flop (didn't bet)
Seat 4: JulyShort folded before Flop (didn't bet)
Seat 5: king10clubs (button) folded on the Flop
Seat 6: ZarubaNT (small blind) folded before Flop


PokerStars Game #102595729284:  Hold'em No Limit ($3/$6 USD) - 2013/08/11 4:17:59 ET
Table 'Hakone VI 40-100 bb' 6-max Seat #6 is the button
Seat 1: leo 32824 ($866.52 in chips) 
Seat 2: floriiiiider ($606 in chips) 
Seat 3: mustanggino ($450 in chips) 
Seat 4: JulyShort ($213.20 in chips) 
Seat 5: king10clubs ($697.48 in chips) 
Seat 6: ZarubaNT ($765.40 in chips) 
leo 32824: posts small blind $3
floriiiiider: posts big blind $6
*** HOLE CARDS ***
mustanggino: raises $6 to $12
JulyShort: folds 
king10clubs: calls $12
ZarubaNT: folds 
leo 32824: folds 
floriiiiider: folds 
*** FLOP *** [9s 8d As]
mustanggino: bets $18
king10clubs: folds 
Uncalled bet ($18) returned to mustanggino
mustanggino collected $31.52 from pot
mustanggino: doesn't show hand 
*** SUMMARY ***
Total pot $33 | Rake $1.48 
Board [9s 8d As]
Seat 1: leo 32824 (small blind) folded before Flop
Seat 2: floriiiiider (big blind) folded before Flop
Seat 3: mustanggino collected ($31.52)
Seat 4: JulyShort folded before Flop (didn't bet)
Seat 5: king10clubs folded on the Flop
Seat 6: ZarubaNT (button) folded before Flop (didn't bet)


PokerStars Game #102595740802:  Hold'em No Limit ($3/$6 USD) - 2013/08/11 4:18:31 ET
Table 'Hakone VI 40-100 bb' 6-max Seat #1 is the button
Seat 1: leo 32824 ($863.52 in chips) 
Seat 2: floriiiiider ($600 in chips) 
Seat 3: mustanggino ($469.52 in chips) 
Seat 4: JulyShort ($213.20 in chips) 
Seat 5: king10clubs ($685.48 in chips) 
Seat 6: ZarubaNT ($765.40 in chips) 
floriiiiider: posts small blind $3
mustanggino: posts big blind $6
*** HOLE CARDS ***
JulyShort: folds 
king10clubs: folds 
ZarubaNT: raises $9 to $15
leo 32824: calls $15
floriiiiider: folds 
mustanggino: folds 
*** FLOP *** [3d Kc Js]
ZarubaNT: checks 
leo 32824: checks 
*** TURN *** [3d Kc Js] [7h]
ZarubaNT: bets $27
leo 32824: folds 
Uncalled bet ($27) returned to ZarubaNT
ZarubaNT collected $37.24 from pot
ZarubaNT: doesn't show hand 
*** SUMMARY ***
Total pot $39 | Rake $1.76 
Board [3d Kc Js 7h]
Seat 1: leo 32824 (button) folded on the Turn
Seat 2: floriiiiider (small blind) folded before Flop
Seat 3: mustanggino (big blind) folded before Flop
Seat 4: JulyShort folded before Flop (didn't bet)
Seat 5: king10clubs folded before Flop (didn't bet)
Seat 6: ZarubaNT collected ($37.24)


PokerStars Game #102595757130:  Hold'em No Limit ($3/$6 USD) - 2013/08/11 4:19:17 ET
Table 'Hakone VI 40-100 bb' 6-max Seat #2 is the button
Seat 1: leo 32824 ($848.52 in chips) 
Seat 2: floriiiiider ($600 in chips) 
Seat 3: mustanggino ($463.52 in chips) 
Seat 4: JulyShort ($213.20 in chips) 
Seat 5: king10clubs ($685.48 in chips) 
Seat 6: ZarubaNT ($787.64 in chips) 
mustanggino: posts small blind $3
JulyShort: posts big blind $6
*** HOLE CARDS ***
king10clubs: folds 
ZarubaNT: folds 
leo 32824: folds 
floriiiiider: folds 
mustanggino: raises $6 to $12
JulyShort: calls $6
*** FLOP *** [5d 4d 7s]
mustanggino: bets $12
JulyShort: calls $12
*** TURN *** [5d 4d 7s] [Jd]
mustanggino: bets $36
JulyShort: calls $36
*** RIVER *** [5d 4d 7s Jd] [6h]
mustanggino: bets $90
JulyShort: folds 
Uncalled bet ($90) returned to mustanggino
mustanggino collected $117.20 from pot
mustanggino: doesn't show hand 
*** SUMMARY ***
Total pot $120 | Rake $2.80 
Board [5d 4d 7s Jd 6h]
Seat 1: leo 32824 folded before Flop (didn't bet)
Seat 2: floriiiiider (button) folded before Flop (didn't bet)
Seat 3: mustanggino (small blind) collected ($117.20)
Seat 4: JulyShort (big blind) folded on the River
Seat 5: king10clubs folded before Flop (didn't bet)
Seat 6: ZarubaNT folded before Flop (didn't bet)


PokerStars Game #102596194296:  Hold'em No Limit ($3/$6 USD) - 2013/08/11 4:40:01 ET
Table 'Hakone VI 40-100 bb' 6-max Seat #6 is the button
Seat 1: leo 32824 ($814.10 in chips) 
Seat 2: floriiiiider ($652.24 in chips) 
Seat 3: mustanggino ($469.72 in chips) 
Seat 4: JulyShort ($111.20 in chips) 
Seat 5: king10clubs ($654.70 in chips) 
Seat 6: ZarubaNT ($915.38 in chips) 
leo 32824: posts small blind $3
floriiiiider: posts big blind $6
*** HOLE CARDS ***
mustanggino: folds 
JulyShort: folds 
king10clubs: raises $9 to $15
ZarubaNT: folds 
leo 32824: folds 
floriiiiider: folds 
Uncalled bet ($9) returned to king10clubs
king10clubs collected $15 from pot
king10clubs: doesn't show hand 
*** SUMMARY ***
Total pot $15 | Rake $0 
Seat 1: leo 32824 (small blind) folded before Flop
Seat 2: floriiiiider (big blind) folded before Flop
Seat 3: mustanggino folded before Flop (didn't bet)
Seat 4: JulyShort folded before Flop (didn't bet)
Seat 5: king10clubs collected ($15)
Seat 6: ZarubaNT (button) folded before Flop (didn't bet)


PokerStars Game #102596201457:  Hold'em No Limit ($3/$6 USD) - 2013/08/11 4:40:22 ET
Table 'Hakone VI 40-100 bb' 6-max Seat #1 is the button
Seat 1: leo 32824 ($811.10 in chips) 
Seat 2: floriiiiider ($646.24 in chips) 
Seat 3: mustanggino ($469.72 in chips) 
Seat 4: JulyShort ($111.20 in chips) 
Seat 5: king10clubs ($663.70 in chips) 
Seat 6: ZarubaNT ($915.38 in chips) 
floriiiiider: posts small blind $3
mustanggino: posts big blind $6
*** HOLE CARDS ***
JulyShort: folds 
king10clubs: folds 
ZarubaNT: folds 
leo 32824: raises $6 to $12
floriiiiider: folds 
mustanggino: folds 
Uncalled bet ($6) returned to leo 32824
leo 32824 collected $15 from pot
*** SUMMARY ***
Total pot $15 | Rake $0 
Seat 1: leo 32824 (button) collected ($15)
Seat 2: floriiiiider (small blind) folded before Flop
Seat 3: mustanggino (big blind) folded before Flop
Seat 4: JulyShort folded before Flop (didn't bet)
Seat 5: king10clubs folded before Flop (didn't bet)
Seat 6: ZarubaNT folded before Flop (didn't bet)


PokerStars Game #102596210786:  Hold'em No Limit ($3/$6 USD) - 2013/08/11 4:40:48 ET
Table 'Hakone VI 40-100 bb' 6-max Seat #2 is the button
Seat 1: leo 32824 ($820.10 in chips) 
Seat 2: floriiiiider ($643.24 in chips) 
Seat 3: mustanggino ($463.72 in chips) 
Seat 4: JulyShort ($111.20 in chips) 
Seat 5: king10clubs ($663.70 in chips) 
Seat 6: ZarubaNT ($915.38 in chips) 
mustanggino: posts small blind $3
JulyShort: posts big blind $6
*** HOLE CARDS ***
king10clubs: folds 
ZarubaNT: folds 
leo 32824 has timed out
leo 32824: folds 
floriiiiider: folds 
mustanggino: raises $6 to $12
JulyShort: folds 
Uncalled bet ($6) returned to mustanggino
mustanggino collected $12 from pot
mustanggino: doesn't show hand 
*** SUMMARY ***
Total pot $12 | Rake $0 
Seat 1: leo 32824 folded before Flop (didn't bet)
Seat 2: floriiiiider (button) folded before Flop (didn't bet)
Seat 3: mustanggino (small blind) collected ($12)
Seat 4: JulyShort (big blind) folded before Flop
Seat 5: king10clubs folded before Flop (didn't bet)
Seat 6: ZarubaNT folded before Flop (didn't bet)


PokerStars Game #102596227725:  Hold'em No Limit ($3/$6 USD) - 2013/08/11 4:41:36 ET
Table 'Hakone VI 40-100 bb' 6-max Seat #3 is the button
Seat 1: leo 32824 ($820.10 in chips) 
Seat 2: floriiiiider ($643.24 in chips) 
Seat 3: mustanggino ($469.72 in chips) 
Seat 4: JulyShort ($105.20 in chips) 
Seat 5: king10clubs ($663.70 in chips) 
Seat 6: ZarubaNT ($915.38 in chips) 
JulyShort: posts small blind $3
king10clubs: posts big blind $6
*** HOLE CARDS ***
ZarubaNT: folds 
leo 32824: folds 
floriiiiider: folds 
mustanggino: folds 
JulyShort: folds 
Uncalled bet ($3) returned to king10clubs
king10clubs collected $6 from pot
king10clubs: doesn't show hand 
*** SUMMARY ***
Total pot $6 | Rake $0 
Seat 1: leo 32824 folded before Flop (didn't bet)
Seat 2: floriiiiider folded before Flop (didn't bet)
Seat 3: mustanggino (button) folded before Flop (didn't bet)
Seat 4: JulyShort (small blind) folded before Flop
Seat 5: king10clubs (big blind) collected ($6)
Seat 6: ZarubaNT folded before Flop (didn't bet)


PokerStars Game #102596238235:  Hold'em No Limit ($3/$6 USD) - 2013/08/11 4:42:05 ET
Table 'Hakone VI 40-100 bb' 6-max Seat #4 is the button
Seat 1: leo 32824 ($820.10 in chips) 
Seat 2: floriiiiider ($643.24 in chips) 
Seat 3: mustanggino ($469.72 in chips) 
Seat 4: JulyShort ($102.20 in chips) 
Seat 5: king10clubs ($666.70 in chips) 
Seat 6: ZarubaNT ($915.38 in chips) 
king10clubs: posts small blind $3
ZarubaNT: posts big blind $6
*** HOLE CARDS ***
leo 32824: folds 
floriiiiider: raises $12 to $18
mustanggino: folds 
JulyShort: folds 
king10clubs: raises $42 to $60
ZarubaNT: folds 
floriiiiider: calls $42
*** FLOP *** [Ad Js 2s]
king10clubs: bets $54
floriiiiider: calls $54
*** TURN *** [Ad Js 2s] [3d]
king10clubs: checks 
floriiiiider: checks 
*** RIVER *** [Ad Js 2s 3d] [7d]
king10clubs: checks 
floriiiiider: checks 
*** SHOW DOWN ***
king10clubs: shows [Ks Qd] (high card Ace)
floriiiiider: shows [6s 7s] (a pair of Sevens)
floriiiiider collected $231.20 from pot
*** SUMMARY ***
Total pot $234 | Rake $2.80 
Board [Ad Js 2s 3d 7d]
Seat 1: leo 32824 folded before Flop (didn't bet)
Seat 2: floriiiiider showed [6s 7s] and won ($231.20) with a pair of Sevens
Seat 3: mustanggino folded before Flop (didn't bet)
Seat 4: JulyShort (button) folded before Flop (didn't bet)
Seat 5: king10clubs (small blind) showed [Ks Qd] and lost with high card Ace
Seat 6: ZarubaNT (big blind) folded before Flop


PokerStars Game #102596270348:  Hold'em No Limit ($3/$6 USD) - 2013/08/11 4:43:35 ET
Table 'Hakone VI 40-100 bb' 6-max Seat #5 is the button
Seat 1: leo 32824 ($820.10 in chips) 
Seat 2: floriiiiider ($760.44 in chips) 
Seat 3: mustanggino ($469.72 in chips) 
Seat 4: JulyShort ($102.20 in chips) 
Seat 5: king10clubs ($600 in chips) 
Seat 6: ZarubaNT ($909.38 in chips) 
ZarubaNT: posts small blind $3
leo 32824: posts big blind $6
*** HOLE CARDS ***
floriiiiider: folds 
mustanggino: folds 
JulyShort: raises $6 to $12
king10clubs: calls $12
ZarubaNT: folds 
leo 32824: folds 
*** FLOP *** [5c 5h Jc]
JulyShort: checks 
king10clubs: bets $12
JulyShort: folds 
Uncalled bet ($12) returned to king10clubs
king10clubs collected $31.52 from pot
king10clubs: doesn't show hand 
*** SUMMARY ***
Total pot $33 | Rake $1.48 
Board [5c 5h Jc]
Seat 1: leo 32824 (big blind) folded before Flop
Seat 2: floriiiiider folded before Flop (didn't bet)
Seat 3: mustanggino folded before Flop (didn't bet)
Seat 4: JulyShort folded on the Flop
Seat 5: king10clubs (button) collected ($31.52)
Seat 6: ZarubaNT (small blind) folded before Flop


PokerStars Game #102596287284:  Hold'em No Limit ($3/$6 USD) - 2013/08/11 4:44:22 ET
Table 'Hakone VI 40-100 bb' 6-max Seat #6 is the button
Seat 1: leo 32824 ($814.10 in chips) 
Seat 2: floriiiiider ($760.44 in chips) 
Seat 3: mustanggino ($469.72 in chips) 
Seat 4: JulyShort ($90.20 in chips) 
Seat 5: king10clubs ($619.52 in chips) 
Seat 6: ZarubaNT ($906.38 in chips) 
leo 32824: posts small blind $3
floriiiiider: posts big blind $6
*** HOLE CARDS ***
mustanggino: raises $6 to $12
JulyShort: folds 
king10clubs: folds 
ZarubaNT: folds 
leo 32824: folds 
floriiiiider: folds 
Uncalled bet ($6) returned to mustanggino
mustanggino collected $15 from pot
mustanggino: doesn't show hand 
*** SUMMARY ***
Total pot $15 | Rake $0 
Seat 1: leo 32824 (small blind) folded before Flop
Seat 2: floriiiiider (big blind) folded before Flop
Seat 3: mustanggino collected ($15)
Seat 4: JulyShort folded before Flop (didn't bet)
Seat 5: king10clubs folded before Flop (didn't bet)
Seat 6: ZarubaNT (button) folded before Flop (didn't bet)


PokerStars Game #102596293271:  Hold'em No Limit ($3/$6 USD) - 2013/08/11 4:44:39 ET
Table 'Hakone VI 40-100 bb' 6-max Seat #1 is the button
Seat 1: leo 32824 ($811.10 in chips) 
Seat 2: floriiiiider ($754.44 in chips) 
Seat 3: mustanggino ($478.72 in chips) 
Seat 4: JulyShort ($90.20 in chips) 
Seat 5: king10clubs ($619.52 in chips) 
Seat 6: ZarubaNT ($906.38 in chips) 
floriiiiider: posts small blind $3
mustanggino: posts big blind $6
*** HOLE CARDS ***
JulyShort: folds 
king10clubs: raises $9 to $15
ZarubaNT: calls $15
leo 32824: folds 
floriiiiider: folds 
mustanggino: folds 
*** FLOP *** [Tc Td 9h]
king10clubs: checks 
ZarubaNT: checks 
*** TURN *** [Tc Td 9h] [Kd]
king10clubs: checks 
ZarubaNT: checks 
*** RIVER *** [Tc Td 9h Kd] [8s]
king10clubs: checks 
ZarubaNT: checks 
*** SHOW DOWN ***
king10clubs: shows [Qc Ad] (a pair of Tens)
ZarubaNT: shows [8c 9c] (two pair, Tens and Nines)
ZarubaNT collected $37.24 from pot
*** SUMMARY ***
Total pot $39 | Rake $1.76 
Board [Tc Td 9h Kd 8s]
Seat 1: leo 32824 (button) folded before Flop (didn't bet)
Seat 2: floriiiiider (small blind) folded before Flop
Seat 3: mustanggino (big blind) folded before Flop
Seat 4: JulyShort folded before Flop (didn't bet)
Seat 5: king10clubs showed [Qc Ad] and lost with a pair of Tens
Seat 6: ZarubaNT showed [8c 9c] and won ($37.24) with two pair, Tens and Nines


PokerStars Game #102596091146:  Hold'em No Limit ($3/$6 USD) - 2013/08/11 4:35:11 ET
Table 'Hakone VI 40-100 bb' 6-max Seat #5 is the button
Seat 1: leo 32824 ($824.72 in chips) 
Seat 2: floriiiiider ($652.24 in chips) 
Seat 3: mustanggino ($460.72 in chips) 
Seat 4: JulyShort ($132.20 in chips) 
Seat 5: king10clubs ($656.18 in chips) 
Seat 6: ZarubaNT ($896.14 in chips) 
ZarubaNT: posts small blind $3
leo 32824: posts big blind $6
*** HOLE CARDS ***
floriiiiider: folds 
mustanggino: raises $6 to $12
JulyShort: folds 
king10clubs: folds 
ZarubaNT: folds 
leo 32824: folds 
Uncalled bet ($6) returned to mustanggino
mustanggino collected $15 from pot
mustanggino: doesn't show hand 
*** SUMMARY ***
Total pot $15 | Rake $0 
Seat 1: leo 32824 (big blind) folded before Flop
Seat 2: floriiiiider folded before Flop (didn't bet)
Seat 3: mustanggino collected ($15)
Seat 4: JulyShort folded before Flop (didn't bet)
Seat 5: king10clubs (button) folded before Flop (didn't bet)
Seat 6: ZarubaNT (small blind) folded before Flop


PokerStars Game #102596104387:  Hold'em No Limit ($3/$6 USD) - 2013/08/11 4:35:48 ET
Table 'Hakone VI 40-100 bb' 6-max Seat #6 is the button
Seat 1: leo 32824 ($818.72 in chips) 
Seat 2: floriiiiider ($652.24 in chips) 
Seat 3: mustanggino ($469.72 in chips) 
Seat 4: JulyShort ($132.20 in chips) 
Seat 5: king10clubs ($656.18 in chips) 
Seat 6: ZarubaNT ($893.14 in chips) 
leo 32824: posts small blind $3
floriiiiider: posts big blind $6
*** HOLE CARDS ***
mustanggino: folds 
JulyShort: folds 
king10clubs: folds 
ZarubaNT: raises $6 to $12
leo 32824: folds 
floriiiiider: folds 
Uncalled bet ($6) returned to ZarubaNT
ZarubaNT collected $15 from pot
ZarubaNT: doesn't show hand 
*** SUMMARY ***
Total pot $15 | Rake $0 
Seat 1: leo 32824 (small blind) folded before Flop
Seat 2: floriiiiider (big blind) folded before Flop
Seat 3: mustanggino folded before Flop (didn't bet)
Seat 4: JulyShort folded before Flop (didn't bet)
Seat 5: king10clubs folded before Flop (didn't bet)
Seat 6: ZarubaNT (button) collected ($15)


PokerStars Game #102596119327:  Hold'em No Limit ($3/$6 USD) - 2013/08/11 4:36:30 ET
Table 'Hakone VI 40-100 bb' 6-max Seat #1 is the button
Seat 1: leo 32824 ($815.72 in chips) 
Seat 2: floriiiiider ($646.24 in chips) 
Seat 3: mustanggino ($469.72 in chips) 
Seat 4: JulyShort ($132.20 in chips) 
Seat 5: king10clubs ($656.18 in chips) 
Seat 6: ZarubaNT ($902.14 in chips) 
floriiiiider: posts small blind $3
mustanggino: posts big blind $6
*** HOLE CARDS ***
JulyShort: folds 
king10clubs: folds 
ZarubaNT: raises $9 to $15
leo 32824: calls $15
floriiiiider: folds 
mustanggino: folds 
*** FLOP *** [Qd 4s Ts]
ZarubaNT: checks 
leo 32824: checks 
*** TURN *** [Qd 4s Ts] [2d]
ZarubaNT: checks 
leo 32824: checks 
*** RIVER *** [Qd 4s Ts 2d] [Jh]
ZarubaNT: checks 
leo 32824: checks 
*** SHOW DOWN ***
ZarubaNT: shows [Kc 4c] (a pair of Fours)
leo 32824: mucks hand 
ZarubaNT collected $37.24 from pot
*** SUMMARY ***
Total pot $39 | Rake $1.76 
Board [Qd 4s Ts 2d Jh]
Seat 1: leo 32824 (button) mucked
Seat 2: floriiiiider (small blind) folded before Flop
Seat 3: mustanggino (big blind) folded before Flop
Seat 4: JulyShort folded before Flop (didn't bet)
Seat 5: king10clubs folded before Flop (didn't bet)
Seat 6: ZarubaNT showed [Kc 4c] and won ($37.24) with a pair of Fours


PokerStars Game #102596140123:  Hold'em No Limit ($3/$6 USD) - 2013/08/11 4:37:28 ET
Table 'Hakone VI 40-100 bb' 6-max Seat #2 is the button
Seat 1: leo 32824 ($800.72 in chips) 
Seat 2: floriiiiider ($643.24 in chips) 
Seat 3: mustanggino ($463.72 in chips) 
Seat 4: JulyShort ($132.20 in chips) 
Seat 5: king10clubs ($656.18 in chips) 
Seat 6: ZarubaNT ($924.38 in chips) 
mustanggino: posts small blind $3
JulyShort: posts big blind $6
*** HOLE CARDS ***
king10clubs: folds 
ZarubaNT: folds 
leo 32824: folds 
floriiiiider: raises $6 to $12
mustanggino: folds 
JulyShort: folds 
Uncalled bet ($6) returned to floriiiiider
floriiiiider collected $15 from pot
floriiiiider: doesn't show hand 
*** SUMMARY ***
Total pot $15 | Rake $0 
Seat 1: leo 32824 folded before Flop (didn't bet)
Seat 2: floriiiiider (button) collected ($15)
Seat 3: mustanggino (small blind) folded before Flop
Seat 4: JulyShort (big blind) folded before Flop
Seat 5: king10clubs folded before Flop (didn't bet)
Seat 6: ZarubaNT folded before Flop (didn't bet)


PokerStars Game #102596146691:  Hold'em No Limit ($3/$6 USD) - 2013/08/11 4:37:46 ET
Table 'Hakone VI 40-100 bb' 6-max Seat #3 is the button
Seat 1: leo 32824 ($800.72 in chips) 
Seat 2: floriiiiider ($652.24 in chips) 
Seat 3: mustanggino ($460.72 in chips) 
Seat 4: JulyShort ($126.20 in chips) 
Seat 5: king10clubs ($656.18 in chips) 
Seat 6: ZarubaNT ($924.38 in chips) 
JulyShort: posts small blind $3
king10clubs: posts big blind $6
*** HOLE CARDS ***
ZarubaNT: folds 
leo 32824: folds 
floriiiiider: folds 
mustanggino: raises $6 to $12
JulyShort: folds 
king10clubs: folds 
Uncalled bet ($6) returned to mustanggino
mustanggino collected $15 from pot
mustanggino: doesn't show hand 
*** SUMMARY ***
Total pot $15 | Rake $0 
Seat 1: leo 32824 folded before Flop (didn't bet)
Seat 2: floriiiiider folded before Flop (didn't bet)
Seat 3: mustanggino (button) collected ($15)
Seat 4: JulyShort (small blind) folded before Flop
Seat 5: king10clubs (big blind) folded before Flop
Seat 6: ZarubaNT folded before Flop (didn't bet)


PokerStars Game #102596157882:  Hold'em No Limit ($3/$6 USD) - 2013/08/11 4:38:18 ET
Table 'Hakone VI 40-100 bb' 6-max Seat #4 is the button
Seat 1: leo 32824 ($800.72 in chips) 
Seat 2: floriiiiider ($652.24 in chips) 
Seat 3: mustanggino ($469.72 in chips) 
Seat 4: JulyShort ($123.20 in chips) 
Seat 5: king10clubs ($650.18 in chips) 
Seat 6: ZarubaNT ($924.38 in chips) 
king10clubs: posts small blind $3
ZarubaNT: posts big blind $6
*** HOLE CARDS ***
leo 32824: raises $9 to $15
floriiiiider: folds 
mustanggino: folds 
JulyShort: folds 
king10clubs: calls $12
ZarubaNT: folds 
*** FLOP *** [7s Ac Td]
king10clubs: checks 
leo 32824: bets $30
king10clubs: folds 
Uncalled bet ($30) returned to leo 32824
leo 32824 collected $34.38 from pot
*** SUMMARY ***
Total pot $36 | Rake $1.62 
Board [7s Ac Td]
Seat 1: leo 32824 collected ($34.38)
Seat 2: floriiiiider folded before Flop (didn't bet)
Seat 3: mustanggino folded before Flop (didn't bet)
Seat 4: JulyShort (button) folded before Flop (didn't bet)
Seat 5: king10clubs (small blind) folded on the Flop
Seat 6: ZarubaNT (big blind) folded before Flop


PokerStars Game #102596175647:  Hold'em No Limit ($3/$6 USD) - 2013/08/11 4:39:08 ET
Table 'Hakone VI 40-100 bb' 6-max Seat #5 is the button
Seat 1: leo 32824 ($820.10 in chips) 
Seat 2: floriiiiider ($652.24 in chips) 
Seat 3: mustanggino ($469.72 in chips) 
Seat 4: JulyShort ($123.20 in chips) 
Seat 5: king10clubs ($635.18 in chips) 
Seat 6: ZarubaNT ($918.38 in chips) 
ZarubaNT: posts small blind $3
leo 32824: posts big blind $6
*** HOLE CARDS ***
floriiiiider: folds 
mustanggino: folds 
JulyShort: raises $6 to $12
king10clubs: calls $12
ZarubaNT: folds 
leo 32824: folds 
*** FLOP *** [2s 9h Kh]
JulyShort: checks 
king10clubs: checks 
*** TURN *** [2s 9h Kh] [Tc]
JulyShort: checks 
king10clubs: bets $21
JulyShort: folds 
Uncalled bet ($21) returned to king10clubs
king10clubs collected $31.52 from pot
king10clubs: doesn't show hand 
*** SUMMARY ***
Total pot $33 | Rake $1.48 
Board [2s 9h Kh Tc]
Seat 1: leo 32824 (big blind) folded before Flop
Seat 2: floriiiiider folded before Flop (didn't bet)
Seat 3: mustanggino folded before Flop (didn't bet)
Seat 4: JulyShort folded on the Turn
Seat 5: king10clubs (button) collected ($31.52)
Seat 6: ZarubaNT (small blind) folded before Flop


PokerStars Game #102595984507:  Hold'em No Limit ($3/$6 USD) - 2013/08/11 4:30:09 ET
Table 'Hakone VI 40-100 bb' 6-max Seat #4 is the button
Seat 1: leo 32824 ($857.72 in chips) 
Seat 2: floriiiiider ($609 in chips) 
Seat 3: mustanggino ($493.72 in chips) 
Seat 4: JulyShort ($132.20 in chips) 
Seat 5: king10clubs ($692.18 in chips) 
Seat 6: ZarubaNT ($839.14 in chips) 
king10clubs: posts small blind $3
ZarubaNT: posts big blind $6
*** HOLE CARDS ***
leo 32824 has timed out
leo 32824: folds 
floriiiiider: folds 
mustanggino: raises $6 to $12
JulyShort: folds 
king10clubs: folds 
ZarubaNT: raises $30 to $42
mustanggino: folds 
Uncalled bet ($30) returned to ZarubaNT
ZarubaNT collected $27 from pot
ZarubaNT: doesn't show hand 
*** SUMMARY ***
Total pot $27 | Rake $0 
Seat 1: leo 32824 folded before Flop (didn't bet)
Seat 2: floriiiiider folded before Flop (didn't bet)
Seat 3: mustanggino folded before Flop
Seat 4: JulyShort (button) folded before Flop (didn't bet)
Seat 5: king10clubs (small blind) folded before Flop
Seat 6: ZarubaNT (big blind) collected ($27)


PokerStars Game #102596007217:  Hold'em No Limit ($3/$6 USD) - 2013/08/11 4:31:13 ET
Table 'Hakone VI 40-100 bb' 6-max Seat #5 is the button
Seat 1: leo 32824 ($857.72 in chips) 
Seat 2: floriiiiider ($609 in chips) 
Seat 3: mustanggino ($481.72 in chips) 
Seat 4: JulyShort ($132.20 in chips) 
Seat 5: king10clubs ($689.18 in chips) 
Seat 6: ZarubaNT ($854.14 in chips) 
ZarubaNT: posts small blind $3
leo 32824: posts big blind $6
*** HOLE CARDS ***
floriiiiider: raises $12 to $18
mustanggino: folds 
JulyShort: folds 
king10clubs: folds 
ZarubaNT: folds 
leo 32824: calls $12
*** FLOP *** [8h 2d As]
leo 32824: checks 
floriiiiider: bets $27
leo 32824: folds 
Uncalled bet ($27) returned to floriiiiider
floriiiiider collected $37.24 from pot
floriiiiider: doesn't show hand 
*** SUMMARY ***
Total pot $39 | Rake $1.76 
Board [8h 2d As]
Seat 1: leo 32824 (big blind) folded on the Flop
Seat 2: floriiiiider collected ($37.24)
Seat 3: mustanggino folded before Flop (didn't bet)
Seat 4: JulyShort folded before Flop (didn't bet)
Seat 5: king10clubs (button) folded before Flop (didn't bet)
Seat 6: ZarubaNT (small blind) folded before Flop


PokerStars Game #102596024582:  Hold'em No Limit ($3/$6 USD) - 2013/08/11 4:32:02 ET
Table 'Hakone VI 40-100 bb' 6-max Seat #6 is the button
Seat 1: leo 32824 ($839.72 in chips) 
Seat 2: floriiiiider ($628.24 in chips) 
Seat 3: mustanggino ($481.72 in chips) 
Seat 4: JulyShort ($132.20 in chips) 
Seat 5: king10clubs ($689.18 in chips) 
Seat 6: ZarubaNT ($851.14 in chips) 
leo 32824: posts small blind $3
floriiiiider: posts big blind $6
*** HOLE CARDS ***
mustanggino: folds 
JulyShort: raises $9 to $15
king10clubs: folds 
ZarubaNT: folds 
leo 32824: folds 
floriiiiider: folds 
Uncalled bet ($9) returned to JulyShort
JulyShort collected $15 from pot
JulyShort: doesn't show hand 
*** SUMMARY ***
Total pot $15 | Rake $0 
Seat 1: leo 32824 (small blind) folded before Flop
Seat 2: floriiiiider (big blind) folded before Flop
Seat 3: mustanggino folded before Flop (didn't bet)
Seat 4: JulyShort collected ($15)
Seat 5: king10clubs folded before Flop (didn't bet)
Seat 6: ZarubaNT (button) folded before Flop (didn't bet)


PokerStars Game #102596033499:  Hold'em No Limit ($3/$6 USD) - 2013/08/11 4:32:28 ET
Table 'Hakone VI 40-100 bb' 6-max Seat #1 is the button
Seat 1: leo 32824 ($836.72 in chips) 
Seat 2: floriiiiider ($622.24 in chips) 
Seat 3: mustanggino ($481.72 in chips) 
Seat 4: JulyShort ($141.20 in chips) 
Seat 5: king10clubs ($689.18 in chips) 
Seat 6: ZarubaNT ($851.14 in chips) 
floriiiiider: posts small blind $3
mustanggino: posts big blind $6
*** HOLE CARDS ***
JulyShort: folds 
king10clubs: folds 
ZarubaNT: raises $9 to $15
leo 32824: folds 
floriiiiider: raises $36 to $51
mustanggino: folds 
ZarubaNT: folds 
Uncalled bet ($36) returned to floriiiiider
floriiiiider collected $36 from pot
floriiiiider: doesn't show hand 
*** SUMMARY ***
Total pot $36 | Rake $0 
Seat 1: leo 32824 (button) folded before Flop (didn't bet)
Seat 2: floriiiiider (small blind) collected ($36)
Seat 3: mustanggino (big blind) folded before Flop
Seat 4: JulyShort folded before Flop (didn't bet)
Seat 5: king10clubs folded before Flop (didn't bet)
Seat 6: ZarubaNT folded before Flop


PokerStars Game #102596046692:  Hold'em No Limit ($3/$6 USD) - 2013/08/11 4:33:05 ET
Table 'Hakone VI 40-100 bb' 6-max Seat #2 is the button
Seat 1: leo 32824 ($836.72 in chips) 
Seat 2: floriiiiider ($643.24 in chips) 
Seat 3: mustanggino ($475.72 in chips) 
Seat 4: JulyShort ($141.20 in chips) 
Seat 5: king10clubs ($689.18 in chips) 
Seat 6: ZarubaNT ($836.14 in chips) 
mustanggino: posts small blind $3
JulyShort: posts big blind $6
*** HOLE CARDS ***
king10clubs: folds 
ZarubaNT: folds 
leo 32824: folds 
floriiiiider: raises $6 to $12
mustanggino: folds 
JulyShort: folds 
Uncalled bet ($6) returned to floriiiiider
floriiiiider collected $15 from pot
floriiiiider: doesn't show hand 
*** SUMMARY ***
Total pot $15 | Rake $0 
Seat 1: leo 32824 folded before Flop (didn't bet)
Seat 2: floriiiiider (button) collected ($15)
Seat 3: mustanggino (small blind) folded before Flop
Seat 4: JulyShort (big blind) folded before Flop
Seat 5: king10clubs folded before Flop (didn't bet)
Seat 6: ZarubaNT folded before Flop (didn't bet)


PokerStars Game #102596056242:  Hold'em No Limit ($3/$6 USD) - 2013/08/11 4:33:32 ET
Table 'Hakone VI 40-100 bb' 6-max Seat #3 is the button
Seat 1: leo 32824 ($836.72 in chips) 
Seat 2: floriiiiider ($652.24 in chips) 
Seat 3: mustanggino ($472.72 in chips) 
Seat 4: JulyShort ($135.20 in chips) 
Seat 5: king10clubs ($689.18 in chips) 
Seat 6: ZarubaNT ($836.14 in chips) 
JulyShort: posts small blind $3
king10clubs: posts big blind $6
*** HOLE CARDS ***
ZarubaNT: folds 
leo 32824: raises $6 to $12
floriiiiider: folds 
mustanggino: folds 
JulyShort: folds 
king10clubs: raises $36 to $48
leo 32824: folds 
Uncalled bet ($36) returned to king10clubs
king10clubs collected $27 from pot
king10clubs: doesn't show hand 
*** SUMMARY ***
Total pot $27 | Rake $0 
Seat 1: leo 32824 folded before Flop
Seat 2: floriiiiider folded before Flop (didn't bet)
Seat 3: mustanggino (button) folded before Flop (didn't bet)
Seat 4: JulyShort (small blind) folded before Flop
Seat 5: king10clubs (big blind) collected ($27)
Seat 6: ZarubaNT folded before Flop (didn't bet)


PokerStars Game #102596067784:  Hold'em No Limit ($3/$6 USD) - 2013/08/11 4:34:05 ET
Table 'Hakone VI 40-100 bb' 6-max Seat #4 is the button
Seat 1: leo 32824 ($824.72 in chips) 
Seat 2: floriiiiider ($652.24 in chips) 
Seat 3: mustanggino ($472.72 in chips) 
Seat 4: JulyShort ($132.20 in chips) 
Seat 5: king10clubs ($704.18 in chips) 
Seat 6: ZarubaNT ($836.14 in chips) 
king10clubs: posts small blind $3
ZarubaNT: posts big blind $6
*** HOLE CARDS ***
leo 32824: folds 
floriiiiider: folds 
mustanggino: raises $6 to $12
JulyShort: folds 
king10clubs: raises $36 to $48
ZarubaNT: raises $72 to $120
mustanggino: folds 
king10clubs: folds 
Uncalled bet ($72) returned to ZarubaNT
ZarubaNT collected $108 from pot
ZarubaNT: doesn't show hand 
*** SUMMARY ***
Total pot $108 | Rake $0 
Seat 1: leo 32824 folded before Flop (didn't bet)
Seat 2: floriiiiider folded before Flop (didn't bet)
Seat 3: mustanggino folded before Flop
Seat 4: JulyShort (button) folded before Flop (didn't bet)
Seat 5: king10clubs (small blind) folded before Flop
Seat 6: ZarubaNT (big blind) collected ($108)


PokerStars Game #102596432047:  Hold'em No Limit ($3/$6 USD) - 2013/08/11 4:51:11 ET
Table 'Hakone VI 40-100 bb' 6-max Seat #6 is the button
Seat 1: leo 32824 ($1393.30 in chips) 
Seat 2: floriiiiider ($751.44 in chips) 
Seat 3: mustanggino ($596.12 in chips) 
Seat 4: JulyShort ($222 in chips) 
Seat 5: king10clubs ($600 in chips) 
Seat 6: ZarubaNT ($1160.93 in chips) 
leo 32824: posts small blind $3
floriiiiider: posts big blind $6
*** HOLE CARDS ***
mustanggino: folds 
JulyShort: folds 
king10clubs: folds 
ZarubaNT: folds 
leo 32824: folds 
Uncalled bet ($3) returned to floriiiiider
floriiiiider collected $6 from pot
floriiiiider: doesn't show hand 
*** SUMMARY ***
Total pot $6 | Rake $0 
Seat 1: leo 32824 (small blind) folded before Flop
Seat 2: floriiiiider (big blind) collected ($6)
Seat 3: mustanggino folded before Flop (didn't bet)
Seat 4: JulyShort folded before Flop (didn't bet)
Seat 5: king10clubs folded before Flop (didn't bet)
Seat 6: ZarubaNT (button) folded before Flop (didn't bet)


PokerStars Game #102596441000:  Hold'em No Limit ($3/$6 USD) - 2013/08/11 4:51:36 ET
Table 'Hakone VI 40-100 bb' 6-max Seat #1 is the button
Seat 1: leo 32824 ($1390.30 in chips) 
Seat 2: floriiiiider ($754.44 in chips) 
Seat 3: mustanggino ($596.12 in chips) 
Seat 4: JulyShort ($222 in chips) 
Seat 5: king10clubs ($600 in chips) 
Seat 6: ZarubaNT ($1160.93 in chips) 
floriiiiider: posts small blind $3
mustanggino: posts big blind $6
*** HOLE CARDS ***
JulyShort: folds 
king10clubs: folds 
ZarubaNT: raises $9 to $15
leo 32824: folds 
floriiiiider: folds 
mustanggino: folds 
Uncalled bet ($9) returned to ZarubaNT
ZarubaNT collected $15 from pot
ZarubaNT: doesn't show hand 
*** SUMMARY ***
Total pot $15 | Rake $0 
Seat 1: leo 32824 (button) folded before Flop (didn't bet)
Seat 2: floriiiiider (small blind) folded before Flop
Seat 3: mustanggino (big blind) folded before Flop
Seat 4: JulyShort folded before Flop (didn't bet)
Seat 5: king10clubs folded before Flop (didn't bet)
Seat 6: ZarubaNT collected ($15)


PokerStars Game #102596454183:  Hold'em No Limit ($3/$6 USD) - 2013/08/11 4:52:13 ET
Table 'Hakone VI 40-100 bb' 6-max Seat #2 is the button
Seat 1: leo 32824 ($1390.30 in chips) 
Seat 2: floriiiiider ($751.44 in chips) 
Seat 3: mustanggino ($590.12 in chips) 
Seat 4: JulyShort ($222 in chips) 
Seat 5: king10clubs ($600 in chips) 
Seat 6: ZarubaNT ($1169.93 in chips) 
mustanggino: posts small blind $3
JulyShort: posts big blind $6
*** HOLE CARDS ***
king10clubs: folds 
ZarubaNT: folds 
leo 32824: folds 
floriiiiider: folds 
mustanggino: raises $6 to $12
JulyShort: calls $6
*** FLOP *** [8d 6s Ad]
mustanggino: bets $12
JulyShort: folds 
Uncalled bet ($12) returned to mustanggino
mustanggino collected $22.92 from pot
mustanggino: doesn't show hand 
*** SUMMARY ***
Total pot $24 | Rake $1.08 
Board [8d 6s Ad]
Seat 1: leo 32824 folded before Flop (didn't bet)
Seat 2: floriiiiider (button) folded before Flop (didn't bet)
Seat 3: mustanggino (small blind) collected ($22.92)
Seat 4: JulyShort (big blind) folded on the Flop
Seat 5: king10clubs folded before Flop (didn't bet)
Seat 6: ZarubaNT folded before Flop (didn't bet)


PokerStars Game #102596464576:  Hold'em No Limit ($3/$6 USD) - 2013/08/11 4:52:43 ET
Table 'Hakone VI 40-100 bb' 6-max Seat #3 is the button
Seat 1: leo 32824 ($1390.30 in chips) 
Seat 2: floriiiiider ($751.44 in chips) 
Seat 3: mustanggino ($601.04 in chips) 
Seat 4: JulyShort ($210 in chips) 
Seat 5: king10clubs ($600 in chips) 
Seat 6: ZarubaNT ($1169.93 in chips) 
JulyShort: posts small blind $3
king10clubs: posts big blind $6
*** HOLE CARDS ***
ZarubaNT: folds 
leo 32824: folds 
floriiiiider: folds 
mustanggino: folds 
JulyShort: folds 
Uncalled bet ($3) returned to king10clubs
king10clubs collected $6 from pot
king10clubs: doesn't show hand 
*** SUMMARY ***
Total pot $6 | Rake $0 
Seat 1: leo 32824 folded before Flop (didn't bet)
Seat 2: floriiiiider folded before Flop (didn't bet)
Seat 3: mustanggino (button) folded before Flop (didn't bet)
Seat 4: JulyShort (small blind) folded before Flop
Seat 5: king10clubs (big blind) collected ($6)
Seat 6: ZarubaNT folded before Flop (didn't bet)


PokerStars Game #102596471247:  Hold'em No Limit ($3/$6 USD) - 2013/08/11 4:53:02 ET
Table 'Hakone VI 40-100 bb' 6-max Seat #4 is the button
Seat 1: leo 32824 ($1390.30 in chips) 
Seat 2: floriiiiider ($751.44 in chips) 
Seat 3: mustanggino ($601.04 in chips) 
Seat 4: JulyShort ($207 in chips) 
Seat 5: king10clubs ($603 in chips) 
Seat 6: ZarubaNT ($1169.93 in chips) 
king10clubs: posts small blind $3
ZarubaNT: posts big blind $6
*** HOLE CARDS ***
leo 32824: folds 
floriiiiider: folds 
mustanggino: folds 
JulyShort: folds 
king10clubs: raises $9 to $15
ZarubaNT: calls $9
*** FLOP *** [8h Qh Jc]
king10clubs: bets $21
ZarubaNT: folds 
Uncalled bet ($21) returned to king10clubs
king10clubs collected $28.65 from pot
king10clubs: doesn't show hand 
*** SUMMARY ***
Total pot $30 | Rake $1.35 
Board [8h Qh Jc]
Seat 1: leo 32824 folded before Flop (didn't bet)
Seat 2: floriiiiider folded before Flop (didn't bet)
Seat 3: mustanggino folded before Flop (didn't bet)
Seat 4: JulyShort (button) folded before Flop (didn't bet)
Seat 5: king10clubs (small blind) collected ($28.65)
Seat 6: ZarubaNT (big blind) folded on the Flop


PokerStars Game #102596491576:  Hold'em No Limit ($3/$6 USD) - 2013/08/11 4:53:59 ET
Table 'Hakone VI 40-100 bb' 6-max Seat #5 is the button
Seat 1: leo 32824 ($1390.30 in chips) 
Seat 2: floriiiiider ($751.44 in chips) 
Seat 3: mustanggino ($601.04 in chips) 
Seat 4: JulyShort ($207 in chips) 
Seat 5: king10clubs ($616.65 in chips) 
Seat 6: ZarubaNT ($1154.93 in chips) 
ZarubaNT: posts small blind $3
leo 32824: posts big blind $6
*** HOLE CARDS ***
floriiiiider: folds 
mustanggino: folds 
JulyShort: folds 
king10clubs: raises $6 to $12
ZarubaNT: folds 
leo 32824: folds 
Uncalled bet ($6) returned to king10clubs
king10clubs collected $15 from pot
king10clubs: doesn't show hand 
*** SUMMARY ***
Total pot $15 | Rake $0 
Seat 1: leo 32824 (big blind) folded before Flop
Seat 2: floriiiiider folded before Flop (didn't bet)
Seat 3: mustanggino folded before Flop (didn't bet)
Seat 4: JulyShort folded before Flop (didn't bet)
Seat 5: king10clubs (button) collected ($15)
Seat 6: ZarubaNT (small blind) folded before Flop


PokerStars Game #102596502005:  Hold'em No Limit ($3/$6 USD) - 2013/08/11 4:54:28 ET
Table 'Hakone VI 40-100 bb' 6-max Seat #6 is the button
Seat 1: leo 32824 ($1384.30 in chips) 
Seat 2: floriiiiider ($751.44 in chips) 
Seat 3: mustanggino ($601.04 in chips) 
Seat 4: JulyShort ($207 in chips) 
Seat 5: king10clubs ($625.65 in chips) 
Seat 6: ZarubaNT ($1151.93 in chips) 
leo 32824: posts small blind $3
floriiiiider: posts big blind $6
*** HOLE CARDS ***
mustanggino: folds 
JulyShort: folds 
king10clubs: raises $9 to $15
ZarubaNT: folds 
leo 32824: folds 
floriiiiider: folds 
Uncalled bet ($9) returned to king10clubs
king10clubs collected $15 from pot
king10clubs: doesn't show hand 
*** SUMMARY ***
Total pot $15 | Rake $0 
Seat 1: leo 32824 (small blind) folded before Flop
Seat 2: floriiiiider (big blind) folded before Flop
Seat 3: mustanggino folded before Flop (didn't bet)
Seat 4: JulyShort folded before Flop (didn't bet)
Seat 5: king10clubs collected ($15)
Seat 6: ZarubaNT (button) folded before Flop (didn't bet)


PokerStars Game #102596513155:  Hold'em No Limit ($3/$6 USD) - 2013/08/11 4:54:59 ET
Table 'Hakone VI 40-100 bb' 6-max Seat #1 is the button
Seat 1: leo 32824 ($1381.30 in chips) 
Seat 2: floriiiiider ($745.44 in chips) 
Seat 3: mustanggino ($601.04 in chips) 
Seat 4: JulyShort ($207 in chips) 
Seat 5: king10clubs ($634.65 in chips) 
Seat 6: ZarubaNT ($1151.93 in chips) 
floriiiiider: posts small blind $3
mustanggino: posts big blind $6
*** HOLE CARDS ***
JulyShort: folds 
king10clubs: folds 
ZarubaNT: raises $9 to $15
leo 32824: calls $15
floriiiiider: folds 
mustanggino: folds 
*** FLOP *** [3c Qh Qd]
ZarubaNT: checks 
leo 32824: bets $24
ZarubaNT: folds 
Uncalled bet ($24) returned to leo 32824
leo 32824 collected $37.24 from pot
*** SUMMARY ***
Total pot $39 | Rake $1.76 
Board [3c Qh Qd]
Seat 1: leo 32824 (button) collected ($37.24)
Seat 2: floriiiiider (small blind) folded before Flop
Seat 3: mustanggino (big blind) folded before Flop
Seat 4: JulyShort folded before Flop (didn't bet)
Seat 5: king10clubs folded before Flop (didn't bet)
Seat 6: ZarubaNT folded on the Flop


PokerStars Game #102596312186:  Hold'em No Limit ($3/$6 USD) - 2013/08/11 4:45:32 ET
Table 'Hakone VI 40-100 bb' 6-max Seat #2 is the button
Seat 1: leo 32824 ($811.10 in chips) 
Seat 2: floriiiiider ($751.44 in chips) 
Seat 3: mustanggino ($472.72 in chips) 
Seat 4: JulyShort ($90.20 in chips) 
Seat 5: king10clubs ($604.52 in chips) 
Seat 6: ZarubaNT ($928.62 in chips) 
mustanggino: posts small blind $3
JulyShort: posts big blind $6
*** HOLE CARDS ***
king10clubs: raises $12 to $18
ZarubaNT: folds 
leo 32824: calls $18
floriiiiider: folds 
mustanggino: calls $15
JulyShort: raises $72.20 to $90.20 and is all-in
king10clubs: folds 
leo 32824: folds 
mustanggino: calls $72.20
*** FIRST FLOP *** [3c 8h Kc]
*** FIRST TURN *** [3c 8h Kc] [Kh]
*** FIRST RIVER *** [3c 8h Kc Kh] [2s]
*** SECOND FLOP *** [7h 9s 4d]
*** SECOND TURN *** [7h 9s 4d] [4s]
*** SECOND RIVER *** [7h 9s 4d 4s] [2d]
*** FIRST SHOW DOWN ***
mustanggino: shows [4c 4h] (two pair, Kings and Fours)
JulyShort: mucks hand 
mustanggino collected $106.80 from pot
*** SECOND SHOW DOWN ***
mustanggino: shows [4c 4h] (four of a kind, Fours)
JulyShort: mucks hand 
mustanggino collected $106.80 from pot
*** SUMMARY ***
Total pot $216.40 | Rake $2.80 
Hand was run twice
FIRST Board [3c 8h Kc Kh 2s]
SECOND Board [7h 9s 4d 4s 2d]
Seat 1: leo 32824 folded before Flop
Seat 2: floriiiiider (button) folded before Flop (didn't bet)
Seat 3: mustanggino (small blind) showed [4c 4h] and won ($106.80) with two pair, Kings and Fours, and won ($106.80) with four of a kind, Fours
Seat 4: JulyShort (big blind) mucked
Seat 5: king10clubs folded before Flop
Seat 6: ZarubaNT folded before Flop (didn't bet)


PokerStars Game #102596329504:  Hold'em No Limit ($3/$6 USD) - 2013/08/11 4:46:21 ET
Table 'Hakone VI 40-100 bb' 6-max Seat #3 is the button
Seat 1: leo 32824 ($793.10 in chips) 
Seat 2: floriiiiider ($751.44 in chips) 
Seat 3: mustanggino ($596.12 in chips) 
Seat 4: JulyShort ($240 in chips) 
Seat 5: king10clubs ($600 in chips) 
Seat 6: ZarubaNT ($928.62 in chips) 
JulyShort: posts small blind $3
king10clubs: posts big blind $6
*** HOLE CARDS ***
ZarubaNT: raises $12 to $18
leo 32824: folds 
floriiiiider: folds 
mustanggino: folds 
JulyShort: calls $15
king10clubs: folds 
*** FLOP *** [9h 5h Th]
JulyShort: checks 
ZarubaNT: bets $27
JulyShort: folds 
Uncalled bet ($27) returned to ZarubaNT
ZarubaNT collected $40.11 from pot
ZarubaNT: doesn't show hand 
*** SUMMARY ***
Total pot $42 | Rake $1.89 
Board [9h 5h Th]
Seat 1: leo 32824 folded before Flop (didn't bet)
Seat 2: floriiiiider folded before Flop (didn't bet)
Seat 3: mustanggino (button) folded before Flop (didn't bet)
Seat 4: JulyShort (small blind) folded on the Flop
Seat 5: king10clubs (big blind) folded before Flop
Seat 6: ZarubaNT collected ($40.11)


PokerStars Game #102596343778:  Hold'em No Limit ($3/$6 USD) - 2013/08/11 4:47:01 ET
Table 'Hakone VI 40-100 bb' 6-max Seat #4 is the button
Seat 1: leo 32824 ($793.10 in chips) 
Seat 2: floriiiiider ($751.44 in chips) 
Seat 3: mustanggino ($596.12 in chips) 
Seat 4: JulyShort ($222 in chips) 
Seat 5: king10clubs ($600 in chips) 
Seat 6: ZarubaNT ($950.73 in chips) 
king10clubs: posts small blind $3
ZarubaNT: posts big blind $6
*** HOLE CARDS ***
leo 32824: folds 
floriiiiider: folds 
mustanggino: folds 
JulyShort: folds 
king10clubs: raises $9 to $15
ZarubaNT: calls $9
*** FLOP *** [4d Jh 7h]
king10clubs: checks 
ZarubaNT: bets $18
king10clubs: calls $18
*** TURN *** [4d Jh 7h] [Ac]
king10clubs: checks 
ZarubaNT: bets $48
king10clubs: calls $48
*** RIVER *** [4d Jh 7h Ac] [9d]
king10clubs: checks 
ZarubaNT: bets $135
king10clubs: calls $135
*** SHOW DOWN ***
ZarubaNT: shows [Th 8s] (a straight, Seven to Jack)
king10clubs: mucks hand 
ZarubaNT collected $429.20 from pot
*** SUMMARY ***
Total pot $432 | Rake $2.80 
Board [4d Jh 7h Ac 9d]
Seat 1: leo 32824 folded before Flop (didn't bet)
Seat 2: floriiiiider folded before Flop (didn't bet)
Seat 3: mustanggino folded before Flop (didn't bet)
Seat 4: JulyShort (button) folded before Flop (didn't bet)
Seat 5: king10clubs (small blind) mucked
Seat 6: ZarubaNT (big blind) showed [Th 8s] and won ($429.20) with a straight, Seven to Jack


PokerStars Game #102596377332:  Hold'em No Limit ($3/$6 USD) - 2013/08/11 4:48:36 ET
Table 'Hakone VI 40-100 bb' 6-max Seat #5 is the button
Seat 1: leo 32824 ($793.10 in chips) 
Seat 2: floriiiiider ($751.44 in chips) 
Seat 3: mustanggino ($596.12 in chips) 
Seat 4: JulyShort ($222 in chips) 
Seat 5: king10clubs ($600 in chips) 
Seat 6: ZarubaNT ($1163.93 in chips) 
ZarubaNT: posts small blind $3
leo 32824: posts big blind $6
*** HOLE CARDS ***
floriiiiider: folds 
mustanggino: folds 
JulyShort: folds 
king10clubs: raises $6 to $12
ZarubaNT: folds 
leo 32824: calls $6
*** FLOP *** [Td 6s 7d]
leo 32824: bets $18
king10clubs: raises $36 to $54
leo 32824: calls $36
*** TURN *** [Td 6s 7d] [As]
leo 32824: checks 
king10clubs: bets $102
leo 32824: calls $102
*** RIVER *** [Td 6s 7d As] [5d]
leo 32824: checks 
king10clubs: bets $198
leo 32824: raises $427.10 to $625.10 and is all-in
king10clubs: calls $234 and is all-in
Uncalled bet ($193.10) returned to leo 32824
*** SHOW DOWN ***
leo 32824: shows [8s 9d] (a straight, Six to Ten)
king10clubs: shows [Ad Ac] (three of a kind, Aces)
leo 32824 collected $1200.20 from pot
*** SUMMARY ***
Total pot $1203 | Rake $2.80 
Board [Td 6s 7d As 5d]
Seat 1: leo 32824 (big blind) showed [8s 9d] and won ($1200.20) with a straight, Six to Ten
Seat 2: floriiiiider folded before Flop (didn't bet)
Seat 3: mustanggino folded before Flop (didn't bet)
Seat 4: JulyShort folded before Flop (didn't bet)
Seat 5: king10clubs (button) showed [Ad Ac] and lost with three of a kind, Aces
Seat 6: ZarubaNT (small blind) folded before Flop


PokerStars Game #102596830312:  Hold'em No Limit ($3/$6 USD) - 2013/08/11 5:10:05 ET
Table 'Hakone VI 40-100 bb' 6-max Seat #2 is the button
Seat 1: leo 32824 ($1285.32 in chips) 
Seat 2: floriiiiider ($653.96 in chips) 
Seat 3: mustanggino ($613.24 in chips) 
Seat 4: JulyShort ($243.43 in chips) 
Seat 5: dreamtech129 ($825.20 in chips) 
Seat 6: ZarubaNT ($925.17 in chips) 
mustanggino: posts small blind $3
JulyShort: posts big blind $6
*** HOLE CARDS ***
dreamtech129: folds 
ZarubaNT: folds 
leo 32824: folds 
floriiiiider: folds 
mustanggino: raises $6 to $12
JulyShort: folds 
Uncalled bet ($6) returned to mustanggino
mustanggino collected $12 from pot
mustanggino: doesn't show hand 
*** SUMMARY ***
Total pot $12 | Rake $0 
Seat 1: leo 32824 folded before Flop (didn't bet)
Seat 2: floriiiiider (button) folded before Flop (didn't bet)
Seat 3: mustanggino (small blind) collected ($12)
Seat 4: JulyShort (big blind) folded before Flop
Seat 5: dreamtech129 folded before Flop (didn't bet)
Seat 6: ZarubaNT folded before Flop (didn't bet)


PokerStars Game #102596839798:  Hold'em No Limit ($3/$6 USD) - 2013/08/11 5:10:29 ET
Table 'Hakone VI 40-100 bb' 6-max Seat #3 is the button
Seat 1: leo 32824 ($1285.32 in chips) 
Seat 2: floriiiiider ($653.96 in chips) 
Seat 3: mustanggino ($619.24 in chips) 
Seat 4: JulyShort ($237.43 in chips) 
Seat 5: dreamtech129 ($825.20 in chips) 
Seat 6: ZarubaNT ($925.17 in chips) 
JulyShort: posts small blind $3
dreamtech129: posts big blind $6
*** HOLE CARDS ***
ZarubaNT: folds 
leo 32824: folds 
floriiiiider: raises $9 to $15
mustanggino: folds 
JulyShort: folds 
dreamtech129: folds 
Uncalled bet ($9) returned to floriiiiider
floriiiiider collected $15 from pot
floriiiiider: doesn't show hand 
*** SUMMARY ***
Total pot $15 | Rake $0 
Seat 1: leo 32824 folded before Flop (didn't bet)
Seat 2: floriiiiider collected ($15)
Seat 3: mustanggino (button) folded before Flop (didn't bet)
Seat 4: JulyShort (small blind) folded before Flop
Seat 5: dreamtech129 (big blind) folded before Flop
Seat 6: ZarubaNT folded before Flop (didn't bet)


PokerStars Game #102596848359:  Hold'em No Limit ($3/$6 USD) - 2013/08/11 5:10:51 ET
Table 'Hakone VI 40-100 bb' 6-max Seat #4 is the button
Seat 1: leo 32824 ($1285.32 in chips) 
Seat 2: floriiiiider ($662.96 in chips) 
Seat 3: mustanggino ($619.24 in chips) 
Seat 4: JulyShort ($234.43 in chips) 
Seat 5: dreamtech129 ($819.20 in chips) 
Seat 6: ZarubaNT ($925.17 in chips) 
dreamtech129: posts small blind $3
ZarubaNT: posts big blind $6
*** HOLE CARDS ***
leo 32824: folds 
floriiiiider: folds 
mustanggino: folds 
JulyShort: folds 
dreamtech129: raises $7.80 to $13.80
ZarubaNT: calls $7.80
*** FLOP *** [Jc Ts Qs]
dreamtech129: bets $21
ZarubaNT: calls $21
*** TURN *** [Jc Ts Qs] [6c]
dreamtech129: bets $60
ZarubaNT: raises $93 to $153
dreamtech129: raises $144 to $297
ZarubaNT: raises $593.37 to $890.37 and is all-in
dreamtech129: calls $487.40 and is all-in
Uncalled bet ($105.97) returned to ZarubaNT
*** RIVER *** [Jc Ts Qs 6c] [5h]
*** SHOW DOWN ***
dreamtech129: shows [Kc 9s] (a straight, Nine to King)
ZarubaNT: shows [Jd Qh] (two pair, Queens and Jacks)
dreamtech129 collected $1635.60 from pot
*** SUMMARY ***
Total pot $1638.40 | Rake $2.80 
Board [Jc Ts Qs 6c 5h]
Seat 1: leo 32824 folded before Flop (didn't bet)
Seat 2: floriiiiider folded before Flop (didn't bet)
Seat 3: mustanggino folded before Flop (didn't bet)
Seat 4: JulyShort (button) folded before Flop (didn't bet)
Seat 5: dreamtech129 (small blind) showed [Kc 9s] and won ($1635.60) with a straight, Nine to King
Seat 6: ZarubaNT (big blind) showed [Jd Qh] and lost with two pair, Queens and Jacks


PokerStars Game #102596886227:  Hold'em No Limit ($3/$6 USD) - 2013/08/11 5:12:28 ET
Table 'Hakone VI 40-100 bb' 6-max Seat #5 is the button
Seat 1: leo 32824 ($1285.32 in chips) 
Seat 2: floriiiiider ($662.96 in chips) 
Seat 3: mustanggino ($619.24 in chips) 
Seat 4: JulyShort ($234.43 in chips) 
Seat 5: dreamtech129 ($1635.60 in chips) 
Seat 6: ZarubaNT ($600 in chips) 
ZarubaNT: posts small blind $3
leo 32824: posts big blind $6
*** HOLE CARDS ***
floriiiiider: folds 
mustanggino: folds 
JulyShort: folds 
dreamtech129: raises $7.80 to $13.80
ZarubaNT: folds 
leo 32824: folds 
Uncalled bet ($7.80) returned to dreamtech129
dreamtech129 collected $15 from pot
dreamtech129: doesn't show hand 
*** SUMMARY ***
Total pot $15 | Rake $0 
Seat 1: leo 32824 (big blind) folded before Flop
Seat 2: floriiiiider folded before Flop (didn't bet)
Seat 3: mustanggino folded before Flop (didn't bet)
Seat 4: JulyShort folded before Flop (didn't bet)
Seat 5: dreamtech129 (button) collected ($15)
Seat 6: ZarubaNT (small blind) folded before Flop


PokerStars Game #102596896927:  Hold'em No Limit ($3/$6 USD) - 2013/08/11 5:12:55 ET
Table 'Hakone VI 40-100 bb' 6-max Seat #6 is the button
Seat 1: leo 32824 ($1279.32 in chips) 
Seat 2: floriiiiider ($662.96 in chips) 
Seat 3: mustanggino ($619.24 in chips) 
Seat 4: JulyShort ($234.43 in chips) 
Seat 5: dreamtech129 ($1644.60 in chips) 
Seat 6: ZarubaNT ($600 in chips) 
leo 32824: posts small blind $3
floriiiiider: posts big blind $6
*** HOLE CARDS ***
mustanggino: folds 
JulyShort: folds 
dreamtech129: folds 
ZarubaNT: folds 
leo 32824: raises $6 to $12
floriiiiider: folds 
Uncalled bet ($6) returned to leo 32824
leo 32824 collected $12 from pot
*** SUMMARY ***
Total pot $12 | Rake $0 
Seat 1: leo 32824 (small blind) collected ($12)
Seat 2: floriiiiider (big blind) folded before Flop
Seat 3: mustanggino folded before Flop (didn't bet)
Seat 4: JulyShort folded before Flop (didn't bet)
Seat 5: dreamtech129 folded before Flop (didn't bet)
Seat 6: ZarubaNT (button) folded before Flop (didn't bet)


PokerStars Game #102596905605:  Hold'em No Limit ($3/$6 USD) - 2013/08/11 5:13:17 ET
Table 'Hakone VI 40-100 bb' 6-max Seat #1 is the button
Seat 1: leo 32824 ($1285.32 in chips) 
Seat 2: floriiiiider ($656.96 in chips) 
Seat 3: mustanggino ($619.24 in chips) 
Seat 4: JulyShort ($234.43 in chips) 
Seat 5: dreamtech129 ($1644.60 in chips) 
Seat 6: ZarubaNT ($600 in chips) 
floriiiiider: posts small blind $3
mustanggino: posts big blind $6
*** HOLE CARDS ***
JulyShort: folds 
dreamtech129: folds 
ZarubaNT: raises $9 to $15
leo 32824: folds 
floriiiiider: folds 
mustanggino: folds 
Uncalled bet ($9) returned to ZarubaNT
ZarubaNT collected $15 from pot
ZarubaNT: doesn't show hand 
*** SUMMARY ***
Total pot $15 | Rake $0 
Seat 1: leo 32824 (button) folded before Flop (didn't bet)
Seat 2: floriiiiider (small blind) folded before Flop
Seat 3: mustanggino (big blind) folded before Flop
Seat 4: JulyShort folded before Flop (didn't bet)
Seat 5: dreamtech129 folded before Flop (didn't bet)
Seat 6: ZarubaNT collected ($15)


PokerStars Game #102596913703:  Hold'em No Limit ($3/$6 USD) - 2013/08/11 5:13:38 ET
Table 'Hakone VI 40-100 bb' 6-max Seat #2 is the button
Seat 1: leo 32824 ($1285.32 in chips) 
Seat 2: floriiiiider ($653.96 in chips) 
Seat 3: mustanggino ($613.24 in chips) 
Seat 4: JulyShort ($234.43 in chips) 
Seat 5: dreamtech129 ($1644.60 in chips) 
Seat 6: ZarubaNT ($609 in chips) 
mustanggino: posts small blind $3
JulyShort: posts big blind $6
*** HOLE CARDS ***
dreamtech129: folds 
ZarubaNT: folds 
leo 32824: raises $8 to $14
floriiiiider: folds 
mustanggino: folds 
JulyShort: folds 
Uncalled bet ($8) returned to leo 32824
leo 32824 collected $15 from pot
*** SUMMARY ***
Total pot $15 | Rake $0 
Seat 1: leo 32824 collected ($15)
Seat 2: floriiiiider (button) folded before Flop (didn't bet)
Seat 3: mustanggino (small blind) folded before Flop
Seat 4: JulyShort (big blind) folded before Flop
Seat 5: dreamtech129 folded before Flop (didn't bet)
Seat 6: ZarubaNT folded before Flop (didn't bet)


PokerStars Game #102596922101:  Hold'em No Limit ($3/$6 USD) - 2013/08/11 5:13:59 ET
Table 'Hakone VI 40-100 bb' 6-max Seat #3 is the button
Seat 1: leo 32824 ($1294.32 in chips) 
Seat 2: floriiiiider ($653.96 in chips) 
Seat 3: mustanggino ($610.24 in chips) 
Seat 4: JulyShort ($228.43 in chips) 
Seat 5: dreamtech129 ($1644.60 in chips) 
Seat 6: ZarubaNT ($609 in chips) 
JulyShort: posts small blind $3
dreamtech129: posts big blind $6
*** HOLE CARDS ***
ZarubaNT: folds 
leo 32824: folds 
floriiiiider: folds 
mustanggino: raises $6 to $12
JulyShort: folds 
dreamtech129: raises $36 to $48
mustanggino: folds 
Uncalled bet ($36) returned to dreamtech129
dreamtech129 collected $27 from pot
dreamtech129: doesn't show hand 
*** SUMMARY ***
Total pot $27 | Rake $0 
Seat 1: leo 32824 folded before Flop (didn't bet)
Seat 2: floriiiiider folded before Flop (didn't bet)
Seat 3: mustanggino (button) folded before Flop
Seat 4: JulyShort (small blind) folded before Flop
Seat 5: dreamtech129 (big blind) collected ($27)
Seat 6: ZarubaNT folded before Flop (didn't bet)


PokerStars Game #102596939068:  Hold'em No Limit ($3/$6 USD) - 2013/08/11 5:14:42 ET
Table 'Hakone VI 40-100 bb' 6-max Seat #4 is the button
Seat 1: leo 32824 ($1294.32 in chips) 
Seat 2: floriiiiider ($653.96 in chips) 
Seat 3: mustanggino ($598.24 in chips) 
Seat 4: JulyShort ($225.43 in chips) 
Seat 5: dreamtech129 ($1659.60 in chips) 
Seat 6: ZarubaNT ($609 in chips) 
dreamtech129: posts small blind $3
ZarubaNT: posts big blind $6
*** HOLE CARDS ***
leo 32824: folds 
floriiiiider: folds 
mustanggino: folds 
JulyShort: raises $6 to $12
dreamtech129: folds 
ZarubaNT: folds 
Uncalled bet ($6) returned to JulyShort
JulyShort collected $15 from pot
JulyShort: doesn't show hand 
*** SUMMARY ***
Total pot $15 | Rake $0 
Seat 1: leo 32824 folded before Flop (didn't bet)
Seat 2: floriiiiider folded before Flop (didn't bet)
Seat 3: mustanggino folded before Flop (didn't bet)
Seat 4: JulyShort (button) collected ($15)
Seat 5: dreamtech129 (small blind) folded before Flop
Seat 6: ZarubaNT (big blind) folded before Flop


PokerStars Game #102596728654:  Hold'em No Limit ($3/$6 USD) - 2013/08/11 5:05:46 ET
Table 'Hakone VI 40-100 bb' 6-max Seat #1 is the button
Seat 1: leo 32824 ($1288.32 in chips) 
Seat 2: floriiiiider ($674.96 in chips) 
Seat 3: mustanggino ($625.24 in chips) 
Seat 4: JulyShort ($243.43 in chips) 
Seat 5: dreamtech129 ($600 in chips) 
Seat 6: ZarubaNT ($1118.93 in chips) 
floriiiiider: posts small blind $3
mustanggino: posts big blind $6
*** HOLE CARDS ***
JulyShort: folds 
dreamtech129: folds 
ZarubaNT: folds 
leo 32824: raises $9 to $15
floriiiiider: folds 
mustanggino: folds 
Uncalled bet ($9) returned to leo 32824
leo 32824 collected $15 from pot
*** SUMMARY ***
Total pot $15 | Rake $0 
Seat 1: leo 32824 (button) collected ($15)
Seat 2: floriiiiider (small blind) folded before Flop
Seat 3: mustanggino (big blind) folded before Flop
Seat 4: JulyShort folded before Flop (didn't bet)
Seat 5: dreamtech129 folded before Flop (didn't bet)
Seat 6: ZarubaNT folded before Flop (didn't bet)


PokerStars Game #102596738446:  Hold'em No Limit ($3/$6 USD) - 2013/08/11 5:06:11 ET
Table 'Hakone VI 40-100 bb' 6-max Seat #2 is the button
Seat 1: leo 32824 ($1297.32 in chips) 
Seat 2: floriiiiider ($671.96 in chips) 
Seat 3: mustanggino ($619.24 in chips) 
Seat 4: JulyShort ($243.43 in chips) 
Seat 5: dreamtech129 ($600 in chips) 
Seat 6: ZarubaNT ($1118.93 in chips) 
mustanggino: posts small blind $3
JulyShort: posts big blind $6
*** HOLE CARDS ***
dreamtech129: folds 
ZarubaNT: folds 
leo 32824: raises $8 to $14
floriiiiider: folds 
mustanggino: folds 
JulyShort: folds 
Uncalled bet ($8) returned to leo 32824
leo 32824 collected $15 from pot
*** SUMMARY ***
Total pot $15 | Rake $0 
Seat 1: leo 32824 collected ($15)
Seat 2: floriiiiider (button) folded before Flop (didn't bet)
Seat 3: mustanggino (small blind) folded before Flop
Seat 4: JulyShort (big blind) folded before Flop
Seat 5: dreamtech129 folded before Flop (didn't bet)
Seat 6: ZarubaNT folded before Flop (didn't bet)


PokerStars Game #102596747642:  Hold'em No Limit ($3/$6 USD) - 2013/08/11 5:06:34 ET
Table 'Hakone VI 40-100 bb' 6-max Seat #3 is the button
Seat 1: leo 32824 ($1306.32 in chips) 
Seat 2: floriiiiider ($671.96 in chips) 
Seat 3: mustanggino ($616.24 in chips) 
Seat 4: JulyShort ($237.43 in chips) 
Seat 5: dreamtech129 ($600 in chips) 
Seat 6: ZarubaNT ($1118.93 in chips) 
JulyShort: posts small blind $3
dreamtech129: posts big blind $6
*** HOLE CARDS ***
ZarubaNT: raises $12 to $18
leo 32824: folds 
floriiiiider: folds 
mustanggino: calls $18
JulyShort: folds 
dreamtech129: raises $60 to $78
ZarubaNT: calls $60
mustanggino: folds 
*** FLOP *** [4h Qh 7c]
dreamtech129: checks 
ZarubaNT: checks 
*** TURN *** [4h Qh 7c] [9d]
dreamtech129: checks 
ZarubaNT: bets $132
dreamtech129: calls $132
*** RIVER *** [4h Qh 7c 9d] [8h]
dreamtech129: checks 
ZarubaNT: checks 
*** SHOW DOWN ***
dreamtech129: shows [9h Kh] (a flush, King high)
ZarubaNT: mucks hand 
dreamtech129 collected $438.20 from pot
*** SUMMARY ***
Total pot $441 | Rake $2.80 
Board [4h Qh 7c 9d 8h]
Seat 1: leo 32824 folded before Flop (didn't bet)
Seat 2: floriiiiider folded before Flop (didn't bet)
Seat 3: mustanggino (button) folded before Flop
Seat 4: JulyShort (small blind) folded before Flop
Seat 5: dreamtech129 (big blind) showed [9h Kh] and won ($438.20) with a flush, King high
Seat 6: ZarubaNT mucked


PokerStars Game #102596780670:  Hold'em No Limit ($3/$6 USD) - 2013/08/11 5:07:59 ET
Table 'Hakone VI 40-100 bb' 6-max Seat #4 is the button
Seat 1: leo 32824 ($1306.32 in chips) 
Seat 2: floriiiiider ($671.96 in chips) 
Seat 3: mustanggino ($598.24 in chips) 
Seat 4: JulyShort ($234.43 in chips) 
Seat 5: dreamtech129 ($828.20 in chips) 
Seat 6: ZarubaNT ($908.93 in chips) 
dreamtech129: posts small blind $3
ZarubaNT: posts big blind $6
*** HOLE CARDS ***
leo 32824: folds 
floriiiiider: raises $12 to $18
mustanggino: folds 
JulyShort: folds 
dreamtech129: folds 
ZarubaNT: calls $12
*** FLOP *** [Ac Ts 4d]
ZarubaNT: checks 
floriiiiider: checks 
*** TURN *** [Ac Ts 4d] [6s]
ZarubaNT: bets $27
floriiiiider: folds 
Uncalled bet ($27) returned to ZarubaNT
ZarubaNT collected $37.24 from pot
ZarubaNT: doesn't show hand 
*** SUMMARY ***
Total pot $39 | Rake $1.76 
Board [Ac Ts 4d 6s]
Seat 1: leo 32824 folded before Flop (didn't bet)
Seat 2: floriiiiider folded on the Turn
Seat 3: mustanggino folded before Flop (didn't bet)
Seat 4: JulyShort (button) folded before Flop (didn't bet)
Seat 5: dreamtech129 (small blind) folded before Flop
Seat 6: ZarubaNT (big blind) collected ($37.24)


PokerStars Game #102596795435:  Hold'em No Limit ($3/$6 USD) - 2013/08/11 5:08:36 ET
Table 'Hakone VI 40-100 bb' 6-max Seat #5 is the button
Seat 1: leo 32824 ($1306.32 in chips) 
Seat 2: floriiiiider ($653.96 in chips) 
Seat 3: mustanggino ($598.24 in chips) 
Seat 4: JulyShort ($234.43 in chips) 
Seat 5: dreamtech129 ($825.20 in chips) 
Seat 6: ZarubaNT ($928.17 in chips) 
ZarubaNT: posts small blind $3
leo 32824: posts big blind $6
*** HOLE CARDS ***
floriiiiider: folds 
mustanggino: folds 
JulyShort: raises $9 to $15
dreamtech129: folds 
ZarubaNT: folds 
leo 32824: folds 
Uncalled bet ($9) returned to JulyShort
JulyShort collected $15 from pot
JulyShort: doesn't show hand 
*** SUMMARY ***
Total pot $15 | Rake $0 
Seat 1: leo 32824 (big blind) folded before Flop
Seat 2: floriiiiider folded before Flop (didn't bet)
Seat 3: mustanggino folded before Flop (didn't bet)
Seat 4: JulyShort collected ($15)
Seat 5: dreamtech129 (button) folded before Flop (didn't bet)
Seat 6: ZarubaNT (small blind) folded before Flop


PokerStars Game #102596805860:  Hold'em No Limit ($3/$6 USD) - 2013/08/11 5:09:03 ET
Table 'Hakone VI 40-100 bb' 6-max Seat #6 is the button
Seat 1: leo 32824 ($1300.32 in chips) 
Seat 2: floriiiiider ($653.96 in chips) 
Seat 3: mustanggino ($598.24 in chips) 
Seat 4: JulyShort ($243.43 in chips) 
Seat 5: dreamtech129 ($825.20 in chips) 
Seat 6: ZarubaNT ($925.17 in chips) 
leo 32824: posts small blind $3
floriiiiider: posts big blind $6
*** HOLE CARDS ***
mustanggino: folds 
JulyShort: folds 
dreamtech129: folds 
ZarubaNT: folds 
leo 32824: folds 
Uncalled bet ($3) returned to floriiiiider
floriiiiider collected $6 from pot
floriiiiider: doesn't show hand 
*** SUMMARY ***
Total pot $6 | Rake $0 
Seat 1: leo 32824 (small blind) folded before Flop
Seat 2: floriiiiider (big blind) collected ($6)
Seat 3: mustanggino folded before Flop (didn't bet)
Seat 4: JulyShort folded before Flop (didn't bet)
Seat 5: dreamtech129 folded before Flop (didn't bet)
Seat 6: ZarubaNT (button) folded before Flop (didn't bet)


PokerStars Game #102596811107:  Hold'em No Limit ($3/$6 USD) - 2013/08/11 5:09:16 ET
Table 'Hakone VI 40-100 bb' 6-max Seat #1 is the button
Seat 1: leo 32824 ($1297.32 in chips) 
Seat 2: floriiiiider ($656.96 in chips) 
Seat 3: mustanggino ($598.24 in chips) 
Seat 4: JulyShort ($243.43 in chips) 
Seat 5: dreamtech129 ($825.20 in chips) 
Seat 6: ZarubaNT ($925.17 in chips) 
floriiiiider: posts small blind $3
mustanggino: posts big blind $6
*** HOLE CARDS ***
JulyShort: folds 
dreamtech129: folds 
ZarubaNT: folds 
leo 32824: raises $6 to $12
floriiiiider: folds 
mustanggino: raises $30 to $42
leo 32824: folds 
Uncalled bet ($30) returned to mustanggino
mustanggino collected $27 from pot
mustanggino: doesn't show hand 
*** SUMMARY ***
Total pot $27 | Rake $0 
Seat 1: leo 32824 (button) folded before Flop
Seat 2: floriiiiider (small blind) folded before Flop
Seat 3: mustanggino (big blind) collected ($27)
Seat 4: JulyShort folded before Flop (didn't bet)
Seat 5: dreamtech129 folded before Flop (didn't bet)
Seat 6: ZarubaNT folded before Flop (didn't bet)


PokerStars Game #102596528824:  Hold'em No Limit ($3/$6 USD) - 2013/08/11 4:55:52 ET
Table 'Hakone VI 40-100 bb' 6-max Seat #2 is the button
Seat 1: leo 32824 ($1403.54 in chips) 
Seat 2: floriiiiider ($742.44 in chips) 
Seat 3: mustanggino ($595.04 in chips) 
Seat 4: JulyShort ($207 in chips) 
Seat 5: king10clubs ($634.65 in chips) 
Seat 6: ZarubaNT ($1136.93 in chips) 
mustanggino: posts small blind $3
JulyShort: posts big blind $6
*** HOLE CARDS ***
king10clubs: folds 
ZarubaNT: folds 
leo 32824: folds 
floriiiiider: raises $6 to $12
mustanggino: folds 
JulyShort: raises $21 to $33
floriiiiider: folds 
Uncalled bet ($21) returned to JulyShort
JulyShort collected $27 from pot
JulyShort: doesn't show hand 
*** SUMMARY ***
Total pot $27 | Rake $0 
Seat 1: leo 32824 folded before Flop (didn't bet)
Seat 2: floriiiiider (button) folded before Flop
Seat 3: mustanggino (small blind) folded before Flop
Seat 4: JulyShort (big blind) collected ($27)
Seat 5: king10clubs folded before Flop (didn't bet)
Seat 6: ZarubaNT folded before Flop (didn't bet)


PokerStars Game #102596540477:  Hold'em No Limit ($3/$6 USD) - 2013/08/11 4:56:34 ET
Table 'Hakone VI 40-100 bb' 6-max Seat #3 is the button
Seat 1: leo 32824 ($1403.54 in chips) 
Seat 2: floriiiiider ($730.44 in chips) 
Seat 3: mustanggino ($592.04 in chips) 
Seat 4: JulyShort ($222 in chips) 
Seat 5: king10clubs ($634.65 in chips) 
Seat 6: ZarubaNT ($1136.93 in chips) 
JulyShort: posts small blind $3
king10clubs: posts big blind $6
*** HOLE CARDS ***
ZarubaNT: folds 
leo 32824: folds 
floriiiiider: folds 
mustanggino: folds 
JulyShort: raises $9 to $15
king10clubs: calls $9
*** FLOP *** [6s Th 6h]
JulyShort: checks 
king10clubs: checks 
*** TURN *** [6s Th 6h] [8d]
JulyShort: checks 
king10clubs: checks 
*** RIVER *** [6s Th 6h 8d] [Jh]
JulyShort: checks 
king10clubs: checks 
*** SHOW DOWN ***
JulyShort: shows [Kh Ts] (two pair, Tens and Sixes)
king10clubs: mucks hand 
JulyShort collected $28.65 from pot
*** SUMMARY ***
Total pot $30 | Rake $1.35 
Board [6s Th 6h 8d Jh]
Seat 1: leo 32824 folded before Flop (didn't bet)
Seat 2: floriiiiider folded before Flop (didn't bet)
Seat 3: mustanggino (button) folded before Flop (didn't bet)
Seat 4: JulyShort (small blind) showed [Kh Ts] and won ($28.65) with two pair, Tens and Sixes
Seat 5: king10clubs (big blind) mucked
Seat 6: ZarubaNT folded before Flop (didn't bet)


PokerStars Game #102596552105:  Hold'em No Limit ($3/$6 USD) - 2013/08/11 4:57:16 ET
Table 'Hakone VI 40-100 bb' 6-max Seat #4 is the button
Seat 1: leo 32824 ($1403.54 in chips) 
Seat 2: floriiiiider ($730.44 in chips) 
Seat 3: mustanggino ($592.04 in chips) 
Seat 4: JulyShort ($235.65 in chips) 
Seat 5: king10clubs ($619.65 in chips) 
Seat 6: ZarubaNT ($1136.93 in chips) 
king10clubs: posts small blind $3
ZarubaNT: posts big blind $6
*** HOLE CARDS ***
leo 32824: raises $6 to $12
floriiiiider: folds 
mustanggino: folds 
JulyShort: folds 
king10clubs: folds 
ZarubaNT: folds 
Uncalled bet ($6) returned to leo 32824
leo 32824 collected $15 from pot
*** SUMMARY ***
Total pot $15 | Rake $0 
Seat 1: leo 32824 collected ($15)
Seat 2: floriiiiider folded before Flop (didn't bet)
Seat 3: mustanggino folded before Flop (didn't bet)
Seat 4: JulyShort (button) folded before Flop (didn't bet)
Seat 5: king10clubs (small blind) folded before Flop
Seat 6: ZarubaNT (big blind) folded before Flop


PokerStars Game #102596558060:  Hold'em No Limit ($3/$6 USD) - 2013/08/11 4:57:37 ET
Table 'Hakone VI 40-100 bb' 6-max Seat #5 is the button
Seat 1: leo 32824 ($1412.54 in chips) 
Seat 2: floriiiiider ($730.44 in chips) 
Seat 3: mustanggino ($592.04 in chips) 
Seat 4: JulyShort ($235.65 in chips) 
Seat 5: king10clubs ($616.65 in chips) 
Seat 6: ZarubaNT ($1130.93 in chips) 
ZarubaNT: posts small blind $3
leo 32824: posts big blind $6
*** HOLE CARDS ***
floriiiiider: folds 
mustanggino: folds 
JulyShort: folds 
king10clubs: raises $6 to $12
ZarubaNT: folds 
leo 32824: folds 
Uncalled bet ($6) returned to king10clubs
king10clubs collected $15 from pot
king10clubs: doesn't show hand 
*** SUMMARY ***
Total pot $15 | Rake $0 
Seat 1: leo 32824 (big blind) folded before Flop
Seat 2: floriiiiider folded before Flop (didn't bet)
Seat 3: mustanggino folded before Flop (didn't bet)
Seat 4: JulyShort folded before Flop (didn't bet)
Seat 5: king10clubs (button) collected ($15)
Seat 6: ZarubaNT (small blind) folded before Flop


PokerStars Game #102596567774:  Hold'em No Limit ($3/$6 USD) - 2013/08/11 4:58:12 ET
Table 'Hakone VI 40-100 bb' 6-max Seat #6 is the button
Seat 1: leo 32824 ($1406.54 in chips) 
Seat 2: floriiiiider ($730.44 in chips) 
Seat 3: mustanggino ($592.04 in chips) 
Seat 4: JulyShort ($235.65 in chips) 
Seat 5: king10clubs ($625.65 in chips) 
Seat 6: ZarubaNT ($1127.93 in chips) 
leo 32824: posts small blind $3
floriiiiider: posts big blind $6
*** HOLE CARDS ***
mustanggino: folds 
JulyShort: folds 
king10clubs: raises $9 to $15
ZarubaNT: folds 
leo 32824: calls $12
floriiiiider: folds 
*** FLOP *** [9c 6c 6d]
leo 32824 is disconnected 
leo 32824 is connected 
leo 32824: checks 
king10clubs: bets $21
leo 32824: calls $21
*** TURN *** [9c 6c 6d] [Td]
leo 32824: checks 
king10clubs: checks 
*** RIVER *** [9c 6c 6d Td] [8d]
leo 32824: bets $36
king10clubs: calls $36
*** SHOW DOWN ***
leo 32824: shows [Ac Qc] (a pair of Sixes)
king10clubs: shows [5h 5d] (two pair, Sixes and Fives)
king10clubs collected $147.20 from pot
*** SUMMARY ***
Total pot $150 | Rake $2.80 
Board [9c 6c 6d Td 8d]
Seat 1: leo 32824 (small blind) showed [Ac Qc] and lost with a pair of Sixes
Seat 2: floriiiiider (big blind) folded before Flop
Seat 3: mustanggino folded before Flop (didn't bet)
Seat 4: JulyShort folded before Flop (didn't bet)
Seat 5: king10clubs showed [5h 5d] and won ($147.20) with two pair, Sixes and Fives
Seat 6: ZarubaNT (button) folded before Flop (didn't bet)


PokerStars Game #102596594786:  Hold'em No Limit ($3/$6 USD) - 2013/08/11 4:59:49 ET
Table 'Hakone VI 40-100 bb' 6-max Seat #1 is the button
Seat 1: leo 32824 ($1334.54 in chips) 
Seat 2: floriiiiider ($724.44 in chips) 
Seat 3: mustanggino ($592.04 in chips) 
Seat 4: JulyShort ($235.65 in chips) 
Seat 5: king10clubs ($700.85 in chips) 
Seat 6: ZarubaNT ($1127.93 in chips) 
floriiiiider: posts small blind $3
mustanggino: posts big blind $6
*** HOLE CARDS ***
JulyShort: folds 
king10clubs: raises $9 to $15
ZarubaNT: folds 
leo 32824: folds 
floriiiiider: folds 
mustanggino: folds 
Uncalled bet ($9) returned to king10clubs
king10clubs collected $15 from pot
king10clubs: doesn't show hand 
*** SUMMARY ***
Total pot $15 | Rake $0 
Seat 1: leo 32824 (button) folded before Flop (didn't bet)
Seat 2: floriiiiider (small blind) folded before Flop
Seat 3: mustanggino (big blind) folded before Flop
Seat 4: JulyShort folded before Flop (didn't bet)
Seat 5: king10clubs collected ($15)
Seat 6: ZarubaNT folded before Flop (didn't bet)


PokerStars Game #102596603330:  Hold'em No Limit ($3/$6 USD) - 2013/08/11 5:00:10 ET
Table 'Hakone VI 40-100 bb' 6-max Seat #2 is the button
Seat 1: leo 32824 ($1334.54 in chips) 
Seat 2: floriiiiider ($721.44 in chips) 
Seat 3: mustanggino ($586.04 in chips) 
Seat 4: JulyShort ($235.65 in chips) 
Seat 5: king10clubs ($709.85 in chips) 
Seat 6: ZarubaNT ($1127.93 in chips) 
mustanggino: posts small blind $3
JulyShort: posts big blind $6
*** HOLE CARDS ***
king10clubs: raises $12 to $18
ZarubaNT: folds 
leo 32824: folds 
floriiiiider: calls $18
mustanggino: folds 
JulyShort: folds 
*** FLOP *** [5h 3h 7d]
king10clubs: checks 
floriiiiider: bets $30
king10clubs: calls $30
*** TURN *** [5h 3h 7d] [6s]
king10clubs: checks 
floriiiiider: checks 
*** RIVER *** [5h 3h 7d 6s] [9h]
king10clubs: checks 
floriiiiider: checks 
*** SHOW DOWN ***
king10clubs: shows [3d 4d] (a straight, Three to Seven)
floriiiiider: mucks hand 
king10clubs collected $102.20 from pot
*** SUMMARY ***
Total pot $105 | Rake $2.80 
Board [5h 3h 7d 6s 9h]
Seat 1: leo 32824 folded before Flop (didn't bet)
Seat 2: floriiiiider (button) mucked
Seat 3: mustanggino (small blind) folded before Flop
Seat 4: JulyShort (big blind) folded before Flop
Seat 5: king10clubs showed [3d 4d] and won ($102.20) with a straight, Three to Seven
Seat 6: ZarubaNT folded before Flop (didn't bet)


PokerStars Game #102596616479:  Hold'em No Limit ($3/$6 USD) - 2013/08/11 5:00:53 ET
Table 'Hakone VI 40-100 bb' 6-max Seat #3 is the button
Seat 1: leo 32824 ($1334.54 in chips) 
Seat 2: floriiiiider ($673.44 in chips) 
Seat 3: mustanggino ($583.04 in chips) 
Seat 4: JulyShort ($229.65 in chips) 
Seat 6: ZarubaNT ($1127.93 in chips) 
JulyShort: posts small blind $3
king10clubs: is sitting out 
ZarubaNT: posts big blind $6
*** HOLE CARDS ***
leo 32824: raises $6 to $12
floriiiiider: folds 
king10clubs leaves the table
mustanggino: folds 
JulyShort: folds 
ZarubaNT: folds 
Uncalled bet ($6) returned to leo 32824
leo 32824 collected $15 from pot
vjxbkf joins the table at seat #5 
*** SUMMARY ***
Total pot $15 | Rake $0 
Seat 1: leo 32824 collected ($15)
Seat 2: floriiiiider folded before Flop (didn't bet)
Seat 3: mustanggino (button) folded before Flop (didn't bet)
Seat 4: JulyShort (small blind) folded before Flop
Seat 6: ZarubaNT (big blind) folded before Flop


PokerStars Game #102596621944:  Hold'em No Limit ($3/$6 USD) - 2013/08/11 5:01:09 ET
Table 'Hakone VI 40-100 bb' 6-max Seat #4 is the button
Seat 1: leo 32824 ($1343.54 in chips) 
Seat 2: floriiiiider ($673.44 in chips) 
Seat 3: mustanggino ($583.04 in chips) 
Seat 4: JulyShort ($226.65 in chips) 
Seat 6: ZarubaNT ($1121.93 in chips) 
vjxbkf will be allowed to play after the button
ZarubaNT: posts small blind $3
leo 32824: posts big blind $6
*** HOLE CARDS ***
vjxbkf leaves the table
floriiiiider: raises $12 to $18
mustanggino: folds 
JulyShort: folds 
ZarubaNT: folds 
leo 32824: folds 
Uncalled bet ($12) returned to floriiiiider
floriiiiider collected $15 from pot
floriiiiider: doesn't show hand 
*** SUMMARY ***
Total pot $15 | Rake $0 
Seat 1: leo 32824 (big blind) folded before Flop
Seat 2: floriiiiider collected ($15)
Seat 3: mustanggino folded before Flop (didn't bet)
Seat 4: JulyShort (button) folded before Flop (didn't bet)
Seat 6: ZarubaNT (small blind) folded before Flop


PokerStars Game #102596632903:  Hold'em No Limit ($3/$6 USD) - 2013/08/11 5:01:39 ET
Table 'Hakone VI 40-100 bb' 6-max Seat #6 is the button
Seat 1: leo 32824 ($1337.54 in chips) 
Seat 2: floriiiiider ($682.44 in chips) 
Seat 3: mustanggino ($583.04 in chips) 
Seat 4: JulyShort ($226.65 in chips) 
Seat 6: ZarubaNT ($1118.93 in chips) 
leo 32824: posts small blind $3
floriiiiider: posts big blind $6
*** HOLE CARDS ***
mustanggino: folds 
JulyShort: raises $6 to $12
ZarubaNT: folds 
leo 32824: folds 
floriiiiider: folds 
Uncalled bet ($6) returned to JulyShort
JulyShort collected $15 from pot
JulyShort: doesn't show hand 
*** SUMMARY ***
Total pot $15 | Rake $0 
Seat 1: leo 32824 (small blind) folded before Flop
Seat 2: floriiiiider (big blind) folded before Flop
Seat 3: mustanggino folded before Flop (didn't bet)
Seat 4: JulyShort collected ($15)
Seat 6: ZarubaNT (button) folded before Flop (didn't bet)


PokerStars Game #102596638724:  Hold'em No Limit ($3/$6 USD) - 2013/08/11 5:01:55 ET
Table 'Hakone VI 40-100 bb' 6-max Seat #1 is the button
Seat 1: leo 32824 ($1334.54 in chips) 
Seat 2: floriiiiider ($676.44 in chips) 
Seat 3: mustanggino ($583.04 in chips) 
Seat 4: JulyShort ($235.65 in chips) 
Seat 6: ZarubaNT ($1118.93 in chips) 
floriiiiider: posts small blind $3
mustanggino: posts big blind $6
*** HOLE CARDS ***
JulyShort: folds 
ZarubaNT: folds 
leo 32824: raises $6 to $12
floriiiiider: folds 
mustanggino: calls $6
*** FLOP *** [8d 7c Qc]
mustanggino: checks 
leo 32824: bets $24
mustanggino: folds 
Uncalled bet ($24) returned to leo 32824
leo 32824 collected $25.78 from pot
*** SUMMARY ***
Total pot $27 | Rake $1.22 
Board [8d 7c Qc]
Seat 1: leo 32824 (button) collected ($25.78)
Seat 2: floriiiiider (small blind) folded before Flop
Seat 3: mustanggino (big blind) folded on the Flop
Seat 4: JulyShort folded before Flop (didn't bet)
Seat 6: ZarubaNT folded before Flop (didn't bet)


PokerStars Game #102596657309:  Hold'em No Limit ($3/$6 USD) - 2013/08/11 5:02:44 ET
Table 'Hakone VI 40-100 bb' 6-max Seat #2 is the button
Seat 1: leo 32824 ($1348.32 in chips) 
Seat 2: floriiiiider ($673.44 in chips) 
Seat 3: mustanggino ($571.04 in chips) 
Seat 4: JulyShort ($235.65 in chips) 
Seat 6: ZarubaNT ($1118.93 in chips) 
mustanggino: posts small blind $3
JulyShort: posts big blind $6
*** HOLE CARDS ***
ZarubaNT: folds 
leo 32824: folds 
floriiiiider: raises $6 to $12
mustanggino: folds 
JulyShort: calls $6
*** FLOP *** [3h Qh Th]
JulyShort: checks 
floriiiiider: checks 
*** TURN *** [3h Qh Th] [2s]
JulyShort: bets $24
floriiiiider: folds 
Uncalled bet ($24) returned to JulyShort
dreamtech129 joins the table at seat #5 
JulyShort collected $25.78 from pot
JulyShort: doesn't show hand 
*** SUMMARY ***
Total pot $27 | Rake $1.22 
Board [3h Qh Th 2s]
Seat 1: leo 32824 folded before Flop (didn't bet)
Seat 2: floriiiiider (button) folded on the Turn
Seat 3: mustanggino (small blind) folded before Flop
Seat 4: JulyShort (big blind) collected ($25.78)
Seat 6: ZarubaNT folded before Flop (didn't bet)


PokerStars Game #102596668847:  Hold'em No Limit ($3/$6 USD) - 2013/08/11 5:03:15 ET
Table 'Hakone VI 40-100 bb' 6-max Seat #3 is the button
Seat 1: leo 32824 ($1348.32 in chips) 
Seat 2: floriiiiider ($661.44 in chips) 
Seat 3: mustanggino ($568.04 in chips) 
Seat 4: JulyShort ($249.43 in chips) 
Seat 5: dreamtech129 ($600 in chips) 
Seat 6: ZarubaNT ($1118.93 in chips) 
JulyShort: posts small blind $3
dreamtech129: posts big blind $6
*** HOLE CARDS ***
ZarubaNT: folds 
leo 32824: raises $6 to $12
floriiiiider: calls $12
mustanggino: folds 
JulyShort: folds 
dreamtech129: folds 
*** FLOP *** [Kc Jd 3s]
leo 32824: checks 
floriiiiider: bets $21
leo 32824: folds 
Uncalled bet ($21) returned to floriiiiider
floriiiiider collected $31.52 from pot
floriiiiider: doesn't show hand 
*** SUMMARY ***
Total pot $33 | Rake $1.48 
Board [Kc Jd 3s]
Seat 1: leo 32824 folded on the Flop
Seat 2: floriiiiider collected ($31.52)
Seat 3: mustanggino (button) folded before Flop (didn't bet)
Seat 4: JulyShort (small blind) folded before Flop
Seat 5: dreamtech129 (big blind) folded before Flop
Seat 6: ZarubaNT folded before Flop (didn't bet)


PokerStars Game #102596678125:  Hold'em No Limit ($3/$6 USD) - 2013/08/11 5:03:39 ET
Table 'Hakone VI 40-100 bb' 6-max Seat #4 is the button
Seat 1: leo 32824 ($1336.32 in chips) 
Seat 2: floriiiiider ($680.96 in chips) 
Seat 3: mustanggino ($568.04 in chips) 
Seat 4: JulyShort ($246.43 in chips) 
Seat 5: dreamtech129 ($600 in chips) 
Seat 6: ZarubaNT ($1118.93 in chips) 
dreamtech129: posts small blind $3
ZarubaNT: posts big blind $6
*** HOLE CARDS ***
leo 32824: folds 
floriiiiider: folds 
mustanggino: folds 
JulyShort: folds 
dreamtech129: folds 
Uncalled bet ($3) returned to ZarubaNT
ZarubaNT collected $6 from pot
ZarubaNT: doesn't show hand 
*** SUMMARY ***
Total pot $6 | Rake $0 
Seat 1: leo 32824 folded before Flop (didn't bet)
Seat 2: floriiiiider folded before Flop (didn't bet)
Seat 3: mustanggino folded before Flop (didn't bet)
Seat 4: JulyShort (button) folded before Flop (didn't bet)
Seat 5: dreamtech129 (small blind) folded before Flop
Seat 6: ZarubaNT (big blind) collected ($6)


PokerStars Game #102596684214:  Hold'em No Limit ($3/$6 USD) - 2013/08/11 5:03:53 ET
Table 'Hakone VI 40-100 bb' 6-max Seat #5 is the button
Seat 1: leo 32824 ($1336.32 in chips) 
Seat 2: floriiiiider ($680.96 in chips) 
Seat 3: mustanggino ($568.04 in chips) 
Seat 4: JulyShort ($246.43 in chips) 
Seat 5: dreamtech129 ($600 in chips) 
Seat 6: ZarubaNT ($1121.93 in chips) 
ZarubaNT: posts small blind $3
leo 32824: posts big blind $6
*** HOLE CARDS ***
floriiiiider: folds 
mustanggino: folds 
JulyShort: raises $9 to $15
dreamtech129: folds 
ZarubaNT: folds 
leo 32824: folds 
Uncalled bet ($9) returned to JulyShort
JulyShort collected $15 from pot
JulyShort: doesn't show hand 
*** SUMMARY ***
Total pot $15 | Rake $0 
Seat 1: leo 32824 (big blind) folded before Flop
Seat 2: floriiiiider folded before Flop (didn't bet)
Seat 3: mustanggino folded before Flop (didn't bet)
Seat 4: JulyShort collected ($15)
Seat 5: dreamtech129 (button) folded before Flop (didn't bet)
Seat 6: ZarubaNT (small blind) folded before Flop


PokerStars Game #102596699311:  Hold'em No Limit ($3/$6 USD) - 2013/08/11 5:04:31 ET
Table 'Hakone VI 40-100 bb' 6-max Seat #6 is the button
Seat 1: leo 32824 ($1330.32 in chips) 
Seat 2: floriiiiider ($680.96 in chips) 
Seat 3: mustanggino ($568.04 in chips) 
Seat 4: JulyShort ($255.43 in chips) 
Seat 5: dreamtech129 ($600 in chips) 
Seat 6: ZarubaNT ($1118.93 in chips) 
leo 32824: posts small blind $3
floriiiiider: posts big blind $6
*** HOLE CARDS ***
mustanggino: raises $6 to $12
JulyShort: calls $12
dreamtech129: folds 
ZarubaNT: folds 
leo 32824: calls $9
floriiiiider: folds 
*** FLOP *** [4s 6s 8d]
leo 32824: checks 
mustanggino: bets $30
JulyShort: folds 
leo 32824: calls $30
*** TURN *** [4s 6s 8d] [Qd]
leo 32824: checks 
mustanggino: bets $66
leo 32824: folds 
Uncalled bet ($66) returned to mustanggino
mustanggino collected $99.20 from pot
mustanggino: doesn't show hand 
*** SUMMARY ***
Total pot $102 | Rake $2.80 
Board [4s 6s 8d Qd]
Seat 1: leo 32824 (small blind) folded on the Turn
Seat 2: floriiiiider (big blind) folded before Flop
Seat 3: mustanggino collected ($99.20)
Seat 4: JulyShort folded on the Flop
Seat 5: dreamtech129 folded before Flop (didn't bet)
Seat 6: ZarubaNT (button) folded before Flop (didn't bet)


PokerStars Game #102597203738:  Hold'em No Limit ($3/$6 USD) - 2013/08/11 5:25:44 ET
Table 'Hakone VI 40-100 bb' 6-max Seat #2 is the button
Seat 1: leo 32824 ($1286.97 in chips) 
Seat 2: floriiiiider ($678.16 in chips) 
Seat 3: mustanggino ($554.08 in chips) 
Seat 4: vjxbkf ($1178.98 in chips) 
Seat 5: dreamtech129 ($1629.60 in chips) 
Seat 6: ZarubaNT ($627.70 in chips) 
mustanggino: posts small blind $3
vjxbkf: posts big blind $6
*** HOLE CARDS ***
dreamtech129: folds 
ZarubaNT: folds 
leo 32824: raises $6 to $12
floriiiiider: folds 
mustanggino: folds 
vjxbkf: folds 
Uncalled bet ($6) returned to leo 32824
leo 32824 collected $15 from pot
*** SUMMARY ***
Total pot $15 | Rake $0 
Seat 1: leo 32824 collected ($15)
Seat 2: floriiiiider (button) folded before Flop (didn't bet)
Seat 3: mustanggino (small blind) folded before Flop
Seat 4: vjxbkf (big blind) folded before Flop
Seat 5: dreamtech129 folded before Flop (didn't bet)
Seat 6: ZarubaNT folded before Flop (didn't bet)


PokerStars Game #102597210479:  Hold'em No Limit ($3/$6 USD) - 2013/08/11 5:26:01 ET
Table 'Hakone VI 40-100 bb' 6-max Seat #3 is the button
Seat 1: leo 32824 ($1295.97 in chips) 
Seat 2: floriiiiider ($678.16 in chips) 
Seat 3: mustanggino ($551.08 in chips) 
Seat 4: vjxbkf ($1172.98 in chips) 
Seat 5: dreamtech129 ($1629.60 in chips) 
Seat 6: ZarubaNT ($627.70 in chips) 
vjxbkf: posts small blind $3
dreamtech129: posts big blind $6
*** HOLE CARDS ***
ZarubaNT: folds 
leo 32824: folds 
floriiiiider: raises $9 to $15
mustanggino: folds 
vjxbkf: calls $12
dreamtech129: calls $9
*** FLOP *** [Td Ad 4h]
vjxbkf: checks 
dreamtech129: checks 
floriiiiider: bets $30
vjxbkf: folds 
dreamtech129: folds 
Uncalled bet ($30) returned to floriiiiider
floriiiiider collected $42.98 from pot
floriiiiider: doesn't show hand 
*** SUMMARY ***
Total pot $45 | Rake $2.02 
Board [Td Ad 4h]
Seat 1: leo 32824 folded before Flop (didn't bet)
Seat 2: floriiiiider collected ($42.98)
Seat 3: mustanggino (button) folded before Flop (didn't bet)
Seat 4: vjxbkf (small blind) folded on the Flop
Seat 5: dreamtech129 (big blind) folded on the Flop
Seat 6: ZarubaNT folded before Flop (didn't bet)


PokerStars Game #102597228101:  Hold'em No Limit ($3/$6 USD) - 2013/08/11 5:26:45 ET
Table 'Hakone VI 40-100 bb' 6-max Seat #4 is the button
Seat 1: leo 32824 ($1295.97 in chips) 
Seat 2: floriiiiider ($706.14 in chips) 
Seat 3: mustanggino ($551.08 in chips) 
Seat 4: vjxbkf ($1157.98 in chips) 
Seat 5: dreamtech129 ($1614.60 in chips) 
Seat 6: ZarubaNT ($627.70 in chips) 
dreamtech129: posts small blind $3
ZarubaNT: posts big blind $6
*** HOLE CARDS ***
leo 32824: raises $6 to $12
floriiiiider: folds 
mustanggino: calls $12
vjxbkf: folds 
dreamtech129: folds 
ZarubaNT: raises $42 to $54
leo 32824: folds 
mustanggino: calls $42
*** FLOP *** [9c 8c 9s]
ZarubaNT: bets $69
mustanggino: folds 
Uncalled bet ($69) returned to ZarubaNT
ZarubaNT collected $120.20 from pot
ZarubaNT: doesn't show hand 
*** SUMMARY ***
Total pot $123 | Rake $2.80 
Board [9c 8c 9s]
Seat 1: leo 32824 folded before Flop
Seat 2: floriiiiider folded before Flop (didn't bet)
Seat 3: mustanggino folded on the Flop
Seat 4: vjxbkf (button) folded before Flop (didn't bet)
Seat 5: dreamtech129 (small blind) folded before Flop
Seat 6: ZarubaNT (big blind) collected ($120.20)


PokerStars Game #102597251493:  Hold'em No Limit ($3/$6 USD) - 2013/08/11 5:27:44 ET
Table 'Hakone VI 40-100 bb' 6-max Seat #5 is the button
Seat 1: leo 32824 ($1283.97 in chips) 
Seat 2: floriiiiider ($706.14 in chips) 
Seat 3: mustanggino ($497.08 in chips) 
Seat 4: vjxbkf ($1157.98 in chips) 
Seat 5: dreamtech129 ($1611.60 in chips) 
Seat 6: ZarubaNT ($693.90 in chips) 
ZarubaNT: posts small blind $3
leo 32824: posts big blind $6
*** HOLE CARDS ***
floriiiiider: folds 
mustanggino: raises $6 to $12
vjxbkf: folds 
dreamtech129: folds 
ZarubaNT: folds 
leo 32824: folds 
Uncalled bet ($6) returned to mustanggino
mustanggino collected $15 from pot
mustanggino: doesn't show hand 
*** SUMMARY ***
Total pot $15 | Rake $0 
Seat 1: leo 32824 (big blind) folded before Flop
Seat 2: floriiiiider folded before Flop (didn't bet)
Seat 3: mustanggino collected ($15)
Seat 4: vjxbkf folded before Flop (didn't bet)
Seat 5: dreamtech129 (button) folded before Flop (didn't bet)
Seat 6: ZarubaNT (small blind) folded before Flop


PokerStars Game #102597259576:  Hold'em No Limit ($3/$6 USD) - 2013/08/11 5:28:05 ET
Table 'Hakone VI 40-100 bb' 6-max Seat #6 is the button
Seat 1: leo 32824 ($1277.97 in chips) 
Seat 2: floriiiiider ($706.14 in chips) 
Seat 3: mustanggino ($506.08 in chips) 
Seat 4: vjxbkf ($1157.98 in chips) 
Seat 5: dreamtech129 ($1611.60 in chips) 
Seat 6: ZarubaNT ($690.90 in chips) 
leo 32824: posts small blind $3
floriiiiider: posts big blind $6
*** HOLE CARDS ***
mustanggino: folds 
vjxbkf: folds 
dreamtech129: folds 
ZarubaNT: folds 
leo 32824: folds 
Uncalled bet ($3) returned to floriiiiider
floriiiiider collected $6 from pot
floriiiiider: doesn't show hand 
*** SUMMARY ***
Total pot $6 | Rake $0 
Seat 1: leo 32824 (small blind) folded before Flop
Seat 2: floriiiiider (big blind) collected ($6)
Seat 3: mustanggino folded before Flop (didn't bet)
Seat 4: vjxbkf folded before Flop (didn't bet)
Seat 5: dreamtech129 folded before Flop (didn't bet)
Seat 6: ZarubaNT (button) folded before Flop (didn't bet)


PokerStars Game #102597266516:  Hold'em No Limit ($3/$6 USD) - 2013/08/11 5:28:22 ET
Table 'Hakone VI 40-100 bb' 6-max Seat #1 is the button
Seat 1: leo 32824 ($1274.97 in chips) 
Seat 2: floriiiiider ($709.14 in chips) 
Seat 3: mustanggino ($506.08 in chips) 
Seat 4: vjxbkf ($1157.98 in chips) 
Seat 5: dreamtech129 ($1611.60 in chips) 
Seat 6: ZarubaNT ($690.90 in chips) 
floriiiiider: posts small blind $3
mustanggino: posts big blind $6
*** HOLE CARDS ***
vjxbkf: folds 
dreamtech129: folds 
ZarubaNT: folds 
leo 32824: raises $6 to $12
floriiiiider: folds 
mustanggino: calls $6
*** FLOP *** [9s 2c 4s]
mustanggino: checks 
leo 32824: checks 
*** TURN *** [9s 2c 4s] [2d]
mustanggino: checks 
leo 32824: checks 
*** RIVER *** [9s 2c 4s 2d] [7d]
mustanggino: bets $12
leo 32824: folds 
Uncalled bet ($12) returned to mustanggino
mustanggino collected $25.78 from pot
mustanggino: doesn't show hand 
*** SUMMARY ***
Total pot $27 | Rake $1.22 
Board [9s 2c 4s 2d 7d]
Seat 1: leo 32824 (button) folded on the River
Seat 2: floriiiiider (small blind) folded before Flop
Seat 3: mustanggino (big blind) collected ($25.78)
Seat 4: vjxbkf folded before Flop (didn't bet)
Seat 5: dreamtech129 folded before Flop (didn't bet)
Seat 6: ZarubaNT folded before Flop (didn't bet)


PokerStars Game #102597293012:  Hold'em No Limit ($3/$6 USD) - 2013/08/11 5:29:30 ET
Table 'Hakone VI 40-100 bb' 6-max Seat #2 is the button
Seat 1: leo 32824 ($1262.97 in chips) 
Seat 2: floriiiiider ($706.14 in chips) 
Seat 3: mustanggino ($519.86 in chips) 
Seat 4: vjxbkf ($1157.98 in chips) 
Seat 5: dreamtech129 ($1611.60 in chips) 
Seat 6: ZarubaNT ($690.90 in chips) 
mustanggino: posts small blind $3
vjxbkf: posts big blind $6
*** HOLE CARDS ***
dreamtech129: folds 
ZarubaNT: folds 
leo 32824: folds 
floriiiiider: folds 
mustanggino: raises $6 to $12
vjxbkf: calls $6
*** FLOP *** [Ad 5c 2s]
mustanggino: bets $12
vjxbkf: folds 
Uncalled bet ($12) returned to mustanggino
mustanggino collected $22.92 from pot
mustanggino: doesn't show hand 
*** SUMMARY ***
Total pot $24 | Rake $1.08 
Board [Ad 5c 2s]
Seat 1: leo 32824 folded before Flop (didn't bet)
Seat 2: floriiiiider (button) folded before Flop (didn't bet)
Seat 3: mustanggino (small blind) collected ($22.92)
Seat 4: vjxbkf (big blind) folded on the Flop
Seat 5: dreamtech129 folded before Flop (didn't bet)
Seat 6: ZarubaNT folded before Flop (didn't bet)


PokerStars Game #102597079512:  Hold'em No Limit ($3/$6 USD) - 2013/08/11 5:20:36 ET
Table 'Hakone VI 40-100 bb' 6-max Seat #3 is the button
Seat 1: leo 32824 ($1295.97 in chips) 
Seat 2: floriiiiider ($687.16 in chips) 
Seat 3: mustanggino ($563.08 in chips) 
Seat 4: vjxbkf ($944.78 in chips) 
Seat 5: dreamtech129 ($1638.60 in chips) 
Seat 6: ZarubaNT ($621.20 in chips) 
vjxbkf: posts small blind $3
dreamtech129: posts big blind $6
*** HOLE CARDS ***
ZarubaNT: folds 
leo 32824: folds 
floriiiiider: folds 
mustanggino: folds 
vjxbkf: raises $15 to $21
dreamtech129: folds 
Uncalled bet ($15) returned to vjxbkf
vjxbkf collected $12 from pot
vjxbkf: doesn't show hand 
*** SUMMARY ***
Total pot $12 | Rake $0 
Seat 1: leo 32824 folded before Flop (didn't bet)
Seat 2: floriiiiider folded before Flop (didn't bet)
Seat 3: mustanggino (button) folded before Flop (didn't bet)
Seat 4: vjxbkf (small blind) collected ($12)
Seat 5: dreamtech129 (big blind) folded before Flop
Seat 6: ZarubaNT folded before Flop (didn't bet)


PokerStars Game #102597093605:  Hold'em No Limit ($3/$6 USD) - 2013/08/11 5:21:11 ET
Table 'Hakone VI 40-100 bb' 6-max Seat #4 is the button
Seat 1: leo 32824 ($1295.97 in chips) 
Seat 2: floriiiiider ($687.16 in chips) 
Seat 3: mustanggino ($563.08 in chips) 
Seat 4: vjxbkf ($950.78 in chips) 
Seat 5: dreamtech129 ($1632.60 in chips) 
Seat 6: ZarubaNT ($621.20 in chips) 
dreamtech129: posts small blind $3
ZarubaNT: posts big blind $6
*** HOLE CARDS ***
leo 32824: folds 
floriiiiider: folds 
mustanggino: raises $6 to $12
vjxbkf: folds 
dreamtech129: folds 
ZarubaNT: raises $33 to $45
mustanggino: folds 
Uncalled bet ($33) returned to ZarubaNT
ZarubaNT collected $27 from pot
ZarubaNT: doesn't show hand 
*** SUMMARY ***
Total pot $27 | Rake $0 
Seat 1: leo 32824 folded before Flop (didn't bet)
Seat 2: floriiiiider folded before Flop (didn't bet)
Seat 3: mustanggino folded before Flop
Seat 4: vjxbkf (button) folded before Flop (didn't bet)
Seat 5: dreamtech129 (small blind) folded before Flop
Seat 6: ZarubaNT (big blind) collected ($27)


PokerStars Game #102597105427:  Hold'em No Limit ($3/$6 USD) - 2013/08/11 5:21:41 ET
Table 'Hakone VI 40-100 bb' 6-max Seat #5 is the button
Seat 1: leo 32824 ($1295.97 in chips) 
Seat 2: floriiiiider ($687.16 in chips) 
Seat 3: mustanggino ($551.08 in chips) 
Seat 4: vjxbkf ($950.78 in chips) 
Seat 5: dreamtech129 ($1629.60 in chips) 
Seat 6: ZarubaNT ($636.20 in chips) 
ZarubaNT: posts small blind $3
leo 32824: posts big blind $6
*** HOLE CARDS ***
floriiiiider: folds 
mustanggino: folds 
vjxbkf: raises $12 to $18
dreamtech129: folds 
ZarubaNT: calls $15
leo 32824: folds 
*** FLOP *** [Jd 3d 6s]
ZarubaNT: checks 
vjxbkf: bets $24
ZarubaNT: calls $24
*** TURN *** [Jd 3d 6s] [2s]
ZarubaNT: checks 
vjxbkf: bets $60
ZarubaNT: calls $60
*** RIVER *** [Jd 3d 6s 2s] [7s]
ZarubaNT: checks 
vjxbkf: bets $144
ZarubaNT: calls $144
*** SHOW DOWN ***
vjxbkf: shows [4s As] (a flush, Ace high)
ZarubaNT: mucks hand 
vjxbkf collected $495.20 from pot
*** SUMMARY ***
Total pot $498 | Rake $2.80 
Board [Jd 3d 6s 2s 7s]
Seat 1: leo 32824 (big blind) folded before Flop
Seat 2: floriiiiider folded before Flop (didn't bet)
Seat 3: mustanggino folded before Flop (didn't bet)
Seat 4: vjxbkf showed [4s As] and won ($495.20) with a flush, Ace high
Seat 5: dreamtech129 (button) folded before Flop (didn't bet)
Seat 6: ZarubaNT (small blind) mucked


PokerStars Game #102597153387:  Hold'em No Limit ($3/$6 USD) - 2013/08/11 5:23:39 ET
Table 'Hakone VI 40-100 bb' 6-max Seat #6 is the button
Seat 1: leo 32824 ($1289.97 in chips) 
Seat 2: floriiiiider ($687.16 in chips) 
Seat 3: mustanggino ($551.08 in chips) 
Seat 4: vjxbkf ($1199.98 in chips) 
Seat 5: dreamtech129 ($1629.60 in chips) 
Seat 6: ZarubaNT ($600 in chips) 
leo 32824: posts small blind $3
floriiiiider: posts big blind $6
*** HOLE CARDS ***
mustanggino: raises $6 to $12
vjxbkf: folds 
dreamtech129: folds 
ZarubaNT: folds 
leo 32824: folds 
floriiiiider: folds 
Uncalled bet ($6) returned to mustanggino
mustanggino collected $15 from pot
mustanggino: doesn't show hand 
*** SUMMARY ***
Total pot $15 | Rake $0 
Seat 1: leo 32824 (small blind) folded before Flop
Seat 2: floriiiiider (big blind) folded before Flop
Seat 3: mustanggino collected ($15)
Seat 4: vjxbkf folded before Flop (didn't bet)
Seat 5: dreamtech129 folded before Flop (didn't bet)
Seat 6: ZarubaNT (button) folded before Flop (didn't bet)


PokerStars Game #102597164782:  Hold'em No Limit ($3/$6 USD) - 2013/08/11 5:24:07 ET
Table 'Hakone VI 40-100 bb' 6-max Seat #1 is the button
Seat 1: leo 32824 ($1286.97 in chips) 
Seat 2: floriiiiider ($681.16 in chips) 
Seat 3: mustanggino ($560.08 in chips) 
Seat 4: vjxbkf ($1199.98 in chips) 
Seat 5: dreamtech129 ($1629.60 in chips) 
Seat 6: ZarubaNT ($600 in chips) 
floriiiiider: posts small blind $3
mustanggino: posts big blind $6
*** HOLE CARDS ***
vjxbkf: raises $15 to $21
dreamtech129: folds 
ZarubaNT: calls $21
leo 32824: folds 
floriiiiider: folds 
mustanggino: folds 
*** FLOP *** [5h Jh Td]
vjxbkf: checks 
ZarubaNT: checks 
*** TURN *** [5h Jh Td] [8c]
vjxbkf: checks 
ZarubaNT: bets $36
vjxbkf: folds 
Uncalled bet ($36) returned to ZarubaNT
ZarubaNT collected $48.70 from pot
ZarubaNT: doesn't show hand 
*** SUMMARY ***
Total pot $51 | Rake $2.30 
Board [5h Jh Td 8c]
Seat 1: leo 32824 (button) folded before Flop (didn't bet)
Seat 2: floriiiiider (small blind) folded before Flop
Seat 3: mustanggino (big blind) folded before Flop
Seat 4: vjxbkf folded on the Turn
Seat 5: dreamtech129 folded before Flop (didn't bet)
Seat 6: ZarubaNT collected ($48.70)


PokerStars Game #102596949331:  Hold'em No Limit ($3/$6 USD) - 2013/08/11 5:15:08 ET
Table 'Hakone VI 40-100 bb' 6-max Seat #5 is the button
Seat 1: leo 32824 ($1294.32 in chips) 
Seat 2: floriiiiider ($653.96 in chips) 
Seat 3: mustanggino ($598.24 in chips) 
Seat 4: JulyShort ($234.43 in chips) 
Seat 5: dreamtech129 ($1656.60 in chips) 
Seat 6: ZarubaNT ($603 in chips) 
ZarubaNT: posts small blind $3
leo 32824: posts big blind $6
*** HOLE CARDS ***
floriiiiider: folds 
mustanggino: folds 
JulyShort: folds 
dreamtech129: raises $7.80 to $13.80
ZarubaNT: folds 
leo 32824: folds 
Uncalled bet ($7.80) returned to dreamtech129
dreamtech129 collected $15 from pot
dreamtech129: doesn't show hand 
*** SUMMARY ***
Total pot $15 | Rake $0 
Seat 1: leo 32824 (big blind) folded before Flop
Seat 2: floriiiiider folded before Flop (didn't bet)
Seat 3: mustanggino folded before Flop (didn't bet)
Seat 4: JulyShort folded before Flop (didn't bet)
Seat 5: dreamtech129 (button) collected ($15)
Seat 6: ZarubaNT (small blind) folded before Flop


PokerStars Game #102596957100:  Hold'em No Limit ($3/$6 USD) - 2013/08/11 5:15:27 ET
Table 'Hakone VI 40-100 bb' 6-max Seat #6 is the button
Seat 1: leo 32824 ($1288.32 in chips) 
Seat 2: floriiiiider ($653.96 in chips) 
Seat 3: mustanggino ($598.24 in chips) 
Seat 4: JulyShort ($234.43 in chips) 
Seat 5: dreamtech129 ($1665.60 in chips) 
Seat 6: ZarubaNT ($600 in chips) 
leo 32824: posts small blind $3
floriiiiider: posts big blind $6
*** HOLE CARDS ***
mustanggino: folds 
JulyShort: folds 
dreamtech129: folds 
ZarubaNT: raises $6 to $12
leo 32824: calls $9
floriiiiider: folds 
*** FLOP *** [8c Kh 6h]
leo 32824: checks 
ZarubaNT: bets $18
leo 32824: folds 
Uncalled bet ($18) returned to ZarubaNT
ZarubaNT collected $28.65 from pot
ZarubaNT: doesn't show hand 
*** SUMMARY ***
Total pot $30 | Rake $1.35 
Board [8c Kh 6h]
Seat 1: leo 32824 (small blind) folded on the Flop
Seat 2: floriiiiider (big blind) folded before Flop
Seat 3: mustanggino folded before Flop (didn't bet)
Seat 4: JulyShort folded before Flop (didn't bet)
Seat 5: dreamtech129 folded before Flop (didn't bet)
Seat 6: ZarubaNT (button) collected ($28.65)


PokerStars Game #102596970990:  Hold'em No Limit ($3/$6 USD) - 2013/08/11 5:16:03 ET
Table 'Hakone VI 40-100 bb' 6-max Seat #1 is the button
Seat 1: leo 32824 ($1276.32 in chips) 
Seat 2: floriiiiider ($647.96 in chips) 
Seat 3: mustanggino ($598.24 in chips) 
Seat 4: JulyShort ($234.43 in chips) 
Seat 5: dreamtech129 ($1665.60 in chips) 
Seat 6: ZarubaNT ($616.65 in chips) 
floriiiiider: posts small blind $3
mustanggino: posts big blind $6
*** HOLE CARDS ***
JulyShort: folds 
dreamtech129: folds 
ZarubaNT: folds 
leo 32824: folds 
floriiiiider: folds 
Uncalled bet ($3) returned to mustanggino
mustanggino collected $6 from pot
mustanggino: doesn't show hand 
*** SUMMARY ***
Total pot $6 | Rake $0 
Seat 1: leo 32824 (button) folded before Flop (didn't bet)
Seat 2: floriiiiider (small blind) folded before Flop
Seat 3: mustanggino (big blind) collected ($6)
Seat 4: JulyShort folded before Flop (didn't bet)
Seat 5: dreamtech129 folded before Flop (didn't bet)
Seat 6: ZarubaNT folded before Flop (didn't bet)


PokerStars Game #102596975691:  Hold'em No Limit ($3/$6 USD) - 2013/08/11 5:16:14 ET
Table 'Hakone VI 40-100 bb' 6-max Seat #2 is the button
Seat 1: leo 32824 ($1276.32 in chips) 
Seat 2: floriiiiider ($644.96 in chips) 
Seat 3: mustanggino ($601.24 in chips) 
Seat 5: dreamtech129 ($1665.60 in chips) 
Seat 6: ZarubaNT ($616.65 in chips) 
mustanggino: posts small blind $3
JulyShort: is sitting out 
dreamtech129: posts big blind $6
*** HOLE CARDS ***
ZarubaNT: folds 
JulyShort leaves the table
leo 32824: folds 
floriiiiider: folds 
khk24 joins the table at seat #4 
mustanggino: raises $6 to $12
dreamtech129: calls $6
*** FLOP *** [2h 6h Td]
mustanggino: bets $12
khk24 leaves the table
dreamtech129: calls $12
*** TURN *** [2h 6h Td] [Th]
vjxbkf joins the table at seat #4 
mustanggino: checks 
dreamtech129: checks 
*** RIVER *** [2h 6h Td Th] [Kd]
mustanggino: checks 
dreamtech129: checks 
*** SHOW DOWN ***
mustanggino: shows [Ac 3d] (a pair of Tens)
dreamtech129: mucks hand 
mustanggino collected $45.84 from pot
*** SUMMARY ***
Total pot $48 | Rake $2.16 
Board [2h 6h Td Th Kd]
Seat 1: leo 32824 folded before Flop (didn't bet)
Seat 2: floriiiiider (button) folded before Flop (didn't bet)
Seat 3: mustanggino (small blind) showed [Ac 3d] and won ($45.84) with a pair of Tens
Seat 5: dreamtech129 (big blind) mucked
Seat 6: ZarubaNT folded before Flop (didn't bet)


PokerStars Game #102596993129:  Hold'em No Limit ($3/$6 USD) - 2013/08/11 5:16:59 ET
Table 'Hakone VI 40-100 bb' 6-max Seat #3 is the button
Seat 1: leo 32824 ($1276.32 in chips) 
Seat 2: floriiiiider ($644.96 in chips) 
Seat 3: mustanggino ($623.08 in chips) 
Seat 5: dreamtech129 ($1641.60 in chips) 
Seat 6: ZarubaNT ($616.65 in chips) 
vjxbkf will be allowed to play after the button
dreamtech129: posts small blind $3
ZarubaNT: posts big blind $6
*** HOLE CARDS ***
leo 32824: folds 
floriiiiider: raises $9 to $15
mustanggino: folds 
dreamtech129: folds 
ZarubaNT: raises $36 to $51
floriiiiider: calls $36
*** FLOP *** [Kc 6c 2s]
ZarubaNT: checks 
floriiiiider: bets $54
ZarubaNT: folds 
Uncalled bet ($54) returned to floriiiiider
floriiiiider collected $102.20 from pot
floriiiiider: doesn't show hand 
*** SUMMARY ***
Total pot $105 | Rake $2.80 
Board [Kc 6c 2s]
Seat 1: leo 32824 folded before Flop (didn't bet)
Seat 2: floriiiiider collected ($102.20)
Seat 3: mustanggino (button) folded before Flop (didn't bet)
Seat 5: dreamtech129 (small blind) folded before Flop
Seat 6: ZarubaNT (big blind) folded on the Flop


PokerStars Game #102597008581:  Hold'em No Limit ($3/$6 USD) - 2013/08/11 5:17:37 ET
Table 'Hakone VI 40-100 bb' 6-max Seat #5 is the button
Seat 1: leo 32824 ($1276.32 in chips) 
Seat 2: floriiiiider ($696.16 in chips) 
Seat 3: mustanggino ($623.08 in chips) 
Seat 5: dreamtech129 ($1638.60 in chips) 
Seat 6: ZarubaNT ($600 in chips) 
ZarubaNT: posts small blind $3
leo 32824: posts big blind $6
vjxbkf: sits out 
*** HOLE CARDS ***
floriiiiider: folds 
mustanggino: raises $6 to $12
dreamtech129: folds 
ZarubaNT: calls $9
leo 32824: folds 
*** FLOP *** [4d Js 9s]
ZarubaNT: checks 
mustanggino: bets $18
ZarubaNT: calls $18
*** TURN *** [4d Js 9s] [Jh]
ZarubaNT: checks 
mustanggino: checks 
*** RIVER *** [4d Js 9s Jh] [Ac]
ZarubaNT: checks 
mustanggino: checks 
*** SHOW DOWN ***
ZarubaNT: shows [As Jc] (a full house, Jacks full of Aces)
mustanggino: mucks hand 
ZarubaNT collected $63.20 from pot
*** SUMMARY ***
Total pot $66 | Rake $2.80 
Board [4d Js 9s Jh Ac]
Seat 1: leo 32824 (big blind) folded before Flop
Seat 2: floriiiiider folded before Flop (didn't bet)
Seat 3: mustanggino mucked
Seat 5: dreamtech129 (button) folded before Flop (didn't bet)
Seat 6: ZarubaNT (small blind) showed [As Jc] and won ($63.20) with a full house, Jacks full of Aces


PokerStars Game #102597035320:  Hold'em No Limit ($3/$6 USD) - 2013/08/11 5:18:44 ET
Table 'Hakone VI 40-100 bb' 6-max Seat #6 is the button
Seat 1: leo 32824 ($1270.32 in chips) 
Seat 2: floriiiiider ($696.16 in chips) 
Seat 3: mustanggino ($593.08 in chips) 
Seat 5: dreamtech129 ($1638.60 in chips) 
Seat 6: ZarubaNT ($633.20 in chips) 
leo 32824: posts small blind $3
floriiiiider: posts big blind $6
vjxbkf: sits out 
*** HOLE CARDS ***
mustanggino: folds 
dreamtech129: folds 
ZarubaNT: raises $6 to $12
leo 32824: calls $9
floriiiiider: folds 
*** FLOP *** [8d 9h 9c]
leo 32824: bets $18
ZarubaNT: folds 
Uncalled bet ($18) returned to leo 32824
leo 32824 collected $28.65 from pot
*** SUMMARY ***
Total pot $30 | Rake $1.35 
Board [8d 9h 9c]
Seat 1: leo 32824 (small blind) collected ($28.65)
Seat 2: floriiiiider (big blind) folded before Flop
Seat 3: mustanggino folded before Flop (didn't bet)
Seat 5: dreamtech129 folded before Flop (didn't bet)
Seat 6: ZarubaNT (button) folded on the Flop


PokerStars Game #102597045688:  Hold'em No Limit ($3/$6 USD) - 2013/08/11 5:19:10 ET
Table 'Hakone VI 40-100 bb' 6-max Seat #1 is the button
Seat 1: leo 32824 ($1286.97 in chips) 
Seat 2: floriiiiider ($690.16 in chips) 
Seat 3: mustanggino ($593.08 in chips) 
Seat 5: dreamtech129 ($1638.60 in chips) 
Seat 6: ZarubaNT ($621.20 in chips) 
floriiiiider: posts small blind $3
mustanggino: posts big blind $6
vjxbkf: sits out 
*** HOLE CARDS ***
dreamtech129: folds 
ZarubaNT: folds 
leo 32824: raises $6 to $12
floriiiiider: folds 
mustanggino: folds 
Uncalled bet ($6) returned to leo 32824
leo 32824 collected $15 from pot
*** SUMMARY ***
Total pot $15 | Rake $0 
Seat 1: leo 32824 (button) collected ($15)
Seat 2: floriiiiider (small blind) folded before Flop
Seat 3: mustanggino (big blind) folded before Flop
Seat 5: dreamtech129 folded before Flop (didn't bet)
Seat 6: ZarubaNT folded before Flop (didn't bet)


PokerStars Game #102597050149:  Hold'em No Limit ($3/$6 USD) - 2013/08/11 5:19:22 ET
Table 'Hakone VI 40-100 bb' 6-max Seat #2 is the button
Seat 1: leo 32824 ($1295.97 in chips) 
Seat 2: floriiiiider ($687.16 in chips) 
Seat 3: mustanggino ($587.08 in chips) 
Seat 4: vjxbkf ($922.94 in chips) 
Seat 5: dreamtech129 ($1638.60 in chips) 
Seat 6: ZarubaNT ($621.20 in chips) 
mustanggino: posts small blind $3
vjxbkf: posts big blind $6
*** HOLE CARDS ***
dreamtech129: folds 
ZarubaNT: folds 
leo 32824: folds 
floriiiiider: folds 
mustanggino: raises $6 to $12
vjxbkf: calls $6
*** FLOP *** [5h Tc As]
mustanggino: bets $12
vjxbkf: calls $12
*** TURN *** [5h Tc As] [4s]
mustanggino: checks 
vjxbkf: bets $27
mustanggino: folds 
Uncalled bet ($27) returned to vjxbkf
vjxbkf collected $45.84 from pot
vjxbkf: doesn't show hand 
*** SUMMARY ***
Total pot $48 | Rake $2.16 
Board [5h Tc As 4s]
Seat 1: leo 32824 folded before Flop (didn't bet)
Seat 2: floriiiiider (button) folded before Flop (didn't bet)
Seat 3: mustanggino (small blind) folded on the Turn
Seat 4: vjxbkf (big blind) collected ($45.84)
Seat 5: dreamtech129 folded before Flop (didn't bet)
Seat 6: ZarubaNT folded before Flop (didn't bet)


PokerStars Game #102597311088:  Hold'em No Limit ($3/$6 USD) - 2013/08/11 5:30:15 ET
Table 'Hakone VI 40-100 bb' 6-max Seat #3 is the button
Seat 1: leo 32824 ($1262.97 in chips) 
Seat 2: floriiiiider ($706.14 in chips) 
Seat 3: mustanggino ($530.78 in chips) 
Seat 4: vjxbkf ($1145.98 in chips) 
Seat 5: dreamtech129 ($1611.60 in chips) 
Seat 6: ZarubaNT ($690.90 in chips) 
vjxbkf: posts small blind $3
dreamtech129: posts big blind $6
*** HOLE CARDS ***
ZarubaNT: folds 
leo 32824: folds 
floriiiiider: folds 
mustanggino: raises $6 to $12
vjxbkf: folds 
dreamtech129: raises $33 to $45
mustanggino: folds 
Uncalled bet ($33) returned to dreamtech129
dreamtech129 collected $27 from pot
dreamtech129: doesn't show hand 
*** SUMMARY ***
Total pot $27 | Rake $0 
Seat 1: leo 32824 folded before Flop (didn't bet)
Seat 2: floriiiiider folded before Flop (didn't bet)
Seat 3: mustanggino (button) folded before Flop
Seat 4: vjxbkf (small blind) folded before Flop
Seat 5: dreamtech129 (big blind) collected ($27)
Seat 6: ZarubaNT folded before Flop (didn't bet)


PokerStars Game #102597321614:  Hold'em No Limit ($3/$6 USD) - 2013/08/11 5:30:41 ET
Table 'Hakone VI 40-100 bb' 6-max Seat #4 is the button
Seat 1: leo 32824 ($1262.97 in chips) 
Seat 2: floriiiiider ($706.14 in chips) 
Seat 3: mustanggino ($518.78 in chips) 
Seat 4: vjxbkf ($1142.98 in chips) 
Seat 5: dreamtech129 ($1626.60 in chips) 
Seat 6: ZarubaNT ($690.90 in chips) 
dreamtech129: posts small blind $3
ZarubaNT: posts big blind $6
*** HOLE CARDS ***
leo 32824: folds 
floriiiiider: folds 
mustanggino: folds 
vjxbkf: folds 
dreamtech129: folds 
Uncalled bet ($3) returned to ZarubaNT
ZarubaNT collected $6 from pot
ZarubaNT: doesn't show hand 
*** SUMMARY ***
Total pot $6 | Rake $0 
Seat 1: leo 32824 folded before Flop (didn't bet)
Seat 2: floriiiiider folded before Flop (didn't bet)
Seat 3: mustanggino folded before Flop (didn't bet)
Seat 4: vjxbkf (button) folded before Flop (didn't bet)
Seat 5: dreamtech129 (small blind) folded before Flop
Seat 6: ZarubaNT (big blind) collected ($6)


PokerStars Game #102597333074:  Hold'em No Limit ($3/$6 USD) - 2013/08/11 5:31:10 ET
Table 'Hakone VI 40-100 bb' 6-max Seat #5 is the button
Seat 1: leo 32824 ($1262.97 in chips) 
Seat 2: floriiiiider ($706.14 in chips) 
Seat 3: mustanggino ($518.78 in chips) 
Seat 4: vjxbkf ($1142.98 in chips) 
Seat 5: dreamtech129 ($1623.60 in chips) 
Seat 6: ZarubaNT ($693.90 in chips) 
ZarubaNT: posts small blind $3
leo 32824: posts big blind $6
*** HOLE CARDS ***
floriiiiider: folds 
mustanggino: raises $6 to $12
vjxbkf: folds 
dreamtech129: folds 
ZarubaNT: folds 
leo 32824: calls $6
*** FLOP *** [2d Jd 5d]
leo 32824: checks 
mustanggino: bets $12
leo 32824: calls $12
*** TURN *** [2d Jd 5d] [Qc]
leo 32824: checks 
mustanggino: bets $36
leo 32824: folds 
Uncalled bet ($36) returned to mustanggino
mustanggino collected $48.70 from pot
mustanggino: doesn't show hand 
*** SUMMARY ***
Total pot $51 | Rake $2.30 
Board [2d Jd 5d Qc]
Seat 1: leo 32824 (big blind) folded on the Turn
Seat 2: floriiiiider folded before Flop (didn't bet)
Seat 3: mustanggino collected ($48.70)
Seat 4: vjxbkf folded before Flop (didn't bet)
Seat 5: dreamtech129 (button) folded before Flop (didn't bet)
Seat 6: ZarubaNT (small blind) folded before Flop


PokerStars Game #102597358514:  Hold'em No Limit ($3/$6 USD) - 2013/08/11 5:32:15 ET
Table 'Hakone VI 40-100 bb' 6-max Seat #6 is the button
Seat 1: leo 32824 ($1238.97 in chips) 
Seat 2: floriiiiider ($706.14 in chips) 
Seat 3: mustanggino ($543.48 in chips) 
Seat 4: vjxbkf ($1142.98 in chips) 
Seat 5: dreamtech129 ($1623.60 in chips) 
Seat 6: ZarubaNT ($690.90 in chips) 
leo 32824: posts small blind $3
floriiiiider: posts big blind $6
*** HOLE CARDS ***
mustanggino: folds 
vjxbkf: folds 
dreamtech129: folds 
ZarubaNT: folds 
leo 32824: raises $9 to $15
floriiiiider: calls $9
*** FLOP *** [4c Jc 8c]
leo 32824: bets $30
floriiiiider: folds 
Uncalled bet ($30) returned to leo 32824
leo 32824 collected $28.65 from pot
*** SUMMARY ***
Total pot $30 | Rake $1.35 
Board [4c Jc 8c]
Seat 1: leo 32824 (small blind) collected ($28.65)
Seat 2: floriiiiider (big blind) folded on the Flop
Seat 3: mustanggino folded before Flop (didn't bet)
Seat 4: vjxbkf folded before Flop (didn't bet)
Seat 5: dreamtech129 folded before Flop (didn't bet)
Seat 6: ZarubaNT (button) folded before Flop (didn't bet)


PokerStars Game #102597371612:  Hold'em No Limit ($3/$6 USD) - 2013/08/11 5:32:48 ET
Table 'Hakone VI 40-100 bb' 6-max Seat #1 is the button
Seat 1: leo 32824 ($1252.62 in chips) 
Seat 2: floriiiiider ($691.14 in chips) 
Seat 3: mustanggino ($543.48 in chips) 
Seat 4: vjxbkf ($1142.98 in chips) 
Seat 5: dreamtech129 ($1623.60 in chips) 
Seat 6: ZarubaNT ($690.90 in chips) 
floriiiiider: posts small blind $3
mustanggino: posts big blind $6
*** HOLE CARDS ***
vjxbkf: folds 
dreamtech129: folds 
ZarubaNT: folds 
leo 32824: raises $6 to $12
floriiiiider: folds 
mustanggino: folds 
Uncalled bet ($6) returned to leo 32824
leo 32824 collected $15 from pot
*** SUMMARY ***
Total pot $15 | Rake $0 
Seat 1: leo 32824 (button) collected ($15)
Seat 2: floriiiiider (small blind) folded before Flop
Seat 3: mustanggino (big blind) folded before Flop
Seat 4: vjxbkf folded before Flop (didn't bet)
Seat 5: dreamtech129 folded before Flop (didn't bet)
Seat 6: ZarubaNT folded before Flop (didn't bet)


PokerStars Game #102597377374:  Hold'em No Limit ($3/$6 USD) - 2013/08/11 5:33:03 ET
Table 'Hakone VI 40-100 bb' 6-max Seat #2 is the button
Seat 1: leo 32824 ($1261.62 in chips) 
Seat 2: floriiiiider ($688.14 in chips) 
Seat 3: mustanggino ($537.48 in chips) 
Seat 5: dreamtech129 ($1623.60 in chips) 
Seat 6: ZarubaNT ($690.90 in chips) 
mustanggino: posts small blind $3
vjxbkf: is sitting out 
dreamtech129: posts big blind $6
*** HOLE CARDS ***
ZarubaNT: folds 
leo 32824: folds 
floriiiiider: raises $6 to $12
mustanggino: folds 
dreamtech129: folds 
Uncalled bet ($6) returned to floriiiiider
floriiiiider collected $15 from pot
floriiiiider: doesn't show hand 
*** SUMMARY ***
Total pot $15 | Rake $0 
Seat 1: leo 32824 folded before Flop (didn't bet)
Seat 2: floriiiiider (button) collected ($15)
Seat 3: mustanggino (small blind) folded before Flop
Seat 5: dreamtech129 (big blind) folded before Flop
Seat 6: ZarubaNT folded before Flop (didn't bet)


PokerStars Game #102597390634:  Hold'em No Limit ($3/$6 USD) - 2013/08/11 5:33:36 ET
Table 'Hakone VI 40-100 bb' 6-max Seat #3 is the button
Seat 1: leo 32824 ($1261.62 in chips) 
Seat 2: floriiiiider ($697.14 in chips) 
Seat 3: mustanggino ($534.48 in chips) 
Seat 5: dreamtech129 ($1617.60 in chips) 
Seat 6: ZarubaNT ($690.90 in chips) 
dreamtech129: posts small blind $3
ZarubaNT: posts big blind $6
*** HOLE CARDS ***
vjxbkf leaves the table
leo 32824 has timed out
leo 32824: folds 
floriiiiider: folds 
mustanggino: folds 
dreamtech129: folds 
Uncalled bet ($3) returned to ZarubaNT
ZarubaNT collected $6 from pot
ZarubaNT: doesn't show hand 
*** SUMMARY ***
Total pot $6 | Rake $0 
Seat 1: leo 32824 folded before Flop (didn't bet)
Seat 2: floriiiiider folded before Flop (didn't bet)
Seat 3: mustanggino (button) folded before Flop (didn't bet)
Seat 5: dreamtech129 (small blind) folded before Flop
Seat 6: ZarubaNT (big blind) collected ($6)


PokerStars Game #102597402477:  Hold'em No Limit ($3/$6 USD) - 2013/08/11 5:34:06 ET
Table 'Hakone VI 40-100 bb' 6-max Seat #5 is the button
Seat 2: floriiiiider ($697.14 in chips) 
Seat 3: mustanggino ($534.48 in chips) 
Seat 5: dreamtech129 ($1614.60 in chips) 
Seat 6: ZarubaNT ($693.90 in chips) 
ZarubaNT: posts small blind $3
floriiiiider: posts big blind $6
*** HOLE CARDS ***
mustanggino: folds 
dreamtech129: raises $7.80 to $13.80
ZarubaNT: folds 
floriiiiider: calls $7.80
*** FLOP *** [7c Ac Tc]
floriiiiider: checks 
dreamtech129: bets $18
floriiiiider: folds 
Uncalled bet ($18) returned to dreamtech129
dreamtech129 collected $29.22 from pot
dreamtech129: doesn't show hand 
*** SUMMARY ***
Total pot $30.60 | Rake $1.38 
Board [7c Ac Tc]
Seat 2: floriiiiider (big blind) folded on the Flop
Seat 3: mustanggino folded before Flop (didn't bet)
Seat 5: dreamtech129 (button) collected ($29.22)
Seat 6: ZarubaNT (small blind) folded before Flop


PokerStars Game #102597413019:  Hold'em No Limit ($3/$6 USD) - 2013/08/11 5:34:33 ET
Table 'Hakone VI 40-100 bb' 6-max Seat #6 is the button
Seat 2: floriiiiider ($683.34 in chips) 
Seat 5: dreamtech129 ($1630.02 in chips) 
Seat 6: ZarubaNT ($690.90 in chips) 
leo 32824 will be allowed to play after the button
floriiiiider: posts small blind $3
mustanggino: is sitting out 
dreamtech129: posts big blind $6
*** HOLE CARDS ***
ZarubaNT: raises $6 to $12
floriiiiider: folds 
dreamtech129: folds 
Uncalled bet ($6) returned to ZarubaNT
leo 32824 leaves the table
ZarubaNT collected $15 from pot
ZarubaNT: doesn't show hand 
*** SUMMARY ***
Total pot $15 | Rake $0 
Seat 2: floriiiiider (small blind) folded before Flop
Seat 5: dreamtech129 (big blind) folded before Flop
Seat 6: ZarubaNT (button) collected ($15)


PokerStars Game #102597421842:  Hold'em No Limit ($3/$6 USD) - 2013/08/11 5:34:54 ET
Table 'Hakone VI 40-100 bb' 6-max Seat #5 is the button
Seat 5: dreamtech129 ($1624.02 in chips) 
Seat 6: Ratatuj ($240 in chips) 
dreamtech129: posts small blind $3
Ratatuj: posts big blind $6
*** HOLE CARDS ***
dreamtech129: raises $7.80 to $13.80
Ratatuj: calls $7.80
*** FLOP *** [2s 7h 3h]
Ratatuj: checks 
dreamtech129: checks 
*** TURN *** [2s 7h 3h] [2h]
Ratatuj: checks 
dreamtech129: checks 
*** RIVER *** [2s 7h 3h 2h] [4s]
mustanggino leaves the table
Ratatuj: checks 
dreamtech129: checks 
*** SHOW DOWN ***
Ratatuj: shows [Qc 8c] (a pair of Deuces)
dreamtech129: mucks hand 
Ratatuj collected $27.10 from pot
*** SUMMARY ***
Total pot $27.60 | Rake $0.50 
Board [2s 7h 3h 2h 4s]
Seat 5: dreamtech129 (button) (small blind) mucked
Seat 6: Ratatuj (big blind) showed [Qc 8c] and won ($27.10) with a pair of Deuces
