

PokerStars Game #102619347477:  Hold'em No Limit ($3/$6 USD) - 2013/08/11 15:10:07 ET
Table 'Crux V 40-100 bb' 6-max Seat #3 is the button
Seat 1: teunuss ($600 in chips) 
Seat 2: borntotilt ($600 in chips) 
Seat 3: mikimiki88 ($600 in chips) 
Seat 4: Scarface.VLT ($600 in chips) 
Seat 5: Luthimir ($297 in chips) 
Seat 6: mustanggino ($459 in chips) 
Scarface.VLT: posts small blind $3
Luthimir: posts big blind $6
*** HOLE CARDS ***
mustanggino: raises $6 to $12
teunuss: folds 
borntotilt: folds 
mikimiki88: raises $21 to $33
Scarface.VLT: folds 
Luthimir: folds 
mustanggino: folds 
Uncalled bet ($21) returned to mikimiki88
mikimiki88 collected $33 from pot
mikimiki88: doesn't show hand 
*** SUMMARY ***
Total pot $33 | Rake $0 
Seat 1: teunuss folded before Flop (didn't bet)
Seat 2: borntotilt folded before Flop (didn't bet)
Seat 3: mikimiki88 (button) collected ($33)
Seat 4: Scarface.VLT (small blind) folded before Flop
Seat 5: Luthimir (big blind) folded before Flop
Seat 6: mustanggino folded before Flop


PokerStars Game #102619385419:  Hold'em No Limit ($3/$6 USD) - 2013/08/11 15:10:47 ET
Table 'Crux V 40-100 bb' 6-max Seat #4 is the button
Seat 1: teunuss ($600 in chips) 
Seat 2: borntotilt ($600 in chips) 
Seat 3: mikimiki88 ($621 in chips) 
Seat 4: Scarface.VLT ($600 in chips) 
Seat 5: Luthimir ($291 in chips) 
Seat 6: mustanggino ($450 in chips) 
Luthimir: posts small blind $3
mustanggino: posts big blind $6
*** HOLE CARDS ***
teunuss: raises $12 to $18
borntotilt: folds 
mikimiki88: calls $18
Scarface.VLT: folds 
Luthimir: folds 
mustanggino: folds 
*** FLOP *** [Tc Jd Qh]
teunuss: bets $33
mikimiki88: calls $33
*** TURN *** [Tc Jd Qh] [8c]
teunuss: bets $75
mikimiki88: calls $75
*** RIVER *** [Tc Jd Qh 8c] [5s]
teunuss: bets $228
mikimiki88: folds 
Uncalled bet ($228) returned to teunuss
teunuss collected $258.20 from pot
teunuss: doesn't show hand 
*** SUMMARY ***
Total pot $261 | Rake $2.80 
Board [Tc Jd Qh 8c 5s]
Seat 1: teunuss collected ($258.20)
Seat 2: borntotilt folded before Flop (didn't bet)
Seat 3: mikimiki88 folded on the River
Seat 4: Scarface.VLT (button) folded before Flop (didn't bet)
Seat 5: Luthimir (small blind) folded before Flop
Seat 6: mustanggino (big blind) folded before Flop


PokerStars Game #102619451303:  Hold'em No Limit ($3/$6 USD) - 2013/08/11 15:11:57 ET
Table 'Crux V 40-100 bb' 6-max Seat #5 is the button
Seat 1: teunuss ($732.20 in chips) 
Seat 2: borntotilt ($600 in chips) 
Seat 3: mikimiki88 ($600 in chips) 
Seat 4: Scarface.VLT ($600 in chips) 
Seat 5: Luthimir ($288 in chips) 
Seat 6: mustanggino ($450 in chips) 
mustanggino: posts small blind $3
teunuss: posts big blind $6
*** HOLE CARDS ***
borntotilt: folds 
mikimiki88: raises $12 to $18
Scarface.VLT: folds 
Luthimir: folds 
mustanggino: folds 
teunuss: calls $12
*** FLOP *** [6d 2d 8c]
teunuss: checks 
mikimiki88: bets $26.44
teunuss: raises $48.56 to $75
mikimiki88: calls $48.56
*** TURN *** [6d 2d 8c] [6h]
teunuss: bets $123
mikimiki88: folds 
Uncalled bet ($123) returned to teunuss
teunuss collected $186.20 from pot
teunuss: doesn't show hand 
*** SUMMARY ***
Total pot $189 | Rake $2.80 
Board [6d 2d 8c 6h]
Seat 1: teunuss (big blind) collected ($186.20)
Seat 2: borntotilt folded before Flop (didn't bet)
Seat 3: mikimiki88 folded on the Turn
Seat 4: Scarface.VLT folded before Flop (didn't bet)
Seat 5: Luthimir (button) folded before Flop (didn't bet)
Seat 6: mustanggino (small blind) folded before Flop


PokerStars Game #102619529033:  Hold'em No Limit ($3/$6 USD) - 2013/08/11 15:13:20 ET
Table 'Crux V 40-100 bb' 6-max Seat #6 is the button
Seat 1: teunuss ($825.40 in chips) 
Seat 3: mikimiki88 ($600 in chips) 
Seat 4: Scarface.VLT ($600 in chips) 
Seat 5: Luthimir ($288 in chips) 
Seat 6: mustanggino ($450 in chips) 
teunuss: posts small blind $3
borntotilt: is sitting out 
mikimiki88: posts big blind $6
*** HOLE CARDS ***
Scarface.VLT: folds 
Luthimir: raises $6 to $12
mustanggino: folds 
teunuss: folds 
mikimiki88: calls $6
*** FLOP *** [Qh 5h Ts]
mikimiki88: checks 
Luthimir: bets $13
mikimiki88: calls $13
*** TURN *** [Qh 5h Ts] [Qc]
mikimiki88: checks 
borntotilt leaves the table
Luthimir: checks 
*** RIVER *** [Qh 5h Ts Qc] [8c]
mikimiki88: checks 
Luthimir: checks 
*** SHOW DOWN ***
mikimiki88: shows [6h 8h] (two pair, Queens and Eights)
Luthimir: mucks hand 
mikimiki88 collected $50.62 from pot
*** SUMMARY ***
Total pot $53 | Rake $2.38 
Board [Qh 5h Ts Qc 8c]
Seat 1: teunuss (small blind) folded before Flop
Seat 3: mikimiki88 (big blind) showed [6h 8h] and won ($50.62) with two pair, Queens and Eights
Seat 4: Scarface.VLT folded before Flop (didn't bet)
Seat 5: Luthimir mucked
Seat 6: mustanggino (button) folded before Flop (didn't bet)


PokerStars Game #102619201546:  Hold'em No Limit ($3/$6 USD) - 2013/08/11 15:07:31 ET
Table 'Crux V 40-100 bb' 6-max Seat #6 is the button
Seat 1: teunuss ($600 in chips) 
Seat 2: borntotilt ($600 in chips) 
Seat 3: mikimiki88 ($600 in chips) 
Seat 4: Scarface.VLT ($600 in chips) 
Seat 5: Luthimir ($240 in chips) 
Seat 6: mustanggino ($450 in chips) 
teunuss: posts small blind $3
borntotilt: posts big blind $6
*** HOLE CARDS ***
mikimiki88: folds 
Scarface.VLT: folds 
Luthimir: raises $6 to $12
mustanggino: folds 
teunuss: raises $30 to $42
borntotilt: folds 
Luthimir: raises $198 to $240 and is all-in
teunuss: folds 
Uncalled bet ($198) returned to Luthimir
Luthimir collected $90 from pot
Luthimir: doesn't show hand 
*** SUMMARY ***
Total pot $90 | Rake $0 
Seat 1: teunuss (small blind) folded before Flop
Seat 2: borntotilt (big blind) folded before Flop
Seat 3: mikimiki88 folded before Flop (didn't bet)
Seat 4: Scarface.VLT folded before Flop (didn't bet)
Seat 5: Luthimir collected ($90)
Seat 6: mustanggino (button) folded before Flop (didn't bet)


PokerStars Game #102619271115:  Hold'em No Limit ($3/$6 USD) - 2013/08/11 15:08:46 ET
Table 'Crux V 40-100 bb' 6-max Seat #1 is the button
Seat 1: teunuss ($600 in chips) 
Seat 2: borntotilt ($600 in chips) 
Seat 3: mikimiki88 ($600 in chips) 
Seat 4: Scarface.VLT ($600 in chips) 
Seat 5: Luthimir ($288 in chips) 
Seat 6: mustanggino ($450 in chips) 
borntotilt: posts small blind $3
mikimiki88: posts big blind $6
*** HOLE CARDS ***
Scarface.VLT: folds 
Luthimir: raises $10.50 to $16.50
mustanggino: folds 
teunuss: folds 
borntotilt: folds 
mikimiki88: folds 
Uncalled bet ($10.50) returned to Luthimir
Luthimir collected $15 from pot
Luthimir: doesn't show hand 
*** SUMMARY ***
Total pot $15 | Rake $0 
Seat 1: teunuss (button) folded before Flop (didn't bet)
Seat 2: borntotilt (small blind) folded before Flop
Seat 3: mikimiki88 (big blind) folded before Flop
Seat 4: Scarface.VLT folded before Flop (didn't bet)
Seat 5: Luthimir collected ($15)
Seat 6: mustanggino folded before Flop (didn't bet)


PokerStars Game #102619312061:  Hold'em No Limit ($3/$6 USD) - 2013/08/11 15:09:29 ET
Table 'Crux V 40-100 bb' 6-max Seat #2 is the button
Seat 1: teunuss ($600 in chips) 
Seat 2: borntotilt ($600 in chips) 
Seat 3: mikimiki88 ($600 in chips) 
Seat 4: Scarface.VLT ($600 in chips) 
Seat 5: Luthimir ($297 in chips) 
Seat 6: mustanggino ($450 in chips) 
mikimiki88: posts small blind $3
Scarface.VLT: posts big blind $6
*** HOLE CARDS ***
Luthimir: folds 
mustanggino: raises $6 to $12
teunuss: folds 
borntotilt: folds 
mikimiki88: folds 
Scarface.VLT: folds 
Uncalled bet ($6) returned to mustanggino
mustanggino collected $15 from pot
mustanggino: doesn't show hand 
*** SUMMARY ***
Total pot $15 | Rake $0 
Seat 1: teunuss folded before Flop (didn't bet)
Seat 2: borntotilt (button) folded before Flop (didn't bet)
Seat 3: mikimiki88 (small blind) folded before Flop
Seat 4: Scarface.VLT (big blind) folded before Flop
Seat 5: Luthimir folded before Flop (didn't bet)
Seat 6: mustanggino collected ($15)


PokerStars Game #102620500000:  Hold'em No Limit ($3/$6 USD) - 2013/08/11 15:30:47 ET
Table 'Crux V 40-100 bb' 6-max Seat #3 is the button
Seat 1: teunuss ($762.09 in chips) 
Seat 2: 31ddd31 ($600 in chips) 
Seat 3: mikimiki88 ($709.72 in chips) 
Seat 4: evgenij_d_m ($466.78 in chips) 
Seat 5: Subv ($651 in chips) 
evgenij_d_m: posts small blind $3
Subv: posts big blind $6
*** HOLE CARDS ***
teunuss: folds 
31ddd31: folds 
mikimiki88: raises $6 to $12
evgenij_d_m: calls $9
Subv: folds 
*** FLOP *** [5d Kh Qd]
evgenij_d_m: checks 
mikimiki88: checks 
*** TURN *** [5d Kh Qd] [3h]
evgenij_d_m: checks 
mikimiki88: checks 
*** RIVER *** [5d Kh Qd 3h] [2h]
evgenij_d_m: checks 
mikimiki88: bets $20.34
evgenij_d_m: folds 
Uncalled bet ($20.34) returned to mikimiki88
mikimiki88 collected $28.65 from pot
mikimiki88: doesn't show hand 
*** SUMMARY ***
Total pot $30 | Rake $1.35 
Board [5d Kh Qd 3h 2h]
Seat 1: teunuss folded before Flop (didn't bet)
Seat 2: 31ddd31 folded before Flop (didn't bet)
Seat 3: mikimiki88 (button) collected ($28.65)
Seat 4: evgenij_d_m (small blind) folded on the River
Seat 5: Subv (big blind) folded before Flop


PokerStars Game #102620593001:  Hold'em No Limit ($3/$6 USD) - 2013/08/11 15:32:29 ET
Table 'Crux V 40-100 bb' 6-max Seat #4 is the button
Seat 1: teunuss ($762.09 in chips) 
Seat 2: 31ddd31 ($600 in chips) 
Seat 3: mikimiki88 ($726.37 in chips) 
Seat 4: evgenij_d_m ($454.78 in chips) 
Seat 5: Subv ($645 in chips) 
Subv: posts small blind $3
teunuss: posts big blind $6
*** HOLE CARDS ***
31ddd31: folds 
mikimiki88: folds 
evgenij_d_m: calls $6
Subv: folds 
teunuss: checks 
*** FLOP *** [3h 8h Qs]
teunuss: bets $15
evgenij_d_m: folds 
Uncalled bet ($15) returned to teunuss
teunuss collected $14.32 from pot
teunuss: doesn't show hand 
*** SUMMARY ***
Total pot $15 | Rake $0.68 
Board [3h 8h Qs]
Seat 1: teunuss (big blind) collected ($14.32)
Seat 2: 31ddd31 folded before Flop (didn't bet)
Seat 3: mikimiki88 folded before Flop (didn't bet)
Seat 4: evgenij_d_m (button) folded on the Flop
Seat 5: Subv (small blind) folded before Flop


PokerStars Game #102620629498:  Hold'em No Limit ($3/$6 USD) - 2013/08/11 15:33:09 ET
Table 'Crux V 40-100 bb' 6-max Seat #5 is the button
Seat 1: teunuss ($770.41 in chips) 
Seat 2: 31ddd31 ($600 in chips) 
Seat 3: mikimiki88 ($726.37 in chips) 
Seat 4: evgenij_d_m ($448.78 in chips) 
Seat 5: Subv ($642 in chips) 
teunuss: posts small blind $3
31ddd31: posts big blind $6
*** HOLE CARDS ***
mikimiki88: folds 
evgenij_d_m: folds 
Subv: raises $6.30 to $12.30
teunuss: folds 
31ddd31: folds 
Uncalled bet ($6.30) returned to Subv
Subv collected $15 from pot
Subv: doesn't show hand 
*** SUMMARY ***
Total pot $15 | Rake $0 
Seat 1: teunuss (small blind) folded before Flop
Seat 2: 31ddd31 (big blind) folded before Flop
Seat 3: mikimiki88 folded before Flop (didn't bet)
Seat 4: evgenij_d_m folded before Flop (didn't bet)
Seat 5: Subv (button) collected ($15)


PokerStars Game #102620661683:  Hold'em No Limit ($3/$6 USD) - 2013/08/11 15:33:44 ET
Table 'Crux V 40-100 bb' 6-max Seat #1 is the button
Seat 1: teunuss ($767.41 in chips) 
Seat 2: 31ddd31 ($600 in chips) 
Seat 3: mikimiki88 ($726.37 in chips) 
Seat 4: evgenij_d_m ($448.78 in chips) 
Seat 5: Subv ($651 in chips) 
31ddd31: posts small blind $3
mikimiki88: posts big blind $6
*** HOLE CARDS ***
evgenij_d_m: calls $6
Subv: raises $12.30 to $18.30
teunuss: folds 
31ddd31: folds 
mikimiki88: folds 
evgenij_d_m: calls $12.30
*** FLOP *** [Js Ts Td]
evgenij_d_m: checks 
Subv: bets $28.50
evgenij_d_m: folds 
Uncalled bet ($28.50) returned to Subv
Subv collected $43.55 from pot
Subv: doesn't show hand 
*** SUMMARY ***
Total pot $45.60 | Rake $2.05 
Board [Js Ts Td]
Seat 1: teunuss (button) folded before Flop (didn't bet)
Seat 2: 31ddd31 (small blind) folded before Flop
Seat 3: mikimiki88 (big blind) folded before Flop
Seat 4: evgenij_d_m folded on the Flop
Seat 5: Subv collected ($43.55)


PokerStars Game #102620716539:  Hold'em No Limit ($3/$6 USD) - 2013/08/11 15:34:44 ET
Table 'Crux V 40-100 bb' 6-max Seat #2 is the button
Seat 1: teunuss ($767.41 in chips) 
Seat 2: 31ddd31 ($600 in chips) 
Seat 3: mikimiki88 ($720.37 in chips) 
Seat 4: evgenij_d_m ($430.48 in chips) 
Seat 5: Subv ($676.25 in chips) 
mikimiki88: posts small blind $3
evgenij_d_m: posts big blind $6
*** HOLE CARDS ***
Subv: folds 
teunuss: folds 
31ddd31: raises $6 to $12
mikimiki88: folds 
evgenij_d_m: calls $6
*** FLOP *** [Kd Kc 5s]
evgenij_d_m: checks 
31ddd31: bets $14
evgenij_d_m: folds 
Uncalled bet ($14) returned to 31ddd31
31ddd31 collected $25.78 from pot
31ddd31: doesn't show hand 
*** SUMMARY ***
Total pot $27 | Rake $1.22 
Board [Kd Kc 5s]
Seat 1: teunuss folded before Flop (didn't bet)
Seat 2: 31ddd31 (button) collected ($25.78)
Seat 3: mikimiki88 (small blind) folded before Flop
Seat 4: evgenij_d_m (big blind) folded on the Flop
Seat 5: Subv folded before Flop (didn't bet)


PokerStars Game #102620203336:  Hold'em No Limit ($3/$6 USD) - 2013/08/11 15:25:23 ET
Table 'Crux V 40-100 bb' 6-max Seat #4 is the button
Seat 1: teunuss ($877.61 in chips) 
Seat 3: mikimiki88 ($600 in chips) 
Seat 4: evgenij_d_m ($490.78 in chips) 
Seat 5: Subv ($600 in chips) 
Seat 6: Strz ($600 in chips) 
Subv: posts small blind $3
Strz: posts big blind $6
31ddd31: sits out 
*** HOLE CARDS ***
teunuss: folds 
mikimiki88: raises $6 to $12
evgenij_d_m: folds 
Subv: folds 
Strz: folds 
Uncalled bet ($6) returned to mikimiki88
mikimiki88 collected $15 from pot
mikimiki88: doesn't show hand 
*** SUMMARY ***
Total pot $15 | Rake $0 
Seat 1: teunuss folded before Flop (didn't bet)
Seat 3: mikimiki88 collected ($15)
Seat 4: evgenij_d_m (button) folded before Flop (didn't bet)
Seat 5: Subv (small blind) folded before Flop
Seat 6: Strz (big blind) folded before Flop


PokerStars Game #102620243193:  Hold'em No Limit ($3/$6 USD) - 2013/08/11 15:26:07 ET
Table 'Crux V 40-100 bb' 6-max Seat #5 is the button
Seat 1: teunuss ($877.61 in chips) 
Seat 3: mikimiki88 ($609 in chips) 
Seat 4: evgenij_d_m ($490.78 in chips) 
Seat 5: Subv ($600 in chips) 
Seat 6: Strz ($600 in chips) 
Strz: posts small blind $3
teunuss: posts big blind $6
31ddd31: sits out 
*** HOLE CARDS ***
mikimiki88: raises $12 to $18
evgenij_d_m: folds 
Subv: folds 
Strz: raises $36 to $54
teunuss: folds 
mikimiki88: folds 
Uncalled bet ($36) returned to Strz
Strz collected $42 from pot
*** SUMMARY ***
Total pot $42 | Rake $0 
Seat 1: teunuss (big blind) folded before Flop
Seat 3: mikimiki88 folded before Flop
Seat 4: evgenij_d_m folded before Flop (didn't bet)
Seat 5: Subv (button) folded before Flop (didn't bet)
Seat 6: Strz (small blind) collected ($42)


PokerStars Game #102620265169:  Hold'em No Limit ($3/$6 USD) - 2013/08/11 15:26:31 ET
Table 'Crux V 40-100 bb' 6-max Seat #6 is the button
Seat 1: teunuss ($871.61 in chips) 
Seat 2: 31ddd31 ($609 in chips) 
Seat 3: mikimiki88 ($600 in chips) 
Seat 4: evgenij_d_m ($490.78 in chips) 
Seat 5: Subv ($600 in chips) 
Seat 6: Strz ($624 in chips) 
teunuss: posts small blind $3
31ddd31: posts big blind $6
*** HOLE CARDS ***
mikimiki88: folds 
evgenij_d_m: folds 
Subv: raises $6.30 to $12.30
Strz: folds 
teunuss: folds 
31ddd31: raises $35.70 to $48
Subv: raises $66 to $114
31ddd31: folds 
Uncalled bet ($66) returned to Subv
Subv collected $99 from pot
Subv: doesn't show hand 
*** SUMMARY ***
Total pot $99 | Rake $0 
Seat 1: teunuss (small blind) folded before Flop
Seat 2: 31ddd31 (big blind) folded before Flop
Seat 3: mikimiki88 folded before Flop (didn't bet)
Seat 4: evgenij_d_m folded before Flop (didn't bet)
Seat 5: Subv collected ($99)
Seat 6: Strz (button) folded before Flop (didn't bet)


PokerStars Game #102620328303:  Hold'em No Limit ($3/$6 USD) - 2013/08/11 15:27:40 ET
Table 'Crux V 40-100 bb' 6-max Seat #1 is the button
Seat 1: teunuss ($868.61 in chips) 
Seat 2: 31ddd31 ($600 in chips) 
Seat 3: mikimiki88 ($600 in chips) 
Seat 4: evgenij_d_m ($490.78 in chips) 
Seat 5: Subv ($651 in chips) 
Seat 6: Strz ($624 in chips) 
31ddd31: posts small blind $3
mikimiki88: posts big blind $6
*** HOLE CARDS ***
evgenij_d_m is disconnected 
evgenij_d_m is connected 
evgenij_d_m: calls $6
Subv: folds 
Strz: raises $12 to $18
teunuss: folds 
31ddd31: folds 
mikimiki88: folds 
evgenij_d_m: calls $12
*** FLOP *** [4d 3s Kc]
evgenij_d_m: checks 
Strz: bets $6
evgenij_d_m: folds 
Uncalled bet ($6) returned to Strz
Strz collected $42.98 from pot
*** SUMMARY ***
Total pot $45 | Rake $2.02 
Board [4d 3s Kc]
Seat 1: teunuss (button) folded before Flop (didn't bet)
Seat 2: 31ddd31 (small blind) folded before Flop
Seat 3: mikimiki88 (big blind) folded before Flop
Seat 4: evgenij_d_m folded on the Flop
Seat 5: Subv folded before Flop (didn't bet)
Seat 6: Strz collected ($42.98)


PokerStars Game #102620424262:  Hold'em No Limit ($3/$6 USD) - 2013/08/11 15:29:25 ET
Table 'Crux V 40-100 bb' 6-max Seat #2 is the button
Seat 1: teunuss ($868.61 in chips) 
Seat 2: 31ddd31 ($600 in chips) 
Seat 3: mikimiki88 ($600 in chips) 
Seat 4: evgenij_d_m ($472.78 in chips) 
Seat 5: Subv ($651 in chips) 
Seat 6: Strz ($648.98 in chips) 
mikimiki88: posts small blind $3
evgenij_d_m: posts big blind $6
*** HOLE CARDS ***
Subv: folds 
Strz: folds 
teunuss: raises $9 to $15
31ddd31: folds 
mikimiki88: raises $33 to $48
evgenij_d_m: folds 
teunuss: calls $33
*** FLOP *** [4s Ks Ac]
mikimiki88: bets $58.52
teunuss: calls $58.52
*** TURN *** [4s Ks Ac] [3s]
mikimiki88: bets $114
teunuss: folds 
Uncalled bet ($114) returned to mikimiki88
mikimiki88 collected $216.24 from pot
mikimiki88: doesn't show hand 
*** SUMMARY ***
Total pot $219.04 | Rake $2.80 
Board [4s Ks Ac 3s]
Seat 1: teunuss folded on the Turn
Seat 2: 31ddd31 (button) folded before Flop (didn't bet)
Seat 3: mikimiki88 (small blind) collected ($216.24)
Seat 4: evgenij_d_m (big blind) folded before Flop
Seat 5: Subv folded before Flop (didn't bet)
Seat 6: Strz folded before Flop (didn't bet)


PokerStars Game #102619920739:  Hold'em No Limit ($3/$6 USD) - 2013/08/11 15:20:18 ET
Table 'Crux V 40-100 bb' 6-max Seat #1 is the button
Seat 1: teunuss ($855.40 in chips) 
Seat 2: 31ddd31 ($600 in chips) 
Seat 3: mikimiki88 ($653.18 in chips) 
Seat 4: floriiiiider ($600 in chips) 
Seat 6: Naebushkin ($600 in chips) 
31ddd31: posts small blind $3
mikimiki88: posts big blind $6
TTSIP: sits out 
*** HOLE CARDS ***
floriiiiider: folds 
Naebushkin: folds 
teunuss: folds 
31ddd31: folds 
Uncalled bet ($3) returned to mikimiki88
mikimiki88 collected $6 from pot
mikimiki88: doesn't show hand 
*** SUMMARY ***
Total pot $6 | Rake $0 
Seat 1: teunuss (button) folded before Flop (didn't bet)
Seat 2: 31ddd31 (small blind) folded before Flop
Seat 3: mikimiki88 (big blind) collected ($6)
Seat 4: floriiiiider folded before Flop (didn't bet)
Seat 6: Naebushkin folded before Flop (didn't bet)


PokerStars Game #102619929225:  Hold'em No Limit ($3/$6 USD) - 2013/08/11 15:20:27 ET
Table 'Crux V 40-100 bb' 6-max Seat #2 is the button
Seat 1: teunuss ($855.40 in chips) 
Seat 2: 31ddd31 ($600 in chips) 
Seat 3: mikimiki88 ($656.18 in chips) 
Seat 5: TTSIP ($600 in chips) 
Seat 6: Naebushkin ($600 in chips) 
mikimiki88: posts small blind $3
floriiiiider: is sitting out 
TTSIP: posts big blind $6
*** HOLE CARDS ***
Naebushkin: folds 
floriiiiider leaves the table
teunuss: folds 
31ddd31: folds 
mikimiki88: folds 
Uncalled bet ($3) returned to TTSIP
TTSIP collected $6 from pot
*** SUMMARY ***
Total pot $6 | Rake $0 
Seat 1: teunuss folded before Flop (didn't bet)
Seat 2: 31ddd31 (button) folded before Flop (didn't bet)
Seat 3: mikimiki88 (small blind) folded before Flop
Seat 5: TTSIP (big blind) collected ($6)
Seat 6: Naebushkin folded before Flop (didn't bet)


PokerStars Game #102619948256:  Hold'em No Limit ($3/$6 USD) - 2013/08/11 15:20:47 ET
Table 'Crux V 40-100 bb' 6-max Seat #3 is the button
Seat 1: teunuss ($855.40 in chips) 
Seat 2: 31ddd31 ($600 in chips) 
Seat 3: mikimiki88 ($653.18 in chips) 
Seat 5: TTSIP ($603 in chips) 
TTSIP: posts small blind $3
Naebushkin: is sitting out 
teunuss: posts big blind $6
*** HOLE CARDS ***
Naebushkin leaves the table
31ddd31: raises $12 to $18
mikimiki88: folds 
TTSIP: folds 
maloyd joins the table at seat #4 
teunuss: folds 
Uncalled bet ($12) returned to 31ddd31
31ddd31 collected $15 from pot
31ddd31: doesn't show hand 
*** SUMMARY ***
Total pot $15 | Rake $0 
Seat 1: teunuss (big blind) folded before Flop
Seat 2: 31ddd31 collected ($15)
Seat 3: mikimiki88 (button) folded before Flop (didn't bet)
Seat 5: TTSIP (small blind) folded before Flop


PokerStars Game #102619973215:  Hold'em No Limit ($3/$6 USD) - 2013/08/11 15:21:14 ET
Table 'Crux V 40-100 bb' 6-max Seat #5 is the button
Seat 1: teunuss ($849.40 in chips) 
Seat 3: mikimiki88 ($653.18 in chips) 
Seat 5: TTSIP ($600 in chips) 
teunuss: posts small blind $3
31ddd31: is sitting out 
mikimiki88: posts big blind $6
maloyd: sits out 
*** HOLE CARDS ***
TTSIP: raises $6 to $12
teunuss: folds 
mikimiki88: folds 
Uncalled bet ($6) returned to TTSIP
TTSIP collected $15 from pot
*** SUMMARY ***
Total pot $15 | Rake $0 
Seat 1: teunuss (small blind) folded before Flop
Seat 3: mikimiki88 (big blind) folded before Flop
Seat 5: TTSIP (button) collected ($15)


PokerStars Game #102620000294:  Hold'em No Limit ($3/$6 USD) - 2013/08/11 15:21:43 ET
Table 'Crux V 40-100 bb' 6-max Seat #1 is the button
Seat 1: teunuss ($846.40 in chips) 
Seat 3: mikimiki88 ($647.18 in chips) 
Seat 4: maloyd ($600 in chips) 
Seat 5: TTSIP ($609 in chips) 
mikimiki88: posts small blind $3
maloyd: posts big blind $6
*** HOLE CARDS ***
TTSIP: folds 
TTSIP leaves the table
teunuss: raises $6 to $12
mikimiki88: folds 
maloyd: calls $6
*** FLOP *** [7h Tc 4s]
maloyd: checks 
teunuss: bets $18
checkitout12 joins the table at seat #5 
maloyd: raises $43 to $61
teunuss: folds 
Uncalled bet ($43) returned to maloyd
checkitout12 leaves the table
maloyd collected $61.50 from pot
*** SUMMARY ***
Total pot $63 | Rake $1.50 
Board [7h Tc 4s]
Seat 1: teunuss (button) folded on the Flop
Seat 3: mikimiki88 (small blind) folded before Flop
Seat 4: maloyd (big blind) collected ($61.50)
Seat 5: TTSIP folded before Flop (didn't bet)


PokerStars Game #102620031422:  Hold'em No Limit ($3/$6 USD) - 2013/08/11 15:22:17 ET
Table 'Crux V 40-100 bb' 6-max Seat #3 is the button
Seat 1: teunuss ($816.40 in chips) 
Seat 3: mikimiki88 ($644.18 in chips) 
Seat 4: maloyd ($631.50 in chips) 
maloyd: posts small blind $3
teunuss: posts big blind $6
*** HOLE CARDS ***
mikimiki88: raises $6 to $12
maloyd: folds 
teunuss: calls $6
*** FLOP *** [2c Tc 4s]
teunuss: checks 
mikimiki88: bets $15.21
teunuss: calls $15.21
*** TURN *** [2c Tc 4s] [5s]
teunuss: checks 
mikimiki88: checks 
*** RIVER *** [2c Tc 4s 5s] [Jc]
teunuss: bets $42
mikimiki88: folds 
Uncalled bet ($42) returned to teunuss
teunuss collected $55.92 from pot
teunuss: doesn't show hand 
*** SUMMARY ***
Total pot $57.42 | Rake $1.50 
Board [2c Tc 4s 5s Jc]
Seat 1: teunuss (big blind) collected ($55.92)
Seat 3: mikimiki88 (button) folded on the River
Seat 4: maloyd (small blind) folded before Flop


PokerStars Game #102620068439:  Hold'em No Limit ($3/$6 USD) - 2013/08/11 15:22:56 ET
Table 'Crux V 40-100 bb' 6-max Seat #4 is the button
Seat 1: teunuss ($845.11 in chips) 
Seat 3: mikimiki88 ($616.97 in chips) 
Seat 4: maloyd ($628.50 in chips) 
teunuss: posts small blind $3
mikimiki88: posts big blind $6
*** HOLE CARDS ***
maloyd: raises $6 to $12
teunuss: folds 
mikimiki88: folds 
Uncalled bet ($6) returned to maloyd
maloyd collected $15 from pot
*** SUMMARY ***
Total pot $15 | Rake $0 
Seat 1: teunuss (small blind) folded before Flop
Seat 3: mikimiki88 (big blind) folded before Flop
Seat 4: maloyd (button) collected ($15)


PokerStars Game #102620145325:  Hold'em No Limit ($3/$6 USD) - 2013/08/11 15:24:20 ET
Table 'Crux V 40-100 bb' 6-max Seat #1 is the button
Seat 1: teunuss ($880.61 in chips) 
Seat 3: mikimiki88 ($600 in chips) 
Seat 4: evgenij_d_m ($480 in chips) 
mikimiki88: posts small blind $3
evgenij_d_m: posts big blind $6
Subv: sits out 
Strz: sits out 
*** HOLE CARDS ***
teunuss: raises $6 to $12
mikimiki88: folds 
evgenij_d_m: calls $6
*** FLOP *** [9d 4s 5c]
evgenij_d_m: bets $24
teunuss: folds 
Uncalled bet ($24) returned to evgenij_d_m
evgenij_d_m collected $25.78 from pot
evgenij_d_m: doesn't show hand 
*** SUMMARY ***
Total pot $27 | Rake $1.22 
Board [9d 4s 5c]
Seat 1: teunuss (button) folded on the Flop
Seat 3: mikimiki88 (small blind) folded before Flop
Seat 4: evgenij_d_m (big blind) collected ($25.78)


PokerStars Game #102620175674:  Hold'em No Limit ($3/$6 USD) - 2013/08/11 15:24:53 ET
Table 'Crux V 40-100 bb' 6-max Seat #3 is the button
Seat 1: teunuss ($868.61 in chips) 
Seat 3: mikimiki88 ($600 in chips) 
Seat 4: evgenij_d_m ($493.78 in chips) 
Seat 5: Subv ($600 in chips) 
evgenij_d_m: posts small blind $3
Subv: posts big blind $6
Strz: sits out 
*** HOLE CARDS ***
teunuss: raises $9 to $15
mikimiki88: folds 
evgenij_d_m: folds 
Subv: folds 
Uncalled bet ($9) returned to teunuss
teunuss collected $15 from pot
teunuss: doesn't show hand 
*** SUMMARY ***
Total pot $15 | Rake $0 
Seat 1: teunuss collected ($15)
Seat 3: mikimiki88 (button) folded before Flop (didn't bet)
Seat 4: evgenij_d_m (small blind) folded before Flop
Seat 5: Subv (big blind) folded before Flop


PokerStars Game #102620078713:  Hold'em No Limit ($3/$6 USD) - 2013/08/11 15:23:08 ET
Table 'Crux V 40-100 bb' 6-max Seat #3 is the button
Seat 1: teunuss ($842.11 in chips) 
Seat 3: mikimiki88 ($610.97 in chips) 
mikimiki88: posts small blind $3
maloyd: is sitting out 
teunuss: posts big blind $6
*** HOLE CARDS ***
mikimiki88: raises $6 to $12
teunuss: raises $33 to $45
mikimiki88: folds 
Uncalled bet ($33) returned to teunuss
maloyd leaves the table
teunuss collected $24 from pot
teunuss: doesn't show hand 
*** SUMMARY ***
Total pot $24 | Rake $0 
Seat 1: teunuss (big blind) collected ($24)
Seat 3: mikimiki88 (button) (small blind) folded before Flop


PokerStars Game #102620088478:  Hold'em No Limit ($3/$6 USD) - 2013/08/11 15:23:18 ET
Table 'Crux V 40-100 bb' 6-max Seat #1 is the button
Seat 1: teunuss ($854.11 in chips) 
Seat 3: mikimiki88 ($600 in chips) 
teunuss: posts small blind $3
mikimiki88: posts big blind $6
*** HOLE CARDS ***
teunuss: raises $6 to $12
mikimiki88: calls $6
*** FLOP *** [3d Th 6s]
mikimiki88: checks 
teunuss: bets $15
mikimiki88: calls $15
*** TURN *** [3d Th 6s] [2d]
Subv joins the table at seat #5 
evgenij_d_m joins the table at seat #4 
mikimiki88: checks 
Strz joins the table at seat #6 
teunuss: bets $39
mikimiki88: folds 
Uncalled bet ($39) returned to teunuss
teunuss collected $53.50 from pot
teunuss: doesn't show hand 
*** SUMMARY ***
Total pot $54 | Rake $0.50 
Board [3d Th 6s 2d]
Seat 1: teunuss (button) (small blind) collected ($53.50)
Seat 3: mikimiki88 (big blind) folded on the Turn


PokerStars Game #102619637791:  Hold'em No Limit ($3/$6 USD) - 2013/08/11 15:15:16 ET
Table 'Crux V 40-100 bb' 6-max Seat #1 is the button
Seat 1: teunuss ($822.40 in chips) 
Seat 3: mikimiki88 ($625.62 in chips) 
Seat 4: Scarface.VLT ($600 in chips) 
Seat 5: Luthimir ($263 in chips) 
Seat 6: mustanggino ($450 in chips) 
mikimiki88: posts small blind $3
Scarface.VLT: posts big blind $6
*** HOLE CARDS ***
Luthimir: folds 
mustanggino: raises $6 to $12
teunuss: raises $24 to $36
mikimiki88: folds 
Scarface.VLT: folds 
mustanggino: folds 
Uncalled bet ($24) returned to teunuss
teunuss collected $33 from pot
teunuss: doesn't show hand 
*** SUMMARY ***
Total pot $33 | Rake $0 
Seat 1: teunuss (button) collected ($33)
Seat 3: mikimiki88 (small blind) folded before Flop
Seat 4: Scarface.VLT (big blind) folded before Flop
Seat 5: Luthimir folded before Flop (didn't bet)
Seat 6: mustanggino folded before Flop


PokerStars Game #102619681645:  Hold'em No Limit ($3/$6 USD) - 2013/08/11 15:16:03 ET
Table 'Crux V 40-100 bb' 6-max Seat #3 is the button
Seat 1: teunuss ($843.40 in chips) 
Seat 3: mikimiki88 ($622.62 in chips) 
Seat 4: Scarface.VLT ($600 in chips) 
Scarface.VLT: posts small blind $3
Luthimir: is sitting out 
mustanggino: is sitting out 
Luthimir leaves the table
teunuss: posts big blind $6
*** HOLE CARDS ***
mikimiki88: raises $6 to $12
Scarface.VLT: folds 
teunuss: calls $6
*** FLOP *** [3d 2h 9s]
teunuss: checks 
mikimiki88: bets $15.21
teunuss: folds 
Uncalled bet ($15.21) returned to mikimiki88
mustanggino leaves the table
mikimiki88 collected $25.78 from pot
mikimiki88: doesn't show hand 
*** SUMMARY ***
Total pot $27 | Rake $1.22 
Board [3d 2h 9s]
Seat 1: teunuss (big blind) folded on the Flop
Seat 3: mikimiki88 (button) collected ($25.78)
Seat 4: Scarface.VLT (small blind) folded before Flop


PokerStars Game #102619701861:  Hold'em No Limit ($3/$6 USD) - 2013/08/11 15:16:24 ET
Table 'Crux V 40-100 bb' 6-max Seat #4 is the button
Seat 1: teunuss ($831.40 in chips) 
Seat 3: mikimiki88 ($636.40 in chips) 
Seat 4: Scarface.VLT ($600 in chips) 
teunuss: posts small blind $3
mikimiki88: posts big blind $6
*** HOLE CARDS ***
Scarface.VLT: raises $6 to $12
Hristo008 joins the table at seat #5 
Naebushkin joins the table at seat #6 
teunuss: raises $33 to $45
mikimiki88: folds 
Scarface.VLT: folds 
Uncalled bet ($33) returned to teunuss
teunuss collected $30 from pot
teunuss: doesn't show hand 
*** SUMMARY ***
Total pot $30 | Rake $0 
Seat 1: teunuss (small blind) collected ($30)
Seat 3: mikimiki88 (big blind) folded before Flop
Seat 4: Scarface.VLT (button) folded before Flop


PokerStars Game #102619732989:  Hold'em No Limit ($3/$6 USD) - 2013/08/11 15:16:58 ET
Table 'Crux V 40-100 bb' 6-max Seat #1 is the button
Seat 1: teunuss ($849.40 in chips) 
Seat 3: mikimiki88 ($630.40 in chips) 
Seat 6: Naebushkin ($600 in chips) 
mikimiki88: posts small blind $3
Scarface.VLT: is sitting out 
Naebushkin: posts big blind $6
*** HOLE CARDS ***
Scarface.VLT leaves the table
teunuss: raises $6 to $12
mikimiki88: folds 
Naebushkin: folds 
Uncalled bet ($6) returned to teunuss
teunuss collected $15 from pot
teunuss: doesn't show hand 
*** SUMMARY ***
Total pot $15 | Rake $0 
Seat 1: teunuss (button) collected ($15)
Seat 3: mikimiki88 (small blind) folded before Flop
Seat 6: Naebushkin (big blind) folded before Flop


PokerStars Game #102619753888:  Hold'em No Limit ($3/$6 USD) - 2013/08/11 15:17:20 ET
Table 'Crux V 40-100 bb' 6-max Seat #3 is the button
Seat 1: teunuss ($858.40 in chips) 
Seat 3: mikimiki88 ($627.40 in chips) 
Seat 6: Naebushkin ($600 in chips) 
Naebushkin: posts small blind $3
teunuss: posts big blind $6
*** HOLE CARDS ***
mikimiki88: folds 
Naebushkin: raises $9 to $15
teunuss: calls $9
*** FLOP *** [3d 6d Qh]
31ddd31 joins the table at seat #2 
Naebushkin: bets $21
teunuss: folds 
Uncalled bet ($21) returned to Naebushkin
Naebushkin collected $28.65 from pot
Naebushkin: doesn't show hand 
*** SUMMARY ***
Total pot $30 | Rake $1.35 
Board [3d 6d Qh]
Seat 1: teunuss (big blind) folded on the Flop
Seat 3: mikimiki88 (button) folded before Flop (didn't bet)
Seat 6: Naebushkin (small blind) collected ($28.65)


PokerStars Game #102619773474:  Hold'em No Limit ($3/$6 USD) - 2013/08/11 15:17:41 ET
Table 'Crux V 40-100 bb' 6-max Seat #6 is the button
Seat 1: teunuss ($843.40 in chips) 
Seat 2: 31ddd31 ($600 in chips) 
Seat 3: mikimiki88 ($627.40 in chips) 
Seat 6: Naebushkin ($613.65 in chips) 
teunuss: posts small blind $3
31ddd31: posts big blind $6
*** HOLE CARDS ***
mikimiki88: folds 
Naebushkin: raises $9 to $15
teunuss: folds 
31ddd31: folds 
Uncalled bet ($9) returned to Naebushkin
Naebushkin collected $15 from pot
Naebushkin: doesn't show hand 
*** SUMMARY ***
Total pot $15 | Rake $0 
Seat 1: teunuss (small blind) folded before Flop
Seat 2: 31ddd31 (big blind) folded before Flop
Seat 3: mikimiki88 folded before Flop (didn't bet)
Seat 6: Naebushkin (button) collected ($15)


PokerStars Game #102619789330:  Hold'em No Limit ($3/$6 USD) - 2013/08/11 15:17:57 ET
Table 'Crux V 40-100 bb' 6-max Seat #1 is the button
Seat 1: teunuss ($840.40 in chips) 
Seat 2: 31ddd31 ($600 in chips) 
Seat 3: mikimiki88 ($627.40 in chips) 
Seat 6: Naebushkin ($622.65 in chips) 
31ddd31: posts small blind $3
mikimiki88: posts big blind $6
*** HOLE CARDS ***
Naebushkin: folds 
teunuss: raises $6 to $12
31ddd31: folds 
mikimiki88: raises $33 to $45
teunuss: folds 
Uncalled bet ($33) returned to mikimiki88
floriiiiider joins the table at seat #4 
mikimiki88 collected $27 from pot
mikimiki88: doesn't show hand 
*** SUMMARY ***
Total pot $27 | Rake $0 
Seat 1: teunuss (button) folded before Flop
Seat 2: 31ddd31 (small blind) folded before Flop
Seat 3: mikimiki88 (big blind) collected ($27)
Seat 6: Naebushkin folded before Flop (didn't bet)


PokerStars Game #102619825978:  Hold'em No Limit ($3/$6 USD) - 2013/08/11 15:18:36 ET
Table 'Crux V 40-100 bb' 6-max Seat #2 is the button
Seat 1: teunuss ($828.40 in chips) 
Seat 2: 31ddd31 ($600 in chips) 
Seat 3: mikimiki88 ($642.40 in chips) 
Seat 4: floriiiiider ($600 in chips) 
Seat 6: Naebushkin ($622.65 in chips) 
mikimiki88: posts small blind $3
floriiiiider: posts big blind $6
*** HOLE CARDS ***
Naebushkin: folds 
teunuss: raises $9 to $15
31ddd31: folds 
mikimiki88: folds 
floriiiiider: folds 
Uncalled bet ($9) returned to teunuss
teunuss collected $15 from pot
teunuss: doesn't show hand 
*** SUMMARY ***
Total pot $15 | Rake $0 
Seat 1: teunuss collected ($15)
Seat 2: 31ddd31 (button) folded before Flop (didn't bet)
Seat 3: mikimiki88 (small blind) folded before Flop
Seat 4: floriiiiider (big blind) folded before Flop
Seat 6: Naebushkin folded before Flop (didn't bet)


PokerStars Game #102619854509:  Hold'em No Limit ($3/$6 USD) - 2013/08/11 15:19:07 ET
Table 'Crux V 40-100 bb' 6-max Seat #3 is the button
Seat 1: teunuss ($837.40 in chips) 
Seat 2: 31ddd31 ($600 in chips) 
Seat 3: mikimiki88 ($639.40 in chips) 
Seat 4: floriiiiider ($600 in chips) 
Seat 6: Naebushkin ($622.65 in chips) 
floriiiiider: posts small blind $3
Naebushkin: posts big blind $6
*** HOLE CARDS ***
teunuss: raises $9 to $15
31ddd31: folds 
mikimiki88: folds 
floriiiiider: folds 
Naebushkin: folds 
Uncalled bet ($9) returned to teunuss
teunuss collected $15 from pot
teunuss: doesn't show hand 
*** SUMMARY ***
Total pot $15 | Rake $0 
Seat 1: teunuss collected ($15)
Seat 2: 31ddd31 folded before Flop (didn't bet)
Seat 3: mikimiki88 (button) folded before Flop (didn't bet)
Seat 4: floriiiiider (small blind) folded before Flop
Seat 6: Naebushkin (big blind) folded before Flop


PokerStars Game #102619864361:  Hold'em No Limit ($3/$6 USD) - 2013/08/11 15:19:17 ET
Table 'Crux V 40-100 bb' 6-max Seat #4 is the button
Seat 1: teunuss ($846.40 in chips) 
Seat 2: 31ddd31 ($600 in chips) 
Seat 3: mikimiki88 ($639.40 in chips) 
Seat 4: floriiiiider ($600 in chips) 
Seat 6: Naebushkin ($616.65 in chips) 
Naebushkin: posts small blind $3
teunuss: posts big blind $6
*** HOLE CARDS ***
31ddd31: folds 
mikimiki88: raises $6 to $12
floriiiiider: folds 
Naebushkin: folds 
Hristo008 leaves the table
LuckyBiitch joins the table at seat #5 
teunuss: calls $6
*** FLOP *** [Ad 6h Ks]
teunuss: checks 
mikimiki88: bets $18.30
teunuss: folds 
Uncalled bet ($18.30) returned to mikimiki88
mikimiki88 collected $25.78 from pot
mikimiki88: doesn't show hand 
LuckyBiitch leaves the table
*** SUMMARY ***
Total pot $27 | Rake $1.22 
Board [Ad 6h Ks]
Seat 1: teunuss (big blind) folded on the Flop
Seat 2: 31ddd31 folded before Flop (didn't bet)
Seat 3: mikimiki88 collected ($25.78)
Seat 4: floriiiiider (button) folded before Flop (didn't bet)
Seat 6: Naebushkin (small blind) folded before Flop


PokerStars Game #102619901396:  Hold'em No Limit ($3/$6 USD) - 2013/08/11 15:19:57 ET
Table 'Crux V 40-100 bb' 6-max Seat #6 is the button
Seat 1: teunuss ($834.40 in chips) 
Seat 2: 31ddd31 ($600 in chips) 
Seat 3: mikimiki88 ($653.18 in chips) 
Seat 4: floriiiiider ($600 in chips) 
Seat 6: Naebushkin ($613.65 in chips) 
teunuss: posts small blind $3
TTSIP joins the table at seat #5 
31ddd31: posts big blind $6
*** HOLE CARDS ***
mikimiki88: folds 
floriiiiider: folds 
Naebushkin: raises $9 to $15
teunuss: raises $39 to $54
31ddd31: folds 
Naebushkin: folds 
Uncalled bet ($39) returned to teunuss
teunuss collected $36 from pot
teunuss: doesn't show hand 
*** SUMMARY ***
Total pot $36 | Rake $0 
Seat 1: teunuss (small blind) collected ($36)
Seat 2: 31ddd31 (big blind) folded before Flop
Seat 3: mikimiki88 folded before Flop (didn't bet)
Seat 4: floriiiiider folded before Flop (didn't bet)
Seat 6: Naebushkin (button) folded before Flop


PokerStars Game #102621574456:  Hold'em No Limit ($3/$6 USD) - 2013/08/11 15:50:40 ET
Table 'Crux V 40-100 bb' 6-max Seat #6 is the button
Seat 1: teunuss ($603 in chips) 
Seat 2: 31ddd31 ($633.56 in chips) 
Seat 3: mikimiki88 ($828.07 in chips) 
Seat 4: evgenij_d_m ($483.55 in chips) 
Seat 5: Subv ($1918.41 in chips) 
Seat 6: Strz ($624.98 in chips) 
teunuss: posts small blind $3
31ddd31: posts big blind $6
*** HOLE CARDS ***
mikimiki88: folds 
evgenij_d_m: folds 
Subv: raises $6.30 to $12.30
Strz: calls $12.30
teunuss: folds 
31ddd31: folds 
*** FLOP *** [6h 6d Qh]
Subv: checks 
Strz: bets $18
Subv: folds 
Uncalled bet ($18) returned to Strz
Strz collected $32.09 from pot
*** SUMMARY ***
Total pot $33.60 | Rake $1.51 
Board [6h 6d Qh]
Seat 1: teunuss (small blind) folded before Flop
Seat 2: 31ddd31 (big blind) folded before Flop
Seat 3: mikimiki88 folded before Flop (didn't bet)
Seat 4: evgenij_d_m folded before Flop (didn't bet)
Seat 5: Subv folded on the Flop
Seat 6: Strz (button) collected ($32.09)


PokerStars Game #102621610875:  Hold'em No Limit ($3/$6 USD) - 2013/08/11 15:51:21 ET
Table 'Crux V 40-100 bb' 6-max Seat #1 is the button
Seat 1: teunuss ($600 in chips) 
Seat 2: 31ddd31 ($627.56 in chips) 
Seat 3: mikimiki88 ($828.07 in chips) 
Seat 4: evgenij_d_m ($483.55 in chips) 
Seat 5: Subv ($1906.11 in chips) 
Seat 6: Strz ($644.77 in chips) 
31ddd31: posts small blind $3
mikimiki88: posts big blind $6
*** HOLE CARDS ***
evgenij_d_m: calls $6
Subv: folds 
Strz: folds 
teunuss: raises $12 to $18
31ddd31: folds 
mikimiki88: folds 
evgenij_d_m: calls $12
*** FLOP *** [7h 6s Jc]
evgenij_d_m: bets $12
teunuss: folds 
Uncalled bet ($12) returned to evgenij_d_m
evgenij_d_m collected $42.98 from pot
evgenij_d_m: doesn't show hand 
*** SUMMARY ***
Total pot $45 | Rake $2.02 
Board [7h 6s Jc]
Seat 1: teunuss (button) folded on the Flop
Seat 2: 31ddd31 (small blind) folded before Flop
Seat 3: mikimiki88 (big blind) folded before Flop
Seat 4: evgenij_d_m collected ($42.98)
Seat 5: Subv folded before Flop (didn't bet)
Seat 6: Strz folded before Flop (didn't bet)


PokerStars Game #102621640285:  Hold'em No Limit ($3/$6 USD) - 2013/08/11 15:51:55 ET
Table 'Crux V 40-100 bb' 6-max Seat #2 is the button
Seat 1: teunuss ($600 in chips) 
Seat 2: 31ddd31 ($624.56 in chips) 
Seat 3: mikimiki88 ($822.07 in chips) 
Seat 4: evgenij_d_m ($508.53 in chips) 
Seat 5: Subv ($1906.11 in chips) 
Seat 6: Strz ($644.77 in chips) 
mikimiki88: posts small blind $3
evgenij_d_m: posts big blind $6
*** HOLE CARDS ***
Subv: raises $6.30 to $12.30
Strz: folds 
teunuss: folds 
31ddd31: folds 
mikimiki88: folds 
evgenij_d_m: calls $6.30
*** FLOP *** [4h 2d 4s]
evgenij_d_m: checks 
Subv: bets $18
evgenij_d_m: folds 
Uncalled bet ($18) returned to Subv
Subv collected $26.36 from pot
Subv: doesn't show hand 
*** SUMMARY ***
Total pot $27.60 | Rake $1.24 
Board [4h 2d 4s]
Seat 1: teunuss folded before Flop (didn't bet)
Seat 2: 31ddd31 (button) folded before Flop (didn't bet)
Seat 3: mikimiki88 (small blind) folded before Flop
Seat 4: evgenij_d_m (big blind) folded on the Flop
Seat 5: Subv collected ($26.36)
Seat 6: Strz folded before Flop (didn't bet)


PokerStars Game #102621691699:  Hold'em No Limit ($3/$6 USD) - 2013/08/11 15:52:54 ET
Table 'Crux V 40-100 bb' 6-max Seat #3 is the button
Seat 1: teunuss ($600 in chips) 
Seat 2: 31ddd31 ($624.56 in chips) 
Seat 3: mikimiki88 ($819.07 in chips) 
Seat 5: Subv ($1920.17 in chips) 
evgenij_d_m has timed out while being disconnected
evgenij_d_m: is sitting out 
Subv: posts small blind $3
teunuss: posts big blind $6
*** HOLE CARDS ***
evgenij_d_m is disconnected 
31ddd31: folds 
mikimiki88: folds 
Subv: calls $3
teunuss: raises $18 to $24
Subv: calls $18
*** FLOP *** [Kh 9s Qd]
Subv: checks 
teunuss: checks 
*** TURN *** [Kh 9s Qd] [Ks]
Subv: bets $70.50
teunuss: folds 
Uncalled bet ($70.50) returned to Subv
Subv collected $46.50 from pot
Subv: doesn't show hand 
*** SUMMARY ***
Total pot $48 | Rake $1.50 
Board [Kh 9s Qd Ks]
Seat 1: teunuss (big blind) folded on the Turn
Seat 2: 31ddd31 folded before Flop (didn't bet)
Seat 3: mikimiki88 (button) folded before Flop (didn't bet)
Seat 5: Subv (small blind) collected ($46.50)


PokerStars Game #102621777715:  Hold'em No Limit ($3/$6 USD) - 2013/08/11 15:54:34 ET
Table 'Crux V 40-100 bb' 6-max Seat #5 is the button
Seat 1: teunuss ($600 in chips) 
Seat 2: 31ddd31 ($624.56 in chips) 
Seat 3: mikimiki88 ($819.07 in chips) 
Seat 4: evgenij_d_m ($496.23 in chips) 
Seat 5: Subv ($1942.67 in chips) 
teunuss: posts small blind $3
31ddd31: posts big blind $6
evgenij_d_m: posts small blind $3
*** HOLE CARDS ***
mikimiki88: folds 
evgenij_d_m: folds 
Subv: folds 
teunuss: raises $12 to $18
31ddd31: calls $12
*** FLOP *** [4c Kd 7s]
teunuss: bets $30
31ddd31: calls $30
*** TURN *** [4c Kd 7s] [6d]
teunuss: bets $66
31ddd31: calls $66
*** RIVER *** [4c Kd 7s 6d] [2s]
teunuss: bets $162
31ddd31: folds 
Uncalled bet ($162) returned to teunuss
teunuss collected $228.20 from pot
teunuss: doesn't show hand 
*** SUMMARY ***
Total pot $231 | Rake $2.80 
Board [4c Kd 7s 6d 2s]
Seat 1: teunuss (small blind) collected ($228.20)
Seat 2: 31ddd31 (big blind) folded on the River
Seat 3: mikimiki88 folded before Flop (didn't bet)
Seat 4: evgenij_d_m folded before Flop
Seat 5: Subv (button) folded before Flop (didn't bet)


PokerStars Game #102621003197:  Hold'em No Limit ($3/$6 USD) - 2013/08/11 15:40:00 ET
Table 'Crux V 40-100 bb' 6-max Seat #4 is the button
Seat 1: teunuss ($710.41 in chips) 
Seat 2: 31ddd31 ($604.78 in chips) 
Seat 3: mikimiki88 ($771.57 in chips) 
Seat 4: evgenij_d_m ($413.40 in chips) 
Seat 5: Subv ($685.77 in chips) 
Subv: posts small blind $3
teunuss: posts big blind $6
*** HOLE CARDS ***
31ddd31: folds 
mikimiki88: folds 
evgenij_d_m: folds 
Subv: calls $3
teunuss: raises $18 to $24
Subv: calls $18
*** FLOP *** [Ts 4d 8d]
Subv: checks 
teunuss: checks 
*** TURN *** [Ts 4d 8d] [7d]
Subv: bets $39
teunuss: folds 
Uncalled bet ($39) returned to Subv
Subv collected $45.84 from pot
Subv: doesn't show hand 
*** SUMMARY ***
Total pot $48 | Rake $2.16 
Board [Ts 4d 8d 7d]
Seat 1: teunuss (big blind) folded on the Turn
Seat 2: 31ddd31 folded before Flop (didn't bet)
Seat 3: mikimiki88 folded before Flop (didn't bet)
Seat 4: evgenij_d_m (button) folded before Flop (didn't bet)
Seat 5: Subv (small blind) collected ($45.84)


PokerStars Game #102621049816:  Hold'em No Limit ($3/$6 USD) - 2013/08/11 15:40:52 ET
Table 'Crux V 40-100 bb' 6-max Seat #5 is the button
Seat 1: teunuss ($686.41 in chips) 
Seat 2: 31ddd31 ($604.78 in chips) 
Seat 3: mikimiki88 ($771.57 in chips) 
Seat 4: evgenij_d_m ($413.40 in chips) 
Seat 5: Subv ($707.61 in chips) 
teunuss: posts small blind $3
31ddd31: posts big blind $6
*** HOLE CARDS ***
mikimiki88: folds 
evgenij_d_m: folds 
Subv: raises $6.30 to $12.30
teunuss: raises $32.70 to $45
31ddd31: folds 
Subv: calls $32.70
*** FLOP *** [8d Js 5h]
teunuss: bets $54
Subv: calls $54
*** TURN *** [8d Js 5h] [Jc]
teunuss: checks 
Subv: bets $132
teunuss: folds 
Uncalled bet ($132) returned to Subv
Subv collected $201.20 from pot
Subv: doesn't show hand 
*** SUMMARY ***
Total pot $204 | Rake $2.80 
Board [8d Js 5h Jc]
Seat 1: teunuss (small blind) folded on the Turn
Seat 2: 31ddd31 (big blind) folded before Flop
Seat 3: mikimiki88 folded before Flop (didn't bet)
Seat 4: evgenij_d_m folded before Flop (didn't bet)
Seat 5: Subv (button) collected ($201.20)


PokerStars Game #102621111674:  Hold'em No Limit ($3/$6 USD) - 2013/08/11 15:42:01 ET
Table 'Crux V 40-100 bb' 6-max Seat #1 is the button
Seat 1: teunuss ($600 in chips) 
Seat 2: 31ddd31 ($600 in chips) 
Seat 3: mikimiki88 ($771.57 in chips) 
Seat 4: evgenij_d_m ($413.40 in chips) 
Seat 5: Subv ($809.81 in chips) 
31ddd31: posts small blind $3
mikimiki88: posts big blind $6
*** HOLE CARDS ***
evgenij_d_m: raises $6 to $12
Subv: raises $30 to $42
teunuss: raises $51 to $93
31ddd31: folds 
mikimiki88: folds 
evgenij_d_m: calls $81
Subv: raises $716.81 to $809.81 and is all-in
teunuss: calls $507 and is all-in
evgenij_d_m: calls $320.40 and is all-in
Uncalled bet ($209.81) returned to Subv
*** FLOP *** [5d 9c 5h]
*** TURN *** [5d 9c 5h] [Ah]
*** RIVER *** [5d 9c 5h Ah] [Qd]
*** SHOW DOWN ***
Subv: shows [Ac Ks] (two pair, Aces and Fives)
teunuss: shows [Kh Kc] (two pair, Kings and Fives)
Subv collected $373.20 from side pot
evgenij_d_m: shows [Jh Jc] (two pair, Jacks and Fives)
Subv collected $1246.40 from main pot
*** SUMMARY ***
Total pot $1622.40 Main pot $1246.40. Side pot $373.20. | Rake $2.80 
Board [5d 9c 5h Ah Qd]
Seat 1: teunuss (button) showed [Kh Kc] and lost with two pair, Kings and Fives
Seat 2: 31ddd31 (small blind) folded before Flop
Seat 3: mikimiki88 (big blind) folded before Flop
Seat 4: evgenij_d_m showed [Jh Jc] and lost with two pair, Jacks and Fives
Seat 5: Subv showed [Ac Ks] and won ($1619.60) with two pair, Aces and Fives


PokerStars Game #102621174666:  Hold'em No Limit ($3/$6 USD) - 2013/08/11 15:43:12 ET
Table 'Crux V 40-100 bb' 6-max Seat #2 is the button
Seat 1: teunuss ($600 in chips) 
Seat 2: 31ddd31 ($600 in chips) 
Seat 3: mikimiki88 ($765.57 in chips) 
Seat 5: Subv ($1829.41 in chips) 
mikimiki88: posts small blind $3
Subv: posts big blind $6
*** HOLE CARDS ***
teunuss: raises $9 to $15
31ddd31: calls $15
mikimiki88: raises $37 to $52
Subv: folds 
teunuss: folds 
31ddd31: calls $37
*** FLOP *** [Ac 4d Js]
mikimiki88: checks 
31ddd31: checks 
*** TURN *** [Ac 4d Js] [4h]
mikimiki88: checks 
31ddd31: checks 
*** RIVER *** [Ac 4d Js 4h] [3d]
mikimiki88: checks 
31ddd31: checks 
*** SHOW DOWN ***
mikimiki88: shows [Tc Ts] (two pair, Tens and Fours)
31ddd31: mucks hand 
mikimiki88 collected $123.50 from pot
*** SUMMARY ***
Total pot $125 | Rake $1.50 
Board [Ac 4d Js 4h 3d]
Seat 1: teunuss folded before Flop
Seat 2: 31ddd31 (button) mucked
Seat 3: mikimiki88 (small blind) showed [Tc Ts] and won ($123.50) with two pair, Tens and Fours
Seat 5: Subv (big blind) folded before Flop


PokerStars Game #102621253092:  Hold'em No Limit ($3/$6 USD) - 2013/08/11 15:44:41 ET
Table 'Crux V 40-100 bb' 6-max Seat #3 is the button
Seat 1: teunuss ($600 in chips) 
Seat 2: 31ddd31 ($600 in chips) 
Seat 3: mikimiki88 ($837.07 in chips) 
Seat 5: Subv ($1823.41 in chips) 
Seat 6: Strz ($648.98 in chips) 
evgenij_d_m will be allowed to play after the button
Subv: posts small blind $3
Strz: posts big blind $6
*** HOLE CARDS ***
teunuss: folds 
31ddd31: raises $12 to $18
mikimiki88: folds 
Subv: folds 
Strz: folds 
Uncalled bet ($12) returned to 31ddd31
31ddd31 collected $15 from pot
31ddd31: doesn't show hand 
*** SUMMARY ***
Total pot $15 | Rake $0 
Seat 1: teunuss folded before Flop (didn't bet)
Seat 2: 31ddd31 collected ($15)
Seat 3: mikimiki88 (button) folded before Flop (didn't bet)
Seat 5: Subv (small blind) folded before Flop
Seat 6: Strz (big blind) folded before Flop


PokerStars Game #102621264512:  Hold'em No Limit ($3/$6 USD) - 2013/08/11 15:44:54 ET
Table 'Crux V 40-100 bb' 6-max Seat #5 is the button
Seat 1: teunuss ($600 in chips) 
Seat 2: 31ddd31 ($609 in chips) 
Seat 3: mikimiki88 ($837.07 in chips) 
Seat 4: evgenij_d_m ($579.83 in chips) 
Seat 5: Subv ($1820.41 in chips) 
Seat 6: Strz ($642.98 in chips) 
Strz: posts small blind $3
teunuss: posts big blind $6
evgenij_d_m: posts small & big blinds $9
*** HOLE CARDS ***
31ddd31: folds 
mikimiki88: folds 
evgenij_d_m: checks 
Subv: folds 
Strz: calls $3
teunuss: checks 
*** FLOP *** [7c 6s Js]
Strz: checks 
teunuss: checks 
evgenij_d_m: bets $18
Strz: folds 
teunuss: folds 
Uncalled bet ($18) returned to evgenij_d_m
evgenij_d_m collected $20.06 from pot
evgenij_d_m: doesn't show hand 
*** SUMMARY ***
Total pot $21 | Rake $0.94 
Board [7c 6s Js]
Seat 1: teunuss (big blind) folded on the Flop
Seat 2: 31ddd31 folded before Flop (didn't bet)
Seat 3: mikimiki88 folded before Flop (didn't bet)
Seat 4: evgenij_d_m collected ($20.06)
Seat 5: Subv (button) folded before Flop (didn't bet)
Seat 6: Strz (small blind) folded on the Flop


PokerStars Game #102620776461:  Hold'em No Limit ($3/$6 USD) - 2013/08/11 15:35:50 ET
Table 'Crux V 40-100 bb' 6-max Seat #3 is the button
Seat 1: teunuss ($767.41 in chips) 
Seat 2: 31ddd31 ($613.78 in chips) 
Seat 3: mikimiki88 ($717.37 in chips) 
Seat 4: evgenij_d_m ($418.48 in chips) 
Seat 5: Subv ($676.25 in chips) 
evgenij_d_m: posts small blind $3
Subv: posts big blind $6
*** HOLE CARDS ***
teunuss: folds 
31ddd31: folds 
mikimiki88: folds 
evgenij_d_m: calls $3
Subv: checks 
*** FLOP *** [5d 3h 6c]
evgenij_d_m: checks 
Subv: bets $9
evgenij_d_m: folds 
Uncalled bet ($9) returned to Subv
Subv collected $11.46 from pot
Subv: doesn't show hand 
*** SUMMARY ***
Total pot $12 | Rake $0.54 
Board [5d 3h 6c]
Seat 1: teunuss folded before Flop (didn't bet)
Seat 2: 31ddd31 folded before Flop (didn't bet)
Seat 3: mikimiki88 (button) folded before Flop (didn't bet)
Seat 4: evgenij_d_m (small blind) folded on the Flop
Seat 5: Subv (big blind) collected ($11.46)


PokerStars Game #102620807565:  Hold'em No Limit ($3/$6 USD) - 2013/08/11 15:36:24 ET
Table 'Crux V 40-100 bb' 6-max Seat #4 is the button
Seat 1: teunuss ($767.41 in chips) 
Seat 2: 31ddd31 ($613.78 in chips) 
Seat 3: mikimiki88 ($717.37 in chips) 
Seat 4: evgenij_d_m ($412.48 in chips) 
Seat 5: Subv ($681.71 in chips) 
Subv: posts small blind $3
teunuss: posts big blind $6
*** HOLE CARDS ***
31ddd31: folds 
mikimiki88: folds 
evgenij_d_m: folds 
Subv: calls $3
teunuss: checks 
*** FLOP *** [4h 4d 4c]
Subv: bets $9
teunuss: folds 
Uncalled bet ($9) returned to Subv
Subv collected $11.46 from pot
Subv: doesn't show hand 
*** SUMMARY ***
Total pot $12 | Rake $0.54 
Board [4h 4d 4c]
Seat 1: teunuss (big blind) folded on the Flop
Seat 2: 31ddd31 folded before Flop (didn't bet)
Seat 3: mikimiki88 folded before Flop (didn't bet)
Seat 4: evgenij_d_m (button) folded before Flop (didn't bet)
Seat 5: Subv (small blind) collected ($11.46)


PokerStars Game #102620839144:  Hold'em No Limit ($3/$6 USD) - 2013/08/11 15:36:58 ET
Table 'Crux V 40-100 bb' 6-max Seat #5 is the button
Seat 1: teunuss ($761.41 in chips) 
Seat 2: 31ddd31 ($613.78 in chips) 
Seat 3: mikimiki88 ($717.37 in chips) 
Seat 4: evgenij_d_m ($412.48 in chips) 
Seat 5: Subv ($687.17 in chips) 
teunuss: posts small blind $3
31ddd31: posts big blind $6
*** HOLE CARDS ***
mikimiki88: raises $12 to $18
evgenij_d_m: folds 
Subv: folds 
teunuss: folds 
31ddd31: folds 
Uncalled bet ($12) returned to mikimiki88
mikimiki88 collected $15 from pot
mikimiki88: doesn't show hand 
*** SUMMARY ***
Total pot $15 | Rake $0 
Seat 1: teunuss (small blind) folded before Flop
Seat 2: 31ddd31 (big blind) folded before Flop
Seat 3: mikimiki88 collected ($15)
Seat 4: evgenij_d_m folded before Flop (didn't bet)
Seat 5: Subv (button) folded before Flop (didn't bet)


PokerStars Game #102620860421:  Hold'em No Limit ($3/$6 USD) - 2013/08/11 15:37:22 ET
Table 'Crux V 40-100 bb' 6-max Seat #1 is the button
Seat 1: teunuss ($758.41 in chips) 
Seat 2: 31ddd31 ($607.78 in chips) 
Seat 3: mikimiki88 ($726.37 in chips) 
Seat 4: evgenij_d_m ($412.48 in chips) 
Seat 5: Subv ($687.17 in chips) 
31ddd31: posts small blind $3
mikimiki88: posts big blind $6
*** HOLE CARDS ***
evgenij_d_m: calls $6
Subv: folds 
teunuss: folds 
31ddd31: folds 
mikimiki88: checks 
*** FLOP *** [9h 2d 8d]
mikimiki88: checks 
evgenij_d_m: bets $18
mikimiki88: folds 
Uncalled bet ($18) returned to evgenij_d_m
evgenij_d_m collected $14.32 from pot
evgenij_d_m: doesn't show hand 
*** SUMMARY ***
Total pot $15 | Rake $0.68 
Board [9h 2d 8d]
Seat 1: teunuss (button) folded before Flop (didn't bet)
Seat 2: 31ddd31 (small blind) folded before Flop
Seat 3: mikimiki88 (big blind) folded on the Flop
Seat 4: evgenij_d_m collected ($14.32)
Seat 5: Subv folded before Flop (didn't bet)


PokerStars Game #102620896039:  Hold'em No Limit ($3/$6 USD) - 2013/08/11 15:38:01 ET
Table 'Crux V 40-100 bb' 6-max Seat #2 is the button
Seat 1: teunuss ($758.41 in chips) 
Seat 2: 31ddd31 ($604.78 in chips) 
Seat 3: mikimiki88 ($720.37 in chips) 
Seat 4: evgenij_d_m ($420.80 in chips) 
Seat 5: Subv ($687.17 in chips) 
mikimiki88: posts small blind $3
evgenij_d_m: posts big blind $6
*** HOLE CARDS ***
Subv: folds 
teunuss: raises $9 to $15
31ddd31: folds 
mikimiki88: raises $33 to $48
evgenij_d_m: folds 
teunuss: calls $33
*** FLOP *** [9s 3h 5c]
mikimiki88: bets $58.52
teunuss: folds 
Uncalled bet ($58.52) returned to mikimiki88
mikimiki88 collected $99.20 from pot
mikimiki88: doesn't show hand 
*** SUMMARY ***
Total pot $102 | Rake $2.80 
Board [9s 3h 5c]
Seat 1: teunuss folded on the Flop
Seat 2: 31ddd31 (button) folded before Flop (didn't bet)
Seat 3: mikimiki88 (small blind) collected ($99.20)
Seat 4: evgenij_d_m (big blind) folded before Flop
Seat 5: Subv folded before Flop (didn't bet)


PokerStars Game #102620938270:  Hold'em No Limit ($3/$6 USD) - 2013/08/11 15:38:48 ET
Table 'Crux V 40-100 bb' 6-max Seat #3 is the button
Seat 1: teunuss ($710.41 in chips) 
Seat 2: 31ddd31 ($604.78 in chips) 
Seat 3: mikimiki88 ($771.57 in chips) 
Seat 4: evgenij_d_m ($414.80 in chips) 
Seat 5: Subv ($687.17 in chips) 
evgenij_d_m: posts small blind $3
Subv: posts big blind $6
*** HOLE CARDS ***
teunuss: folds 
31ddd31: folds 
mikimiki88: folds 
evgenij_d_m: calls $3
Subv: raises $18 to $24
evgenij_d_m: raises $18 to $42
Subv: calls $18
*** FLOP *** [Tc Ad 4s]
evgenij_d_m: bets $30
Subv: calls $30
*** TURN *** [Tc Ad 4s] [Qd]
evgenij_d_m: bets $102
Subv: calls $102
*** RIVER *** [Tc Ad 4s Qd] [Js]
evgenij_d_m: bets $240.80 and is all-in
Subv: calls $240.80
*** SHOW DOWN ***
evgenij_d_m: shows [Kd Ac] (a straight, Ten to Ace)
Subv: shows [Jd Kc] (a straight, Ten to Ace)
evgenij_d_m collected $413.40 from pot
Subv collected $413.40 from pot
*** SUMMARY ***
Total pot $829.60 | Rake $2.80 
Board [Tc Ad 4s Qd Js]
Seat 1: teunuss folded before Flop (didn't bet)
Seat 2: 31ddd31 folded before Flop (didn't bet)
Seat 3: mikimiki88 (button) folded before Flop (didn't bet)
Seat 4: evgenij_d_m (small blind) showed [Kd Ac] and won ($413.40) with a straight, Ten to Ace
Seat 5: Subv (big blind) showed [Jd Kc] and won ($413.40) with a straight, Ten to Ace


PokerStars Game #102622780714:  Hold'em No Limit ($3/$6 USD) - 2013/08/11 16:15:55 ET
Table 'Crux V 40-100 bb' 6-max Seat #1 is the button
Seat 1: teunuss ($727.20 in chips) 
Seat 3: mikimiki88 ($924.95 in chips) 
Seat 4: king10clubs ($600 in chips) 
mikimiki88: posts small blind $3
king10clubs: posts big blind $6
*** HOLE CARDS ***
teunuss: raises $6 to $12
mikimiki88: folds 
king10clubs: calls $6
*** FLOP *** [7d 3c Jc]
king10clubs: checks 
teunuss: bets $18
king10clubs: calls $18
*** TURN *** [7d 3c Jc] [5d]
king10clubs: checks 
teunuss: bets $42
king10clubs: calls $42
*** RIVER *** [7d 3c Jc 5d] [Th]
king10clubs: checks 
teunuss: checks 
*** SHOW DOWN ***
king10clubs: shows [Ah 7h] (a pair of Sevens)
teunuss: shows [8d 8s] (a pair of Eights)
teunuss collected $145.50 from pot
*** SUMMARY ***
Total pot $147 | Rake $1.50 
Board [7d 3c Jc 5d Th]
Seat 1: teunuss (button) showed [8d 8s] and won ($145.50) with a pair of Eights
Seat 3: mikimiki88 (small blind) folded before Flop
Seat 4: king10clubs (big blind) showed [Ah 7h] and lost with a pair of Sevens


PokerStars Game #102622817873:  Hold'em No Limit ($3/$6 USD) - 2013/08/11 16:16:37 ET
Table 'Crux V 40-100 bb' 6-max Seat #3 is the button
Seat 1: teunuss ($800.70 in chips) 
Seat 3: mikimiki88 ($921.95 in chips) 
Seat 4: king10clubs ($600 in chips) 
king10clubs: posts small blind $3
teunuss: posts big blind $6
*** HOLE CARDS ***
mikimiki88: raises $6 to $12
king10clubs: calls $9
teunuss: calls $6
*** FLOP *** [Qc Kh 6h]
king10clubs: checks 
teunuss: checks 
mikimiki88: checks 
*** TURN *** [Qc Kh 6h] [9d]
king10clubs: bets $26.80
teunuss: folds 
mikimiki88: folds 
Uncalled bet ($26.80) returned to king10clubs
king10clubs collected $34.50 from pot
king10clubs: doesn't show hand 
*** SUMMARY ***
Total pot $36 | Rake $1.50 
Board [Qc Kh 6h 9d]
Seat 1: teunuss (big blind) folded on the Turn
Seat 3: mikimiki88 (button) folded on the Turn
Seat 4: king10clubs (small blind) collected ($34.50)


PokerStars Game #102622854624:  Hold'em No Limit ($3/$6 USD) - 2013/08/11 16:17:19 ET
Table 'Crux V 40-100 bb' 6-max Seat #4 is the button
Seat 1: teunuss ($788.70 in chips) 
Seat 3: mikimiki88 ($909.95 in chips) 
Seat 4: king10clubs ($622.50 in chips) 
teunuss: posts small blind $3
mikimiki88: posts big blind $6
*** HOLE CARDS ***
king10clubs: raises $6 to $12
teunuss: folds 
mikimiki88: folds 
Uncalled bet ($6) returned to king10clubs
king10clubs collected $15 from pot
king10clubs: doesn't show hand 
*** SUMMARY ***
Total pot $15 | Rake $0 
Seat 1: teunuss (small blind) folded before Flop
Seat 3: mikimiki88 (big blind) folded before Flop
Seat 4: king10clubs (button) collected ($15)


PokerStars Game #102622863760:  Hold'em No Limit ($3/$6 USD) - 2013/08/11 16:17:30 ET
Table 'Crux V 40-100 bb' 6-max Seat #1 is the button
Seat 1: teunuss ($785.70 in chips) 
Seat 3: mikimiki88 ($903.95 in chips) 
Seat 4: king10clubs ($631.50 in chips) 
mikimiki88: posts small blind $3
king10clubs: posts big blind $6
*** HOLE CARDS ***
teunuss: folds 
mikimiki88: folds 
Uncalled bet ($3) returned to king10clubs
king10clubs collected $6 from pot
king10clubs: doesn't show hand 
*** SUMMARY ***
Total pot $6 | Rake $0 
Seat 1: teunuss (button) folded before Flop (didn't bet)
Seat 3: mikimiki88 (small blind) folded before Flop
Seat 4: king10clubs (big blind) collected ($6)


PokerStars Game #102622873095:  Hold'em No Limit ($3/$6 USD) - 2013/08/11 16:17:40 ET
Table 'Crux V 40-100 bb' 6-max Seat #3 is the button
Seat 1: teunuss ($785.70 in chips) 
Seat 3: mikimiki88 ($900.95 in chips) 
Seat 4: king10clubs ($634.50 in chips) 
king10clubs: posts small blind $3
teunuss: posts big blind $6
*** HOLE CARDS ***
mikimiki88: folds 
king10clubs: folds 
Uncalled bet ($3) returned to teunuss
teunuss collected $6 from pot
teunuss: doesn't show hand 
*** SUMMARY ***
Total pot $6 | Rake $0 
Seat 1: teunuss (big blind) collected ($6)
Seat 3: mikimiki88 (button) folded before Flop (didn't bet)
Seat 4: king10clubs (small blind) folded before Flop


PokerStars Game #102622889275:  Hold'em No Limit ($3/$6 USD) - 2013/08/11 16:17:59 ET
Table 'Crux V 40-100 bb' 6-max Seat #4 is the button
Seat 1: teunuss ($788.70 in chips) 
Seat 3: mikimiki88 ($900.95 in chips) 
Seat 4: king10clubs ($631.50 in chips) 
teunuss: posts small blind $3
mikimiki88: posts big blind $6
*** HOLE CARDS ***
king10clubs: raises $6 to $12
teunuss: folds 
mikimiki88: raises $33 to $45
king10clubs: calls $33
*** FLOP *** [3c Ah 4h]
mikimiki88: bets $53.98
king10clubs: calls $53.98
*** TURN *** [3c Ah 4h] [Qd]
mikimiki88: checks 
king10clubs: checks 
*** RIVER *** [3c Ah 4h Qd] [6c]
mikimiki88: checks 
Subv joins the table at seat #2 
tera789 joins the table at seat #5 
king10clubs: bets $140
pindrokk joins the table at seat #6 
mikimiki88: folds 
Uncalled bet ($140) returned to king10clubs
Subv leaves the table
king10clubs collected $199.46 from pot
king10clubs: doesn't show hand 
*** SUMMARY ***
Total pot $200.96 | Rake $1.50 
Board [3c Ah 4h Qd 6c]
Seat 1: teunuss (small blind) folded before Flop
Seat 3: mikimiki88 (big blind) folded on the River
Seat 4: king10clubs (button) collected ($199.46)


PokerStars Game #102622952440:  Hold'em No Limit ($3/$6 USD) - 2013/08/11 16:19:11 ET
Table 'Crux V 40-100 bb' 6-max Seat #1 is the button
Seat 1: teunuss ($785.70 in chips) 
Seat 3: mikimiki88 ($801.97 in chips) 
Seat 4: king10clubs ($731.98 in chips) 
mikimiki88: posts small blind $3
king10clubs: posts big blind $6
tera789: sits out 
pindrokk: sits out 
*** HOLE CARDS ***
Flying Smile joins the table at seat #2 
teunuss: raises $6 to $12
mikimiki88: raises $35 to $47
king10clubs: folds 
teunuss: calls $35
*** FLOP *** [7d 3d 7c]
mikimiki88: bets $58.11
teunuss: folds 
Uncalled bet ($58.11) returned to mikimiki88
mikimiki88 collected $98.50 from pot
mikimiki88: doesn't show hand 
*** SUMMARY ***
Total pot $100 | Rake $1.50 
Board [7d 3d 7c]
Seat 1: teunuss (button) folded on the Flop
Seat 3: mikimiki88 (small blind) collected ($98.50)
Seat 4: king10clubs (big blind) folded before Flop


PokerStars Game #102622982851:  Hold'em No Limit ($3/$6 USD) - 2013/08/11 16:19:46 ET
Table 'Crux V 40-100 bb' 6-max Seat #3 is the button
Seat 1: teunuss ($738.70 in chips) 
Seat 3: mikimiki88 ($853.47 in chips) 
Seat 4: king10clubs ($725.98 in chips) 
Seat 5: tera789 ($331.25 in chips) 
king10clubs: posts small blind $3
tera789: posts big blind $6
pindrokk: sits out 
Flying Smile: sits out 
*** HOLE CARDS ***
teunuss: raises $9 to $15
mikimiki88: folds 
king10clubs: folds 
tera789: calls $9
*** FLOP *** [4s Th 2h]
tera789: bets $30
teunuss: calls $30
*** TURN *** [4s Th 2h] [Jc]
tera789: checks 
teunuss: checks 
*** RIVER *** [4s Th 2h Jc] [3h]
tera789: bets $120
teunuss: calls $120
*** SHOW DOWN ***
tera789: shows [7s 5s] (high card Jack)
teunuss: shows [Qs Td] (a pair of Tens)
teunuss collected $331.50 from pot
*** SUMMARY ***
Total pot $333 | Rake $1.50 
Board [4s Th 2h Jc 3h]
Seat 1: teunuss showed [Qs Td] and won ($331.50) with a pair of Tens
Seat 3: mikimiki88 (button) folded before Flop (didn't bet)
Seat 4: king10clubs (small blind) folded before Flop
Seat 5: tera789 (big blind) showed [7s 5s] and lost with high card Jack


PokerStars Game #102622746084:  Hold'em No Limit ($3/$6 USD) - 2013/08/11 16:15:16 ET
Table 'Crux V 40-100 bb' 6-max Seat #1 is the button
Seat 1: teunuss ($754.20 in chips) 
Seat 3: mikimiki88 ($898.45 in chips) 
teunuss: posts small blind $3
mikimiki88: posts big blind $6
*** HOLE CARDS ***
teunuss: folds 
Uncalled bet ($3) returned to mikimiki88
mikimiki88 collected $6 from pot
mikimiki88: doesn't show hand 
*** SUMMARY ***
Total pot $6 | Rake $0 
Seat 1: teunuss (button) (small blind) folded before Flop
Seat 3: mikimiki88 (big blind) collected ($6)


PokerStars Game #102622752120:  Hold'em No Limit ($3/$6 USD) - 2013/08/11 16:15:23 ET
Table 'Crux V 40-100 bb' 6-max Seat #3 is the button
Seat 1: teunuss ($751.20 in chips) 
Seat 3: mikimiki88 ($901.45 in chips) 
mikimiki88: posts small blind $3
teunuss: posts big blind $6
*** HOLE CARDS ***
mikimiki88: raises $6 to $12
teunuss: calls $6
*** FLOP *** [3h 5h Qh]
teunuss: checks 
king10clubs joins the table at seat #4 
mikimiki88: bets $16.68
teunuss: folds 
Uncalled bet ($16.68) returned to mikimiki88
mikimiki88 collected $23.50 from pot
mikimiki88: doesn't show hand 
*** SUMMARY ***
Total pot $24 | Rake $0.50 
Board [3h 5h Qh]
Seat 1: teunuss (big blind) folded on the Flop
Seat 3: mikimiki88 (button) (small blind) collected ($23.50)


PokerStars Game #102622770719:  Hold'em No Limit ($3/$6 USD) - 2013/08/11 16:15:44 ET
Table 'Crux V 40-100 bb' 6-max Seat #1 is the button
Seat 1: teunuss ($739.20 in chips) 
Seat 3: mikimiki88 ($912.95 in chips) 
teunuss: posts small blind $3
mikimiki88: posts big blind $6
*** HOLE CARDS ***
teunuss: raises $6 to $12
mikimiki88: raises $34 to $46
teunuss: folds 
Uncalled bet ($34) returned to mikimiki88
mikimiki88 collected $24 from pot
mikimiki88: doesn't show hand 
*** SUMMARY ***
Total pot $24 | Rake $0 
Seat 1: teunuss (button) (small blind) folded before Flop
Seat 3: mikimiki88 (big blind) collected ($24)


PokerStars Game #102622507377:  Hold'em No Limit ($3/$6 USD) - 2013/08/11 16:10:39 ET
Table 'Crux V 40-100 bb' 6-max Seat #1 is the button
Seat 1: teunuss ($720.20 in chips) 
Seat 2: 31ddd31 ($603 in chips) 
Seat 3: mikimiki88 ($806.77 in chips) 
Seat 4: evgenij_d_m ($717.39 in chips) 
Seat 5: Subv ($1738.06 in chips) 
Seat 6: Strz ($846.20 in chips) 
31ddd31: posts small blind $3
mikimiki88: posts big blind $6
*** HOLE CARDS ***
evgenij_d_m: calls $6
Subv: folds 
Strz: folds 
teunuss: folds 
31ddd31: folds 
mikimiki88: raises $15 to $21
evgenij_d_m: calls $15
*** FLOP *** [2h 5h 3h]
mikimiki88: bets $25.35
evgenij_d_m: folds 
Uncalled bet ($25.35) returned to mikimiki88
mikimiki88 collected $42.98 from pot
mikimiki88: doesn't show hand 
*** SUMMARY ***
Total pot $45 | Rake $2.02 
Board [2h 5h 3h]
Seat 1: teunuss (button) folded before Flop (didn't bet)
Seat 2: 31ddd31 (small blind) folded before Flop
Seat 3: mikimiki88 (big blind) collected ($42.98)
Seat 4: evgenij_d_m folded on the Flop
Seat 5: Subv folded before Flop (didn't bet)
Seat 6: Strz folded before Flop (didn't bet)


PokerStars Game #102622546077:  Hold'em No Limit ($3/$6 USD) - 2013/08/11 16:11:24 ET
Table 'Crux V 40-100 bb' 6-max Seat #2 is the button
Seat 1: teunuss ($720.20 in chips) 
Seat 2: 31ddd31 ($600 in chips) 
Seat 3: mikimiki88 ($828.75 in chips) 
Seat 4: evgenij_d_m ($696.39 in chips) 
Seat 5: Subv ($1738.06 in chips) 
Seat 6: Strz ($846.20 in chips) 
mikimiki88: posts small blind $3
evgenij_d_m: posts big blind $6
*** HOLE CARDS ***
Subv: folds 
Strz has timed out
Strz: folds 
teunuss: raises $9 to $15
31ddd31: folds 
mikimiki88: raises $34 to $49
evgenij_d_m: calls $43
teunuss: folds 
*** FLOP *** [Js 3c 9c]
mikimiki88: bets $72
evgenij_d_m: folds 
Uncalled bet ($72) returned to mikimiki88
mikimiki88 collected $110.20 from pot
mikimiki88: doesn't show hand 
*** SUMMARY ***
Total pot $113 | Rake $2.80 
Board [Js 3c 9c]
Seat 1: teunuss folded before Flop
Seat 2: 31ddd31 (button) folded before Flop (didn't bet)
Seat 3: mikimiki88 (small blind) collected ($110.20)
Seat 4: evgenij_d_m (big blind) folded on the Flop
Seat 5: Subv folded before Flop (didn't bet)
Seat 6: Strz folded before Flop (didn't bet)


PokerStars Game #102622611550:  Hold'em No Limit ($3/$6 USD) - 2013/08/11 16:12:39 ET
Table 'Crux V 40-100 bb' 6-max Seat #3 is the button
Seat 1: teunuss ($705.20 in chips) 
Seat 2: 31ddd31 ($600 in chips) 
Seat 3: mikimiki88 ($889.95 in chips) 
Seat 5: Subv ($1738.06 in chips) 
Seat 6: Strz ($846.20 in chips) 
Subv: posts small blind $3
Strz: posts big blind $6
*** HOLE CARDS ***
evgenij_d_m leaves the table
teunuss: folds 
31ddd31: folds 
LuckyBiitch joins the table at seat #4 
mikimiki88: raises $6 to $12
LuckyBiitch leaves the table
Subv: folds 
Strz: folds 
Uncalled bet ($6) returned to mikimiki88
mikimiki88 collected $15 from pot
mikimiki88: doesn't show hand 
*** SUMMARY ***
Total pot $15 | Rake $0 
Seat 1: teunuss folded before Flop (didn't bet)
Seat 2: 31ddd31 folded before Flop (didn't bet)
Seat 3: mikimiki88 (button) collected ($15)
Seat 5: Subv (small blind) folded before Flop
Seat 6: Strz (big blind) folded before Flop


PokerStars Game #102622637399:  Hold'em No Limit ($3/$6 USD) - 2013/08/11 16:13:10 ET
Table 'Crux V 40-100 bb' 6-max Seat #5 is the button
Seat 1: teunuss ($705.20 in chips) 
Seat 2: 31ddd31 ($600 in chips) 
Seat 3: mikimiki88 ($898.95 in chips) 
Seat 5: Subv ($1735.06 in chips) 
Seat 6: Strz ($840.20 in chips) 
Strz: posts small blind $3
teunuss: posts big blind $6
*** HOLE CARDS ***
31ddd31: folds 
mikimiki88: folds 
Subv: folds 
Strz: folds 
Uncalled bet ($3) returned to teunuss
teunuss collected $6 from pot
teunuss: doesn't show hand 
*** SUMMARY ***
Total pot $6 | Rake $0 
Seat 1: teunuss (big blind) collected ($6)
Seat 2: 31ddd31 folded before Flop (didn't bet)
Seat 3: mikimiki88 folded before Flop (didn't bet)
Seat 5: Subv (button) folded before Flop (didn't bet)
Seat 6: Strz (small blind) folded before Flop


PokerStars Game #102622652625:  Hold'em No Limit ($3/$6 USD) - 2013/08/11 16:13:27 ET
Table 'Crux V 40-100 bb' 6-max Seat #6 is the button
Seat 1: teunuss ($708.20 in chips) 
Seat 3: mikimiki88 ($898.95 in chips) 
Seat 5: Subv ($1735.06 in chips) 
Seat 6: Strz ($837.20 in chips) 
teunuss: posts small blind $3
31ddd31: is sitting out 
mikimiki88: posts big blind $6
*** HOLE CARDS ***
Subv: raises $6.30 to $12.30
Strz: folds 
31ddd31 leaves the table
teunuss: raises $35.70 to $48
mikimiki88: folds 
Subv: calls $35.70
*** FLOP *** [Kd 3c Ad]
teunuss: bets $54
Subv: folds 
Uncalled bet ($54) returned to teunuss
teunuss collected $100.50 from pot
teunuss: doesn't show hand 
*** SUMMARY ***
Total pot $102 | Rake $1.50 
Board [Kd 3c Ad]
Seat 1: teunuss (small blind) collected ($100.50)
Seat 3: mikimiki88 (big blind) folded before Flop
Seat 5: Subv folded on the Flop
Seat 6: Strz (button) folded before Flop (didn't bet)


PokerStars Game #102622694778:  Hold'em No Limit ($3/$6 USD) - 2013/08/11 16:14:17 ET
Table 'Crux V 40-100 bb' 6-max Seat #3 is the button
Seat 1: teunuss ($760.70 in chips) 
Seat 3: mikimiki88 ($892.95 in chips) 
mikimiki88: posts small blind $3
Subv: is sitting out 
Strz: is sitting out 
teunuss: posts big blind $6
*** HOLE CARDS ***
Subv leaves the table
mikimiki88: raises $6 to $12
teunuss: folds 
Uncalled bet ($6) returned to mikimiki88
mikimiki88 collected $12 from pot
mikimiki88: doesn't show hand 
*** SUMMARY ***
Total pot $12 | Rake $0 
Seat 1: teunuss (big blind) folded before Flop
Seat 3: mikimiki88 (button) (small blind) collected ($12)


PokerStars Game #102622701246:  Hold'em No Limit ($3/$6 USD) - 2013/08/11 16:14:25 ET
Table 'Crux V 40-100 bb' 6-max Seat #1 is the button
Seat 1: teunuss ($754.70 in chips) 
Seat 3: mikimiki88 ($898.95 in chips) 
teunuss: posts small blind $3
mikimiki88: posts big blind $6
*** HOLE CARDS ***
Strz leaves the table
teunuss: raises $6 to $12
mikimiki88: calls $6
*** FLOP *** [2h 3c 2c]
mikimiki88: checks 
teunuss: bets $15
mikimiki88: folds 
Uncalled bet ($15) returned to teunuss
teunuss collected $23.50 from pot
teunuss: doesn't show hand 
*** SUMMARY ***
Total pot $24 | Rake $0.50 
Board [2h 3c 2c]
Seat 1: teunuss (button) (small blind) collected ($23.50)
Seat 3: mikimiki88 (big blind) folded on the Flop


PokerStars Game #102622715818:  Hold'em No Limit ($3/$6 USD) - 2013/08/11 16:14:41 ET
Table 'Crux V 40-100 bb' 6-max Seat #3 is the button
Seat 1: teunuss ($766.20 in chips) 
Seat 3: mikimiki88 ($886.95 in chips) 
mikimiki88: posts small blind $3
teunuss: posts big blind $6
*** HOLE CARDS ***
mikimiki88: raises $6 to $12
teunuss: calls $6
*** FLOP *** [Jh 9s 3c]
teunuss: checks 
mikimiki88: checks 
*** TURN *** [Jh 9s 3c] [5c]
teunuss: checks 
maloyd joins the table at seat #4 
maloyd leaves the table
YourMyATM247 joins the table at seat #4 
mikimiki88: checks 
*** RIVER *** [Jh 9s 3c 5c] [Ks]
teunuss: checks 
YourMyATM247 leaves the table
mikimiki88: checks 
*** SHOW DOWN ***
teunuss: shows [6s Ac] (high card Ace)
mikimiki88: shows [Ah 7s] (high card Ace - King+Jack+Nine+Seven kicker)
mikimiki88 collected $23.50 from pot
*** SUMMARY ***
Total pot $24 | Rake $0.50 
Board [Jh 9s 3c 5c Ks]
Seat 1: teunuss (big blind) showed [6s Ac] and lost with high card Ace
Seat 3: mikimiki88 (button) (small blind) showed [Ah 7s] and won ($23.50) with high card Ace


PokerStars Game #102622212047:  Hold'em No Limit ($3/$6 USD) - 2013/08/11 16:05:05 ET
Table 'Crux V 40-100 bb' 6-max Seat #1 is the button
Seat 1: teunuss ($711.20 in chips) 
Seat 2: 31ddd31 ($600 in chips) 
Seat 3: mikimiki88 ($828.07 in chips) 
Seat 4: evgenij_d_m ($702.19 in chips) 
Seat 5: Subv ($1863.37 in chips) 
31ddd31: posts small blind $3
mikimiki88: posts big blind $6
Strz: sits out 
*** HOLE CARDS ***
evgenij_d_m: calls $6
Subv: raises $12.30 to $18.30
teunuss: folds 
31ddd31: folds 
mikimiki88: calls $12.30
evgenij_d_m: calls $12.30
*** FLOP *** [Js 2c 4c]
mikimiki88: checks 
evgenij_d_m: checks 
Subv: checks 
*** TURN *** [Js 2c 4c] [Th]
mikimiki88: checks 
evgenij_d_m: checks 
Subv: checks 
*** RIVER *** [Js 2c 4c Th] [Kc]
mikimiki88: checks 
evgenij_d_m: checks 
Subv: bets $42
mikimiki88: folds 
evgenij_d_m: folds 
Uncalled bet ($42) returned to Subv
Subv collected $55.29 from pot
Subv: doesn't show hand 
*** SUMMARY ***
Total pot $57.90 | Rake $2.61 
Board [Js 2c 4c Th Kc]
Seat 1: teunuss (button) folded before Flop (didn't bet)
Seat 2: 31ddd31 (small blind) folded before Flop
Seat 3: mikimiki88 (big blind) folded on the River
Seat 4: evgenij_d_m folded on the River
Seat 5: Subv collected ($55.29)


PokerStars Game #102622283332:  Hold'em No Limit ($3/$6 USD) - 2013/08/11 16:06:25 ET
Table 'Crux V 40-100 bb' 6-max Seat #2 is the button
Seat 1: teunuss ($711.20 in chips) 
Seat 2: 31ddd31 ($600 in chips) 
Seat 3: mikimiki88 ($809.77 in chips) 
Seat 4: evgenij_d_m ($683.89 in chips) 
Seat 5: Subv ($1900.36 in chips) 
mikimiki88: posts small blind $3
evgenij_d_m: posts big blind $6
Strz: sits out 
*** HOLE CARDS ***
Subv: folds 
teunuss: raises $9 to $15
31ddd31: folds 
mikimiki88: folds 
evgenij_d_m: folds 
Uncalled bet ($9) returned to teunuss
teunuss collected $15 from pot
teunuss: doesn't show hand 
*** SUMMARY ***
Total pot $15 | Rake $0 
Seat 1: teunuss collected ($15)
Seat 2: 31ddd31 (button) folded before Flop (didn't bet)
Seat 3: mikimiki88 (small blind) folded before Flop
Seat 4: evgenij_d_m (big blind) folded before Flop
Seat 5: Subv folded before Flop (didn't bet)


PokerStars Game #102622306208:  Hold'em No Limit ($3/$6 USD) - 2013/08/11 16:06:51 ET
Table 'Crux V 40-100 bb' 6-max Seat #3 is the button
Seat 1: teunuss ($720.20 in chips) 
Seat 2: 31ddd31 ($600 in chips) 
Seat 3: mikimiki88 ($806.77 in chips) 
Seat 4: evgenij_d_m ($677.89 in chips) 
Seat 5: Subv ($1900.36 in chips) 
evgenij_d_m: posts small blind $3
Subv: posts big blind $6
Strz: sits out 
*** HOLE CARDS ***
teunuss: folds 
31ddd31: raises $12 to $18
mikimiki88: folds 
evgenij_d_m: folds 
Subv: folds 
Uncalled bet ($12) returned to 31ddd31
31ddd31 collected $15 from pot
31ddd31: doesn't show hand 
*** SUMMARY ***
Total pot $15 | Rake $0 
Seat 1: teunuss folded before Flop (didn't bet)
Seat 2: 31ddd31 collected ($15)
Seat 3: mikimiki88 (button) folded before Flop (didn't bet)
Seat 4: evgenij_d_m (small blind) folded before Flop
Seat 5: Subv (big blind) folded before Flop


PokerStars Game #102622329178:  Hold'em No Limit ($3/$6 USD) - 2013/08/11 16:07:16 ET
Table 'Crux V 40-100 bb' 6-max Seat #4 is the button
Seat 1: teunuss ($720.20 in chips) 
Seat 2: 31ddd31 ($609 in chips) 
Seat 3: mikimiki88 ($806.77 in chips) 
Seat 4: evgenij_d_m ($674.89 in chips) 
Seat 5: Subv ($1894.36 in chips) 
Seat 6: Strz ($732 in chips) 
Subv: posts small blind $3
Strz: posts big blind $6
*** HOLE CARDS ***
teunuss: folds 
31ddd31: folds 
mikimiki88: folds 
evgenij_d_m: folds 
Subv: calls $3
Strz: raises $18 to $24
Subv: calls $18
*** FLOP *** [2s 4s 6s]
Subv: checks 
Strz: bets $36
Subv: raises $60 to $96
Strz: calls $60
*** TURN *** [2s 4s 6s] [Jc]
Subv: checks 
Strz: bets $162
Subv: folds 
Uncalled bet ($162) returned to Strz
Strz collected $237.20 from pot
*** SUMMARY ***
Total pot $240 | Rake $2.80 
Board [2s 4s 6s Jc]
Seat 1: teunuss folded before Flop (didn't bet)
Seat 2: 31ddd31 folded before Flop (didn't bet)
Seat 3: mikimiki88 folded before Flop (didn't bet)
Seat 4: evgenij_d_m (button) folded before Flop (didn't bet)
Seat 5: Subv (small blind) folded on the Turn
Seat 6: Strz (big blind) collected ($237.20)


PokerStars Game #102622403893:  Hold'em No Limit ($3/$6 USD) - 2013/08/11 16:08:40 ET
Table 'Crux V 40-100 bb' 6-max Seat #5 is the button
Seat 1: teunuss ($720.20 in chips) 
Seat 2: 31ddd31 ($609 in chips) 
Seat 3: mikimiki88 ($806.77 in chips) 
Seat 4: evgenij_d_m ($674.89 in chips) 
Seat 5: Subv ($1774.36 in chips) 
Seat 6: Strz ($849.20 in chips) 
Strz: posts small blind $3
teunuss: posts big blind $6
*** HOLE CARDS ***
31ddd31: folds 
mikimiki88: folds 
evgenij_d_m: folds 
Subv: folds 
Strz: folds 
Uncalled bet ($3) returned to teunuss
teunuss collected $6 from pot
teunuss: doesn't show hand 
*** SUMMARY ***
Total pot $6 | Rake $0 
Seat 1: teunuss (big blind) collected ($6)
Seat 2: 31ddd31 folded before Flop (didn't bet)
Seat 3: mikimiki88 folded before Flop (didn't bet)
Seat 4: evgenij_d_m folded before Flop (didn't bet)
Seat 5: Subv (button) folded before Flop (didn't bet)
Seat 6: Strz (small blind) folded before Flop


PokerStars Game #102622422972:  Hold'em No Limit ($3/$6 USD) - 2013/08/11 16:09:02 ET
Table 'Crux V 40-100 bb' 6-max Seat #6 is the button
Seat 1: teunuss ($723.20 in chips) 
Seat 2: 31ddd31 ($609 in chips) 
Seat 3: mikimiki88 ($806.77 in chips) 
Seat 4: evgenij_d_m ($674.89 in chips) 
Seat 5: Subv ($1774.36 in chips) 
Seat 6: Strz ($846.20 in chips) 
teunuss: posts small blind $3
31ddd31: posts big blind $6
*** HOLE CARDS ***
mikimiki88: folds 
evgenij_d_m: calls $6
Subv: raises $12.30 to $18.30
Strz: folds 
teunuss: folds 
31ddd31: folds 
evgenij_d_m: calls $12.30
*** FLOP *** [Tc 9h Jh]
evgenij_d_m: checks 
Subv: checks 
*** TURN *** [Tc 9h Jh] [4s]
evgenij_d_m: bets $18
Subv: calls $18
*** RIVER *** [Tc 9h Jh 4s] [9c]
evgenij_d_m: bets $30
Subv: folds 
Uncalled bet ($30) returned to evgenij_d_m
evgenij_d_m collected $78.80 from pot
*** SUMMARY ***
Total pot $81.60 | Rake $2.80 
Board [Tc 9h Jh 4s 9c]
Seat 1: teunuss (small blind) folded before Flop
Seat 2: 31ddd31 (big blind) folded before Flop
Seat 3: mikimiki88 folded before Flop (didn't bet)
Seat 4: evgenij_d_m collected ($78.80)
Seat 5: Subv folded on the River
Seat 6: Strz (button) folded before Flop (didn't bet)


PokerStars Game #102621831715:  Hold'em No Limit ($3/$6 USD) - 2013/08/11 15:55:53 ET
Table 'Crux V 40-100 bb' 6-max Seat #1 is the button
Seat 1: teunuss ($714.20 in chips) 
Seat 2: 31ddd31 ($600 in chips) 
Seat 4: evgenij_d_m ($493.23 in chips) 
Seat 5: Subv ($1942.67 in chips) 
31ddd31: posts small blind $3
mikimiki88: is sitting out 
evgenij_d_m: posts big blind $6
*** HOLE CARDS ***
Subv: folds 
teunuss: folds 
31ddd31: folds 
Uncalled bet ($3) returned to evgenij_d_m
evgenij_d_m collected $6 from pot
*** SUMMARY ***
Total pot $6 | Rake $0 
Seat 1: teunuss (button) folded before Flop (didn't bet)
Seat 2: 31ddd31 (small blind) folded before Flop
Seat 4: evgenij_d_m (big blind) collected ($6)
Seat 5: Subv folded before Flop (didn't bet)


PokerStars Game #102621843399:  Hold'em No Limit ($3/$6 USD) - 2013/08/11 15:56:14 ET
Table 'Crux V 40-100 bb' 6-max Seat #2 is the button
Seat 1: teunuss ($714.20 in chips) 
Seat 2: 31ddd31 ($600 in chips) 
Seat 4: evgenij_d_m ($496.23 in chips) 
Seat 5: Subv ($1942.67 in chips) 
evgenij_d_m: posts small blind $3
Subv: posts big blind $6
*** HOLE CARDS ***
teunuss: folds 
31ddd31: folds 
evgenij_d_m: calls $3
Subv: raises $18 to $24
evgenij_d_m: calls $18
*** FLOP *** [7h 5c Ts]
evgenij_d_m: checks 
Subv: bets $31.50
evgenij_d_m: calls $31.50
*** TURN *** [7h 5c Ts] [Ac]
evgenij_d_m: bets $36
Subv: raises $84 to $120
evgenij_d_m: raises $84 to $204
Subv: folds 
Uncalled bet ($84) returned to evgenij_d_m
evgenij_d_m collected $349.50 from pot
*** SUMMARY ***
Total pot $351 | Rake $1.50 
Board [7h 5c Ts Ac]
Seat 1: teunuss folded before Flop (didn't bet)
Seat 2: 31ddd31 (button) folded before Flop (didn't bet)
Seat 4: evgenij_d_m (small blind) collected ($349.50)
Seat 5: Subv (big blind) folded on the Turn


PokerStars Game #102621903814:  Hold'em No Limit ($3/$6 USD) - 2013/08/11 15:58:03 ET
Table 'Crux V 40-100 bb' 6-max Seat #4 is the button
Seat 1: teunuss ($714.20 in chips) 
Seat 2: 31ddd31 ($600 in chips) 
Seat 4: evgenij_d_m ($670.23 in chips) 
Seat 5: Subv ($1767.17 in chips) 
Seat 6: Strz ($644.77 in chips) 
Subv: posts small blind $3
Strz: posts big blind $6
*** HOLE CARDS ***
teunuss: folds 
31ddd31: folds 
evgenij_d_m: folds 
Subv: calls $3
Strz: checks 
*** FLOP *** [Qd 5s Th]
Subv: bets $9
Strz: calls $9
*** TURN *** [Qd 5s Th] [9s]
Subv: bets $22.50
Strz: calls $22.50
*** RIVER *** [Qd 5s Th 9s] [4d]
Subv: bets $57
Strz: calls $57
*** SHOW DOWN ***
Subv: shows [Td 5d] (two pair, Tens and Fives)
Strz: mucks hand 
Subv collected $186.20 from pot
*** SUMMARY ***
Total pot $189 | Rake $2.80 
Board [Qd 5s Th 9s 4d]
Seat 1: teunuss folded before Flop (didn't bet)
Seat 2: 31ddd31 folded before Flop (didn't bet)
Seat 4: evgenij_d_m (button) folded before Flop (didn't bet)
Seat 5: Subv (small blind) showed [Td 5d] and won ($186.20) with two pair, Tens and Fives
Seat 6: Strz (big blind) mucked


PokerStars Game #102621928613:  Hold'em No Limit ($3/$6 USD) - 2013/08/11 15:58:48 ET
Table 'Crux V 40-100 bb' 6-max Seat #5 is the button
Seat 2: 31ddd31 ($600 in chips) 
Seat 4: evgenij_d_m ($670.23 in chips) 
Seat 5: Subv ($1858.87 in chips) 
Seat 6: Strz ($600 in chips) 
Strz: posts small blind $3
teunuss: is sitting out 
31ddd31: posts big blind $6
*** HOLE CARDS ***
evgenij_d_m: calls $6
Subv: raises $12.30 to $18.30
Strz: folds 
31ddd31: folds 
evgenij_d_m: calls $12.30
*** FLOP *** [8h 2h As]
evgenij_d_m: checks 
Subv: bets $30
evgenij_d_m: folds 
Uncalled bet ($30) returned to Subv
Subv collected $44.10 from pot
Subv: doesn't show hand 
*** SUMMARY ***
Total pot $45.60 | Rake $1.50 
Board [8h 2h As]
Seat 2: 31ddd31 (big blind) folded before Flop
Seat 4: evgenij_d_m folded on the Flop
Seat 5: Subv (button) collected ($44.10)
Seat 6: Strz (small blind) folded before Flop


PokerStars Game #102621951680:  Hold'em No Limit ($3/$6 USD) - 2013/08/11 15:59:29 ET
Table 'Crux V 40-100 bb' 6-max Seat #6 is the button
Seat 2: 31ddd31 ($600 in chips) 
Seat 4: evgenij_d_m ($651.93 in chips) 
Seat 5: Subv ($1884.67 in chips) 
Seat 6: Strz ($600 in chips) 
31ddd31: posts small blind $3
evgenij_d_m: posts big blind $6
*** HOLE CARDS ***
Subv: raises $6.30 to $12.30
Strz: folds 
31ddd31: folds 
evgenij_d_m: calls $6.30
*** FLOP *** [8s 3s 3h]
evgenij_d_m: checks 
Subv: checks 
*** TURN *** [8s 3s 3h] [6h]
evgenij_d_m: checks 
Subv: checks 
*** RIVER *** [8s 3s 3h 6h] [2h]
evgenij_d_m: bets $102
Subv: folds 
Uncalled bet ($102) returned to evgenij_d_m
evgenij_d_m collected $26.36 from pot
*** SUMMARY ***
Total pot $27.60 | Rake $1.24 
Board [8s 3s 3h 6h 2h]
Seat 2: 31ddd31 (small blind) folded before Flop
Seat 4: evgenij_d_m (big blind) collected ($26.36)
Seat 5: Subv folded on the River
Seat 6: Strz (button) folded before Flop (didn't bet)


PokerStars Game #102621987840:  Hold'em No Limit ($3/$6 USD) - 2013/08/11 16:00:29 ET
Table 'Crux V 40-100 bb' 6-max Seat #2 is the button
Seat 2: 31ddd31 ($600 in chips) 
Seat 4: evgenij_d_m ($665.99 in chips) 
Seat 5: Subv ($1872.37 in chips) 
Seat 6: Strz ($600 in chips) 
evgenij_d_m: posts small blind $3
Subv: posts big blind $6
*** HOLE CARDS ***
Strz: folds 
31ddd31: folds 
evgenij_d_m: folds 
Uncalled bet ($3) returned to Subv
Subv collected $6 from pot
Subv: doesn't show hand 
*** SUMMARY ***
Total pot $6 | Rake $0 
Seat 2: 31ddd31 (button) folded before Flop (didn't bet)
Seat 4: evgenij_d_m (small blind) folded before Flop
Seat 5: Subv (big blind) collected ($6)
Seat 6: Strz folded before Flop (didn't bet)


PokerStars Game #102622002393:  Hold'em No Limit ($3/$6 USD) - 2013/08/11 16:00:52 ET
Table 'Crux V 40-100 bb' 6-max Seat #4 is the button
Seat 2: 31ddd31 ($600 in chips) 
Seat 4: evgenij_d_m ($662.99 in chips) 
Seat 5: Subv ($1875.37 in chips) 
Seat 6: Strz ($600 in chips) 
Subv: posts small blind $3
Strz: posts big blind $6
*** HOLE CARDS ***
31ddd31: folds 
evgenij_d_m: calls $6
Subv: folds 
Strz: raises $24 to $30
evgenij_d_m: calls $24
*** FLOP *** [2h 8d Ks]
Strz: bets $30
evgenij_d_m: folds 
Uncalled bet ($30) returned to Strz
Strz collected $61.50 from pot
*** SUMMARY ***
Total pot $63 | Rake $1.50 
Board [2h 8d Ks]
Seat 2: 31ddd31 folded before Flop (didn't bet)
Seat 4: evgenij_d_m (button) folded on the Flop
Seat 5: Subv (small blind) folded before Flop
Seat 6: Strz (big blind) collected ($61.50)


PokerStars Game #102622025515:  Hold'em No Limit ($3/$6 USD) - 2013/08/11 16:01:25 ET
Table 'Crux V 40-100 bb' 6-max Seat #5 is the button
Seat 2: 31ddd31 ($600 in chips) 
Seat 4: evgenij_d_m ($632.99 in chips) 
Seat 5: Subv ($1872.37 in chips) 
Seat 6: Strz ($631.50 in chips) 
Strz: posts small blind $3
31ddd31: posts big blind $6
*** HOLE CARDS ***
evgenij_d_m: folds 
Subv: folds 
Strz: raises $12 to $18
31ddd31: calls $12
*** FLOP *** [4c 9h 3s]
Strz: bets $24
31ddd31: calls $24
*** TURN *** [4c 9h 3s] [Jc]
Strz: bets $60
31ddd31: calls $60
*** RIVER *** [4c 9h 3s Jc] [6s]
Strz: bets $150
31ddd31: folds 
Uncalled bet ($150) returned to Strz
Strz collected $202.50 from pot
*** SUMMARY ***
Total pot $204 | Rake $1.50 
Board [4c 9h 3s Jc 6s]
Seat 2: 31ddd31 (big blind) folded on the River
Seat 4: evgenij_d_m folded before Flop (didn't bet)
Seat 5: Subv (button) folded before Flop (didn't bet)
Seat 6: Strz (small blind) collected ($202.50)


PokerStars Game #102622106964:  Hold'em No Limit ($3/$6 USD) - 2013/08/11 16:03:06 ET
Table 'Crux V 40-100 bb' 6-max Seat #6 is the button
Seat 2: 31ddd31 ($600 in chips) 
Seat 3: mikimiki88 ($819.07 in chips) 
Seat 4: evgenij_d_m ($632.99 in chips) 
Seat 5: Subv ($1872.37 in chips) 
Seat 6: Strz ($732 in chips) 
teunuss will be allowed to play after the button
31ddd31: posts small blind $3
mikimiki88: posts big blind $6
*** HOLE CARDS ***
evgenij_d_m: folds 
Subv: folds 
Strz: folds 
31ddd31: folds 
Uncalled bet ($3) returned to mikimiki88
mikimiki88 collected $6 from pot
mikimiki88: doesn't show hand 
*** SUMMARY ***
Total pot $6 | Rake $0 
Seat 2: 31ddd31 (small blind) folded before Flop
Seat 3: mikimiki88 (big blind) collected ($6)
Seat 4: evgenij_d_m folded before Flop (didn't bet)
Seat 5: Subv folded before Flop (didn't bet)
Seat 6: Strz (button) folded before Flop (didn't bet)


PokerStars Game #102622124355:  Hold'em No Limit ($3/$6 USD) - 2013/08/11 16:03:27 ET
Table 'Crux V 40-100 bb' 6-max Seat #2 is the button
Seat 2: 31ddd31 ($600 in chips) 
Seat 3: mikimiki88 ($822.07 in chips) 
Seat 4: evgenij_d_m ($632.99 in chips) 
Seat 5: Subv ($1872.37 in chips) 
Seat 6: Strz ($732 in chips) 
mikimiki88: posts small blind $3
evgenij_d_m: posts big blind $6
teunuss: sits out 
*** HOLE CARDS ***
Subv: folds 
Strz: folds 
31ddd31: folds 
mikimiki88: folds 
Uncalled bet ($3) returned to evgenij_d_m
evgenij_d_m collected $6 from pot
*** SUMMARY ***
Total pot $6 | Rake $0 
Seat 2: 31ddd31 (button) folded before Flop (didn't bet)
Seat 3: mikimiki88 (small blind) folded before Flop
Seat 4: evgenij_d_m (big blind) collected ($6)
Seat 5: Subv folded before Flop (didn't bet)
Seat 6: Strz folded before Flop (didn't bet)


PokerStars Game #102622135809:  Hold'em No Limit ($3/$6 USD) - 2013/08/11 16:03:39 ET
Table 'Crux V 40-100 bb' 6-max Seat #3 is the button
Seat 2: 31ddd31 ($600 in chips) 
Seat 3: mikimiki88 ($819.07 in chips) 
Seat 4: evgenij_d_m ($635.99 in chips) 
Seat 5: Subv ($1872.37 in chips) 
evgenij_d_m: posts small blind $3
Subv: posts big blind $6
teunuss: sits out 
*** HOLE CARDS ***
31ddd31: folds 
mikimiki88: raises $6 to $12
evgenij_d_m: folds 
Subv: folds 
Uncalled bet ($6) returned to mikimiki88
mikimiki88 collected $15 from pot
mikimiki88: doesn't show hand 
*** SUMMARY ***
Total pot $15 | Rake $0 
Seat 2: 31ddd31 folded before Flop (didn't bet)
Seat 3: mikimiki88 (button) collected ($15)
Seat 4: evgenij_d_m (small blind) folded before Flop
Seat 5: Subv (big blind) folded before Flop


PokerStars Game #102622150905:  Hold'em No Limit ($3/$6 USD) - 2013/08/11 16:03:56 ET
Table 'Crux V 40-100 bb' 6-max Seat #4 is the button
Seat 1: teunuss ($714.20 in chips) 
Seat 2: 31ddd31 ($600 in chips) 
Seat 3: mikimiki88 ($828.07 in chips) 
Seat 4: evgenij_d_m ($632.99 in chips) 
Seat 5: Subv ($1866.37 in chips) 
Subv: posts small blind $3
teunuss: posts big blind $6
*** HOLE CARDS ***
31ddd31: folds 
mikimiki88: folds 
evgenij_d_m: folds 
Subv: folds 
Uncalled bet ($3) returned to teunuss
teunuss collected $6 from pot
teunuss: doesn't show hand 
*** SUMMARY ***
Total pot $6 | Rake $0 
Seat 1: teunuss (big blind) collected ($6)
Seat 2: 31ddd31 folded before Flop (didn't bet)
Seat 3: mikimiki88 folded before Flop (didn't bet)
Seat 4: evgenij_d_m (button) folded before Flop (didn't bet)
Seat 5: Subv (small blind) folded before Flop


PokerStars Game #102622159320:  Hold'em No Limit ($3/$6 USD) - 2013/08/11 16:04:06 ET
Table 'Crux V 40-100 bb' 6-max Seat #5 is the button
Seat 1: teunuss ($717.20 in chips) 
Seat 2: 31ddd31 ($600 in chips) 
Seat 3: mikimiki88 ($828.07 in chips) 
Seat 4: evgenij_d_m ($632.99 in chips) 
Seat 5: Subv ($1863.37 in chips) 
teunuss: posts small blind $3
31ddd31: posts big blind $6
*** HOLE CARDS ***
mikimiki88: folds 
evgenij_d_m: calls $6
Subv: folds 
teunuss: calls $3
31ddd31: raises $24 to $30
evgenij_d_m: calls $24
teunuss: folds 
*** FLOP *** [Ad Ts Kh]
31ddd31: bets $36
evgenij_d_m: calls $36
*** TURN *** [Ad Ts Kh] [Jd]
31ddd31: checks 
evgenij_d_m: bets $54
31ddd31: folds 
Uncalled bet ($54) returned to evgenij_d_m
evgenij_d_m collected $135.20 from pot
*** SUMMARY ***
Total pot $138 | Rake $2.80 
Board [Ad Ts Kh Jd]
Seat 1: teunuss (small blind) folded before Flop
Seat 2: 31ddd31 (big blind) folded on the Turn
Seat 3: mikimiki88 folded before Flop (didn't bet)
Seat 4: evgenij_d_m collected ($135.20)
Seat 5: Subv (button) folded before Flop (didn't bet)


PokerStars Game #102624016287:  Hold'em No Limit ($3/$6 USD) - 2013/08/11 16:40:03 ET
Table 'Crux V 40-100 bb' 6-max Seat #6 is the button
Seat 1: teunuss ($754.65 in chips) 
Seat 2: Strz ($861.10 in chips) 
Seat 3: mikimiki88 ($1358.67 in chips) 
Seat 4: king10clubs ($686.18 in chips) 
Seat 5: baoyi2012 ($396.55 in chips) 
Seat 6: LiveTogether ($240 in chips) 
teunuss: posts small blind $3
Strz: posts big blind $6
*** HOLE CARDS ***
mikimiki88: folds 
king10clubs: folds 
baoyi2012: folds 
LiveTogether: folds 
teunuss: raises $12 to $18
Strz: calls $12
*** FLOP *** [Tc 6d Ks]
teunuss: bets $24
Strz: calls $24
*** TURN *** [Tc 6d Ks] [9s]
teunuss: checks 
Strz: checks 
*** RIVER *** [Tc 6d Ks 9s] [3s]
teunuss: checks 
Strz: checks 
*** SHOW DOWN ***
teunuss: shows [Td Ad] (a pair of Tens)
Strz: mucks hand 
teunuss collected $81.20 from pot
*** SUMMARY ***
Total pot $84 | Rake $2.80 
Board [Tc 6d Ks 9s 3s]
Seat 1: teunuss (small blind) showed [Td Ad] and won ($81.20) with a pair of Tens
Seat 2: Strz (big blind) mucked
Seat 3: mikimiki88 folded before Flop (didn't bet)
Seat 4: king10clubs folded before Flop (didn't bet)
Seat 5: baoyi2012 folded before Flop (didn't bet)
Seat 6: LiveTogether (button) folded before Flop (didn't bet)


PokerStars Game #102624074441:  Hold'em No Limit ($3/$6 USD) - 2013/08/11 16:41:13 ET
Table 'Crux V 40-100 bb' 6-max Seat #1 is the button
Seat 1: teunuss ($793.85 in chips) 
Seat 2: Strz ($819.10 in chips) 
Seat 3: mikimiki88 ($1358.67 in chips) 
Seat 4: king10clubs ($686.18 in chips) 
Seat 5: baoyi2012 ($396.55 in chips) 
Seat 6: LiveTogether ($240 in chips) 
Strz: posts small blind $3
mikimiki88: posts big blind $6
*** HOLE CARDS ***
king10clubs: folds 
baoyi2012: folds 
LiveTogether: folds 
teunuss: folds 
Strz: folds 
Uncalled bet ($3) returned to mikimiki88
mikimiki88 collected $6 from pot
mikimiki88: doesn't show hand 
*** SUMMARY ***
Total pot $6 | Rake $0 
Seat 1: teunuss (button) folded before Flop (didn't bet)
Seat 2: Strz (small blind) folded before Flop
Seat 3: mikimiki88 (big blind) collected ($6)
Seat 4: king10clubs folded before Flop (didn't bet)
Seat 5: baoyi2012 folded before Flop (didn't bet)
Seat 6: LiveTogether folded before Flop (didn't bet)


PokerStars Game #102624085733:  Hold'em No Limit ($3/$6 USD) - 2013/08/11 16:41:27 ET
Table 'Crux V 40-100 bb' 6-max Seat #2 is the button
Seat 1: teunuss ($793.85 in chips) 
Seat 2: Strz ($816.10 in chips) 
Seat 3: mikimiki88 ($1361.67 in chips) 
Seat 4: king10clubs ($686.18 in chips) 
Seat 5: baoyi2012 ($396.55 in chips) 
Seat 6: LiveTogether ($240 in chips) 
mikimiki88: posts small blind $3
king10clubs: posts big blind $6
*** HOLE CARDS ***
baoyi2012: folds 
LiveTogether: raises $6 to $12
teunuss: folds 
Strz: folds 
mikimiki88: folds 
king10clubs: folds 
Uncalled bet ($6) returned to LiveTogether
LiveTogether collected $15 from pot
LiveTogether: doesn't show hand 
*** SUMMARY ***
Total pot $15 | Rake $0 
Seat 1: teunuss folded before Flop (didn't bet)
Seat 2: Strz (button) folded before Flop (didn't bet)
Seat 3: mikimiki88 (small blind) folded before Flop
Seat 4: king10clubs (big blind) folded before Flop
Seat 5: baoyi2012 folded before Flop (didn't bet)
Seat 6: LiveTogether collected ($15)


PokerStars Game #102624119778:  Hold'em No Limit ($3/$6 USD) - 2013/08/11 16:42:08 ET
Table 'Crux V 40-100 bb' 6-max Seat #3 is the button
Seat 1: teunuss ($793.85 in chips) 
Seat 2: Strz ($816.10 in chips) 
Seat 3: mikimiki88 ($1358.67 in chips) 
Seat 4: king10clubs ($680.18 in chips) 
Seat 5: baoyi2012 ($396.55 in chips) 
Seat 6: LiveTogether ($249 in chips) 
king10clubs: posts small blind $3
baoyi2012: posts big blind $6
*** HOLE CARDS ***
LiveTogether: folds 
teunuss: raises $9 to $15
Strz: folds 
mikimiki88: folds 
king10clubs: folds 
baoyi2012: folds 
Uncalled bet ($9) returned to teunuss
teunuss collected $15 from pot
teunuss: doesn't show hand 
*** SUMMARY ***
Total pot $15 | Rake $0 
Seat 1: teunuss collected ($15)
Seat 2: Strz folded before Flop (didn't bet)
Seat 3: mikimiki88 (button) folded before Flop (didn't bet)
Seat 4: king10clubs (small blind) folded before Flop
Seat 5: baoyi2012 (big blind) folded before Flop
Seat 6: LiveTogether folded before Flop (didn't bet)


PokerStars Game #102624143281:  Hold'em No Limit ($3/$6 USD) - 2013/08/11 16:42:36 ET
Table 'Crux V 40-100 bb' 6-max Seat #4 is the button
Seat 1: teunuss ($802.85 in chips) 
Seat 2: Strz ($816.10 in chips) 
Seat 3: mikimiki88 ($1358.67 in chips) 
Seat 4: king10clubs ($677.18 in chips) 
Seat 5: baoyi2012 ($390.55 in chips) 
Seat 6: LiveTogether ($249 in chips) 
baoyi2012: posts small blind $3
LiveTogether: posts big blind $6
*** HOLE CARDS ***
teunuss: folds 
Strz: folds 
mikimiki88: folds 
king10clubs: raises $6 to $12
baoyi2012: raises $36 to $48
LiveTogether: folds 
king10clubs: folds 
Uncalled bet ($36) returned to baoyi2012
baoyi2012 collected $30 from pot
*** SUMMARY ***
Total pot $30 | Rake $0 
Seat 1: teunuss folded before Flop (didn't bet)
Seat 2: Strz folded before Flop (didn't bet)
Seat 3: mikimiki88 folded before Flop (didn't bet)
Seat 4: king10clubs (button) folded before Flop
Seat 5: baoyi2012 (small blind) collected ($30)
Seat 6: LiveTogether (big blind) folded before Flop


PokerStars Game #102624162058:  Hold'em No Limit ($3/$6 USD) - 2013/08/11 16:42:59 ET
Table 'Crux V 40-100 bb' 6-max Seat #5 is the button
Seat 1: teunuss ($802.85 in chips) 
Seat 2: Strz ($816.10 in chips) 
Seat 3: mikimiki88 ($1358.67 in chips) 
Seat 4: king10clubs ($665.18 in chips) 
Seat 5: baoyi2012 ($408.55 in chips) 
Seat 6: LiveTogether ($243 in chips) 
LiveTogether: posts small blind $3
teunuss: posts big blind $6
*** HOLE CARDS ***
Strz: folds 
mikimiki88: folds 
king10clubs: folds 
baoyi2012: folds 
LiveTogether: raises $6 to $12
teunuss: calls $6
*** FLOP *** [Tc 4h 3c]
LiveTogether: bets $15
teunuss: calls $15
*** TURN *** [Tc 4h 3c] [Qd]
LiveTogether: bets $44
teunuss: calls $44
*** RIVER *** [Tc 4h 3c Qd] [2d]
LiveTogether: checks 
teunuss: checks 
*** SHOW DOWN ***
LiveTogether: shows [Kd Js] (high card King)
teunuss: mucks hand 
LiveTogether collected $139.20 from pot
*** SUMMARY ***
Total pot $142 | Rake $2.80 
Board [Tc 4h 3c Qd 2d]
Seat 1: teunuss (big blind) mucked
Seat 2: Strz folded before Flop (didn't bet)
Seat 3: mikimiki88 folded before Flop (didn't bet)
Seat 4: king10clubs folded before Flop (didn't bet)
Seat 5: baoyi2012 (button) folded before Flop (didn't bet)
Seat 6: LiveTogether (small blind) showed [Kd Js] and won ($139.20) with high card King


PokerStars Game #102624218712:  Hold'em No Limit ($3/$6 USD) - 2013/08/11 16:44:07 ET
Table 'Crux V 40-100 bb' 6-max Seat #6 is the button
Seat 1: teunuss ($731.85 in chips) 
Seat 2: Strz ($816.10 in chips) 
Seat 3: mikimiki88 ($1358.67 in chips) 
Seat 4: king10clubs ($665.18 in chips) 
Seat 5: baoyi2012 ($408.55 in chips) 
Seat 6: LiveTogether ($311.20 in chips) 
teunuss: posts small blind $3
Strz: posts big blind $6
*** HOLE CARDS ***
mikimiki88: folds 
king10clubs: folds 
baoyi2012: raises $12 to $18
LiveTogether: folds 
teunuss: folds 
Strz: folds 
Uncalled bet ($12) returned to baoyi2012
baoyi2012 collected $15 from pot
*** SUMMARY ***
Total pot $15 | Rake $0 
Seat 1: teunuss (small blind) folded before Flop
Seat 2: Strz (big blind) folded before Flop
Seat 3: mikimiki88 folded before Flop (didn't bet)
Seat 4: king10clubs folded before Flop (didn't bet)
Seat 5: baoyi2012 collected ($15)
Seat 6: LiveTogether (button) folded before Flop (didn't bet)


PokerStars Game #102624240173:  Hold'em No Limit ($3/$6 USD) - 2013/08/11 16:44:33 ET
Table 'Crux V 40-100 bb' 6-max Seat #1 is the button
Seat 1: teunuss ($728.85 in chips) 
Seat 2: Strz ($810.10 in chips) 
Seat 3: mikimiki88 ($1358.67 in chips) 
Seat 4: king10clubs ($665.18 in chips) 
Seat 5: baoyi2012 ($417.55 in chips) 
Seat 6: LiveTogether ($311.20 in chips) 
Strz: posts small blind $3
mikimiki88: posts big blind $6
*** HOLE CARDS ***
king10clubs: raises $9 to $15
baoyi2012: folds 
LiveTogether: folds 
teunuss: folds 
Strz: folds 
mikimiki88: folds 
Uncalled bet ($9) returned to king10clubs
king10clubs collected $15 from pot
king10clubs: doesn't show hand 
*** SUMMARY ***
Total pot $15 | Rake $0 
Seat 1: teunuss (button) folded before Flop (didn't bet)
Seat 2: Strz (small blind) folded before Flop
Seat 3: mikimiki88 (big blind) folded before Flop
Seat 4: king10clubs collected ($15)
Seat 5: baoyi2012 folded before Flop (didn't bet)
Seat 6: LiveTogether folded before Flop (didn't bet)


PokerStars Game #102624256032:  Hold'em No Limit ($3/$6 USD) - 2013/08/11 16:44:52 ET
Table 'Crux V 40-100 bb' 6-max Seat #2 is the button
Seat 1: teunuss ($728.85 in chips) 
Seat 2: Strz ($807.10 in chips) 
Seat 3: mikimiki88 ($1352.67 in chips) 
Seat 4: king10clubs ($674.18 in chips) 
Seat 5: baoyi2012 ($417.55 in chips) 
Seat 6: LiveTogether ($311.20 in chips) 
mikimiki88: posts small blind $3
king10clubs: posts big blind $6
*** HOLE CARDS ***
baoyi2012: raises $6 to $12
LiveTogether: folds 
teunuss: folds 
Strz: raises $30 to $42
mikimiki88: folds 
king10clubs: folds 
baoyi2012: raises $375.55 to $417.55 and is all-in
Strz: folds 
Uncalled bet ($375.55) returned to baoyi2012
baoyi2012 collected $93 from pot
*** SUMMARY ***
Total pot $93 | Rake $0 
Seat 1: teunuss folded before Flop (didn't bet)
Seat 2: Strz (button) folded before Flop
Seat 3: mikimiki88 (small blind) folded before Flop
Seat 4: king10clubs (big blind) folded before Flop
Seat 5: baoyi2012 collected ($93)
Seat 6: LiveTogether folded before Flop (didn't bet)


PokerStars Game #102623777133:  Hold'em No Limit ($3/$6 USD) - 2013/08/11 16:35:20 ET
Table 'Crux V 40-100 bb' 6-max Seat #4 is the button
Seat 1: teunuss ($829.65 in chips) 
Seat 2: Strz ($937.10 in chips) 
Seat 3: mikimiki88 ($1243.62 in chips) 
Seat 4: king10clubs ($610.98 in chips) 
Seat 5: baoyi2012 ($435.20 in chips) 
Seat 6: LiveTogether ($249 in chips) 
baoyi2012: posts small blind $3
LiveTogether: posts big blind $6
*** HOLE CARDS ***
teunuss: raises $12 to $18
Strz: calls $18
mikimiki88: folds 
king10clubs: calls $18
baoyi2012: folds 
LiveTogether: folds 
*** FLOP *** [9c Jc Ad]
teunuss: bets $42
Strz: folds 
king10clubs: calls $42
*** TURN *** [9c Jc Ad] [5d]
teunuss: checks 
king10clubs: bets $84
teunuss: folds 
Uncalled bet ($84) returned to king10clubs
king10clubs collected $144.20 from pot
king10clubs: doesn't show hand 
*** SUMMARY ***
Total pot $147 | Rake $2.80 
Board [9c Jc Ad 5d]
Seat 1: teunuss folded on the Turn
Seat 2: Strz folded on the Flop
Seat 3: mikimiki88 folded before Flop (didn't bet)
Seat 4: king10clubs (button) collected ($144.20)
Seat 5: baoyi2012 (small blind) folded before Flop
Seat 6: LiveTogether (big blind) folded before Flop


PokerStars Game #102623825127:  Hold'em No Limit ($3/$6 USD) - 2013/08/11 16:36:16 ET
Table 'Crux V 40-100 bb' 6-max Seat #5 is the button
Seat 1: teunuss ($769.65 in chips) 
Seat 2: Strz ($919.10 in chips) 
Seat 3: mikimiki88 ($1243.62 in chips) 
Seat 4: king10clubs ($695.18 in chips) 
Seat 5: baoyi2012 ($432.20 in chips) 
Seat 6: LiveTogether ($243 in chips) 
LiveTogether: posts small blind $3
teunuss: posts big blind $6
*** HOLE CARDS ***
Strz: folds 
mikimiki88: folds 
king10clubs: folds 
baoyi2012: raises $12 to $18
LiveTogether: folds 
teunuss: folds 
Uncalled bet ($12) returned to baoyi2012
baoyi2012 collected $15 from pot
*** SUMMARY ***
Total pot $15 | Rake $0 
Seat 1: teunuss (big blind) folded before Flop
Seat 2: Strz folded before Flop (didn't bet)
Seat 3: mikimiki88 folded before Flop (didn't bet)
Seat 4: king10clubs folded before Flop (didn't bet)
Seat 5: baoyi2012 (button) collected ($15)
Seat 6: LiveTogether (small blind) folded before Flop


PokerStars Game #102623841041:  Hold'em No Limit ($3/$6 USD) - 2013/08/11 16:36:35 ET
Table 'Crux V 40-100 bb' 6-max Seat #6 is the button
Seat 1: teunuss ($763.65 in chips) 
Seat 2: Strz ($919.10 in chips) 
Seat 3: mikimiki88 ($1243.62 in chips) 
Seat 4: king10clubs ($695.18 in chips) 
Seat 5: baoyi2012 ($441.20 in chips) 
Seat 6: LiveTogether ($240 in chips) 
teunuss: posts small blind $3
Strz: posts big blind $6
*** HOLE CARDS ***
mikimiki88: raises $12 to $18
king10clubs: folds 
baoyi2012: calls $18
LiveTogether: folds 
teunuss: folds 
Strz: calls $12
*** FLOP *** [Kh Qd 3d]
Strz: checks 
mikimiki88: bets $38.65
baoyi2012: calls $38.65
Strz: folds 
*** TURN *** [Kh Qd 3d] [Ad]
mikimiki88: bets $102
baoyi2012: folds 
Uncalled bet ($102) returned to mikimiki88
mikimiki88 collected $131.50 from pot
mikimiki88: doesn't show hand 
*** SUMMARY ***
Total pot $134.30 | Rake $2.80 
Board [Kh Qd 3d Ad]
Seat 1: teunuss (small blind) folded before Flop
Seat 2: Strz (big blind) folded on the Flop
Seat 3: mikimiki88 collected ($131.50)
Seat 4: king10clubs folded before Flop (didn't bet)
Seat 5: baoyi2012 folded on the Turn
Seat 6: LiveTogether (button) folded before Flop (didn't bet)


PokerStars Game #102623898324:  Hold'em No Limit ($3/$6 USD) - 2013/08/11 16:37:43 ET
Table 'Crux V 40-100 bb' 6-max Seat #1 is the button
Seat 1: teunuss ($760.65 in chips) 
Seat 2: Strz ($901.10 in chips) 
Seat 3: mikimiki88 ($1318.47 in chips) 
Seat 4: king10clubs ($695.18 in chips) 
Seat 5: baoyi2012 ($384.55 in chips) 
Seat 6: LiveTogether ($240 in chips) 
Strz: posts small blind $3
mikimiki88: posts big blind $6
*** HOLE CARDS ***
king10clubs: folds 
baoyi2012: folds 
LiveTogether: raises $6 to $12
teunuss: folds 
Strz: folds 
mikimiki88: folds 
Uncalled bet ($6) returned to LiveTogether
LiveTogether collected $15 from pot
LiveTogether: doesn't show hand 
*** SUMMARY ***
Total pot $15 | Rake $0 
Seat 1: teunuss (button) folded before Flop (didn't bet)
Seat 2: Strz (small blind) folded before Flop
Seat 3: mikimiki88 (big blind) folded before Flop
Seat 4: king10clubs folded before Flop (didn't bet)
Seat 5: baoyi2012 folded before Flop (didn't bet)
Seat 6: LiveTogether collected ($15)


PokerStars Game #102623913557:  Hold'em No Limit ($3/$6 USD) - 2013/08/11 16:38:01 ET
Table 'Crux V 40-100 bb' 6-max Seat #2 is the button
Seat 1: teunuss ($760.65 in chips) 
Seat 2: Strz ($898.10 in chips) 
Seat 3: mikimiki88 ($1312.47 in chips) 
Seat 4: king10clubs ($695.18 in chips) 
Seat 5: baoyi2012 ($384.55 in chips) 
Seat 6: LiveTogether ($249 in chips) 
mikimiki88: posts small blind $3
king10clubs: posts big blind $6
*** HOLE CARDS ***
baoyi2012: folds 
LiveTogether: folds 
teunuss: folds 
Strz: raises $6 to $12
mikimiki88: folds 
king10clubs: folds 
Uncalled bet ($6) returned to Strz
Strz collected $15 from pot
*** SUMMARY ***
Total pot $15 | Rake $0 
Seat 1: teunuss folded before Flop (didn't bet)
Seat 2: Strz (button) collected ($15)
Seat 3: mikimiki88 (small blind) folded before Flop
Seat 4: king10clubs (big blind) folded before Flop
Seat 5: baoyi2012 folded before Flop (didn't bet)
Seat 6: LiveTogether folded before Flop (didn't bet)


PokerStars Game #102623936483:  Hold'em No Limit ($3/$6 USD) - 2013/08/11 16:38:28 ET
Table 'Crux V 40-100 bb' 6-max Seat #3 is the button
Seat 1: teunuss ($760.65 in chips) 
Seat 2: Strz ($907.10 in chips) 
Seat 3: mikimiki88 ($1309.47 in chips) 
Seat 4: king10clubs ($689.18 in chips) 
Seat 5: baoyi2012 ($384.55 in chips) 
Seat 6: LiveTogether ($249 in chips) 
king10clubs: posts small blind $3
baoyi2012: posts big blind $6
*** HOLE CARDS ***
LiveTogether: folds 
teunuss: folds 
Strz: folds 
mikimiki88: raises $6 to $12
king10clubs: folds 
baoyi2012: raises $42 to $54
mikimiki88: folds 
Uncalled bet ($42) returned to baoyi2012
baoyi2012 collected $27 from pot
*** SUMMARY ***
Total pot $27 | Rake $0 
Seat 1: teunuss folded before Flop (didn't bet)
Seat 2: Strz folded before Flop (didn't bet)
Seat 3: mikimiki88 (button) folded before Flop
Seat 4: king10clubs (small blind) folded before Flop
Seat 5: baoyi2012 (big blind) collected ($27)
Seat 6: LiveTogether folded before Flop (didn't bet)


PokerStars Game #102623963588:  Hold'em No Limit ($3/$6 USD) - 2013/08/11 16:39:01 ET
Table 'Crux V 40-100 bb' 6-max Seat #4 is the button
Seat 1: teunuss ($760.65 in chips) 
Seat 2: Strz ($907.10 in chips) 
Seat 3: mikimiki88 ($1297.47 in chips) 
Seat 4: king10clubs ($686.18 in chips) 
Seat 5: baoyi2012 ($399.55 in chips) 
Seat 6: LiveTogether ($249 in chips) 
baoyi2012: posts small blind $3
LiveTogether: posts big blind $6
*** HOLE CARDS ***
teunuss: folds 
Strz: raises $12 to $18
mikimiki88: raises $28 to $46
king10clubs: folds 
baoyi2012: folds 
LiveTogether: folds 
Strz: calls $28
*** FLOP *** [Qd 4h 5c]
Strz: checks 
mikimiki88: bets $60
Strz: folds 
Uncalled bet ($60) returned to mikimiki88
mikimiki88 collected $98.20 from pot
mikimiki88: doesn't show hand 
*** SUMMARY ***
Total pot $101 | Rake $2.80 
Board [Qd 4h 5c]
Seat 1: teunuss folded before Flop (didn't bet)
Seat 2: Strz folded on the Flop
Seat 3: mikimiki88 collected ($98.20)
Seat 4: king10clubs (button) folded before Flop (didn't bet)
Seat 5: baoyi2012 (small blind) folded before Flop
Seat 6: LiveTogether (big blind) folded before Flop


PokerStars Game #102624001941:  Hold'em No Limit ($3/$6 USD) - 2013/08/11 16:39:46 ET
Table 'Crux V 40-100 bb' 6-max Seat #5 is the button
Seat 1: teunuss ($760.65 in chips) 
Seat 2: Strz ($861.10 in chips) 
Seat 3: mikimiki88 ($1349.67 in chips) 
Seat 4: king10clubs ($686.18 in chips) 
Seat 5: baoyi2012 ($396.55 in chips) 
Seat 6: LiveTogether ($243 in chips) 
LiveTogether: posts small blind $3
teunuss: posts big blind $6
*** HOLE CARDS ***
Strz: folds 
mikimiki88: raises $9 to $15
king10clubs: folds 
baoyi2012: folds 
LiveTogether: folds 
teunuss: folds 
Uncalled bet ($9) returned to mikimiki88
mikimiki88 collected $15 from pot
mikimiki88: doesn't show hand 
*** SUMMARY ***
Total pot $15 | Rake $0 
Seat 1: teunuss (big blind) folded before Flop
Seat 2: Strz folded before Flop (didn't bet)
Seat 3: mikimiki88 collected ($15)
Seat 4: king10clubs folded before Flop (didn't bet)
Seat 5: baoyi2012 (button) folded before Flop (didn't bet)
Seat 6: LiveTogether (small blind) folded before Flop


PokerStars Game #102623536818:  Hold'em No Limit ($3/$6 USD) - 2013/08/11 16:30:39 ET
Table 'Crux V 40-100 bb' 6-max Seat #3 is the button
Seat 1: teunuss ($745.45 in chips) 
Seat 2: Strz ($909.40 in chips) 
Seat 3: mikimiki88 ($1285.42 in chips) 
Seat 4: king10clubs ($628.98 in chips) 
Seat 5: baoyi2012 ($495.20 in chips) 
Seat 6: LiveTogether ($240 in chips) 
king10clubs: posts small blind $3
baoyi2012: posts big blind $6
*** HOLE CARDS ***
LiveTogether: folds 
teunuss: raises $9 to $15
Strz: folds 
mikimiki88: raises $24 to $39
king10clubs: folds 
baoyi2012: folds 
teunuss: calls $24
*** FLOP *** [3h 8s Ad]
teunuss: checks 
mikimiki88: bets $48
teunuss: calls $48
*** TURN *** [3h 8s Ad] [7s]
teunuss: checks 
mikimiki88: checks 
*** RIVER *** [3h 8s Ad 7s] [6s]
teunuss: checks 
mikimiki88: checks 
*** SHOW DOWN ***
teunuss: shows [Js Jc] (a pair of Jacks)
mikimiki88: mucks hand 
teunuss collected $180.20 from pot
*** SUMMARY ***
Total pot $183 | Rake $2.80 
Board [3h 8s Ad 7s 6s]
Seat 1: teunuss showed [Js Jc] and won ($180.20) with a pair of Jacks
Seat 2: Strz folded before Flop (didn't bet)
Seat 3: mikimiki88 (button) mucked
Seat 4: king10clubs (small blind) folded before Flop
Seat 5: baoyi2012 (big blind) folded before Flop
Seat 6: LiveTogether folded before Flop (didn't bet)


PokerStars Game #102623593360:  Hold'em No Limit ($3/$6 USD) - 2013/08/11 16:31:45 ET
Table 'Crux V 40-100 bb' 6-max Seat #4 is the button
Seat 1: teunuss ($838.65 in chips) 
Seat 2: Strz ($909.40 in chips) 
Seat 3: mikimiki88 ($1198.42 in chips) 
Seat 4: king10clubs ($625.98 in chips) 
Seat 5: baoyi2012 ($489.20 in chips) 
Seat 6: LiveTogether ($240 in chips) 
baoyi2012: posts small blind $3
LiveTogether: posts big blind $6
*** HOLE CARDS ***
teunuss: folds 
Strz: folds 
mikimiki88: raises $6 to $12
king10clubs: folds 
baoyi2012: folds 
LiveTogether: folds 
Uncalled bet ($6) returned to mikimiki88
mikimiki88 collected $15 from pot
mikimiki88: doesn't show hand 
*** SUMMARY ***
Total pot $15 | Rake $0 
Seat 1: teunuss folded before Flop (didn't bet)
Seat 2: Strz folded before Flop (didn't bet)
Seat 3: mikimiki88 collected ($15)
Seat 4: king10clubs (button) folded before Flop (didn't bet)
Seat 5: baoyi2012 (small blind) folded before Flop
Seat 6: LiveTogether (big blind) folded before Flop


PokerStars Game #102623609070:  Hold'em No Limit ($3/$6 USD) - 2013/08/11 16:32:04 ET
Table 'Crux V 40-100 bb' 6-max Seat #5 is the button
Seat 1: teunuss ($838.65 in chips) 
Seat 2: Strz ($909.40 in chips) 
Seat 3: mikimiki88 ($1207.42 in chips) 
Seat 4: king10clubs ($625.98 in chips) 
Seat 5: baoyi2012 ($486.20 in chips) 
Seat 6: LiveTogether ($240 in chips) 
LiveTogether: posts small blind $3
teunuss: posts big blind $6
*** HOLE CARDS ***
Strz: folds 
mikimiki88: folds 
king10clubs: raises $9 to $15
baoyi2012: folds 
LiveTogether: folds 
teunuss: folds 
Uncalled bet ($9) returned to king10clubs
king10clubs collected $15 from pot
king10clubs: doesn't show hand 
*** SUMMARY ***
Total pot $15 | Rake $0 
Seat 1: teunuss (big blind) folded before Flop
Seat 2: Strz folded before Flop (didn't bet)
Seat 3: mikimiki88 folded before Flop (didn't bet)
Seat 4: king10clubs collected ($15)
Seat 5: baoyi2012 (button) folded before Flop (didn't bet)
Seat 6: LiveTogether (small blind) folded before Flop


PokerStars Game #102623623340:  Hold'em No Limit ($3/$6 USD) - 2013/08/11 16:32:20 ET
Table 'Crux V 40-100 bb' 6-max Seat #6 is the button
Seat 1: teunuss ($832.65 in chips) 
Seat 2: Strz ($909.40 in chips) 
Seat 3: mikimiki88 ($1207.42 in chips) 
Seat 4: king10clubs ($634.98 in chips) 
Seat 5: baoyi2012 ($486.20 in chips) 
Seat 6: LiveTogether ($240 in chips) 
teunuss: posts small blind $3
Strz: posts big blind $6
*** HOLE CARDS ***
mikimiki88: raises $12 to $18
king10clubs: folds 
baoyi2012: folds 
LiveTogether: folds 
teunuss: folds 
Strz: folds 
Uncalled bet ($12) returned to mikimiki88
mikimiki88 collected $15 from pot
mikimiki88: doesn't show hand 
*** SUMMARY ***
Total pot $15 | Rake $0 
Seat 1: teunuss (small blind) folded before Flop
Seat 2: Strz (big blind) folded before Flop
Seat 3: mikimiki88 collected ($15)
Seat 4: king10clubs folded before Flop (didn't bet)
Seat 5: baoyi2012 folded before Flop (didn't bet)
Seat 6: LiveTogether (button) folded before Flop (didn't bet)


PokerStars Game #102623646258:  Hold'em No Limit ($3/$6 USD) - 2013/08/11 16:32:47 ET
Table 'Crux V 40-100 bb' 6-max Seat #1 is the button
Seat 1: teunuss ($829.65 in chips) 
Seat 2: Strz ($903.40 in chips) 
Seat 3: mikimiki88 ($1216.42 in chips) 
Seat 4: king10clubs ($634.98 in chips) 
Seat 5: baoyi2012 ($486.20 in chips) 
Seat 6: LiveTogether ($240 in chips) 
Strz: posts small blind $3
mikimiki88: posts big blind $6
*** HOLE CARDS ***
king10clubs: raises $9 to $15
baoyi2012: calls $15
LiveTogether: folds 
teunuss: folds 
Strz: calls $12
mikimiki88: folds 
*** FLOP *** [5d Th Kh]
Strz: bets $42
king10clubs: folds 
baoyi2012: folds 
Uncalled bet ($42) returned to Strz
Strz collected $48.70 from pot
*** SUMMARY ***
Total pot $51 | Rake $2.30 
Board [5d Th Kh]
Seat 1: teunuss (button) folded before Flop (didn't bet)
Seat 2: Strz (small blind) collected ($48.70)
Seat 3: mikimiki88 (big blind) folded before Flop
Seat 4: king10clubs folded on the Flop
Seat 5: baoyi2012 folded on the Flop
Seat 6: LiveTogether folded before Flop (didn't bet)


PokerStars Game #102623676283:  Hold'em No Limit ($3/$6 USD) - 2013/08/11 16:33:22 ET
Table 'Crux V 40-100 bb' 6-max Seat #2 is the button
Seat 1: teunuss ($829.65 in chips) 
Seat 2: Strz ($937.10 in chips) 
Seat 3: mikimiki88 ($1210.42 in chips) 
Seat 4: king10clubs ($619.98 in chips) 
Seat 5: baoyi2012 ($471.20 in chips) 
Seat 6: LiveTogether ($240 in chips) 
mikimiki88: posts small blind $3
king10clubs: posts big blind $6
*** HOLE CARDS ***
baoyi2012: folds 
LiveTogether: raises $6 to $12
teunuss: folds 
Strz: folds 
mikimiki88: folds 
king10clubs: folds 
Uncalled bet ($6) returned to LiveTogether
LiveTogether collected $15 from pot
LiveTogether: doesn't show hand 
*** SUMMARY ***
Total pot $15 | Rake $0 
Seat 1: teunuss folded before Flop (didn't bet)
Seat 2: Strz (button) folded before Flop (didn't bet)
Seat 3: mikimiki88 (small blind) folded before Flop
Seat 4: king10clubs (big blind) folded before Flop
Seat 5: baoyi2012 folded before Flop (didn't bet)
Seat 6: LiveTogether collected ($15)


PokerStars Game #102623692622:  Hold'em No Limit ($3/$6 USD) - 2013/08/11 16:33:41 ET
Table 'Crux V 40-100 bb' 6-max Seat #3 is the button
Seat 1: teunuss ($829.65 in chips) 
Seat 2: Strz ($937.10 in chips) 
Seat 3: mikimiki88 ($1207.42 in chips) 
Seat 4: king10clubs ($613.98 in chips) 
Seat 5: baoyi2012 ($471.20 in chips) 
Seat 6: LiveTogether ($249 in chips) 
king10clubs: posts small blind $3
baoyi2012: posts big blind $6
*** HOLE CARDS ***
LiveTogether: folds 
teunuss has timed out
teunuss: folds 
Strz: folds 
mikimiki88: raises $6 to $12
king10clubs: folds 
baoyi2012: calls $6
*** FLOP *** [Ah 8h 8c]
baoyi2012: checks 
mikimiki88: checks 
*** TURN *** [Ah 8h 8c] [2c]
baoyi2012: bets $24
mikimiki88: calls $24
*** RIVER *** [Ah 8h 8c 2c] [5h]
baoyi2012: checks 
mikimiki88: bets $54
baoyi2012: folds 
Uncalled bet ($54) returned to mikimiki88
mikimiki88 collected $72.20 from pot
mikimiki88: doesn't show hand 
*** SUMMARY ***
Total pot $75 | Rake $2.80 
Board [Ah 8h 8c 2c 5h]
Seat 1: teunuss folded before Flop (didn't bet)
Seat 2: Strz folded before Flop (didn't bet)
Seat 3: mikimiki88 (button) collected ($72.20)
Seat 4: king10clubs (small blind) folded before Flop
Seat 5: baoyi2012 (big blind) folded on the River
Seat 6: LiveTogether folded before Flop (didn't bet)


PokerStars Game #102623272175:  Hold'em No Limit ($3/$6 USD) - 2013/08/11 16:25:24 ET
Table 'Crux V 40-100 bb' 6-max Seat #4 is the button
Seat 1: teunuss ($744.01 in chips) 
Seat 2: Strz ($837.20 in chips) 
Seat 3: mikimiki88 ($1240.22 in chips) 
Seat 4: king10clubs ($634.98 in chips) 
baoyi2012 will be allowed to play after the button
LiveTogether will be allowed to play after the button
teunuss: posts small blind $3
Strz: posts big blind $6
*** HOLE CARDS ***
mikimiki88: folds 
king10clubs: raises $6 to $12
teunuss: folds 
Strz: folds 
Uncalled bet ($6) returned to king10clubs
king10clubs collected $15 from pot
king10clubs: doesn't show hand 
*** SUMMARY ***
Total pot $15 | Rake $0 
Seat 1: teunuss (small blind) folded before Flop
Seat 2: Strz (big blind) folded before Flop
Seat 3: mikimiki88 folded before Flop (didn't bet)
Seat 4: king10clubs (button) collected ($15)


PokerStars Game #102623279979:  Hold'em No Limit ($3/$6 USD) - 2013/08/11 16:25:33 ET
Table 'Crux V 40-100 bb' 6-max Seat #1 is the button
Seat 1: teunuss ($741.01 in chips) 
Seat 2: Strz ($831.20 in chips) 
Seat 3: mikimiki88 ($1240.22 in chips) 
Seat 4: king10clubs ($643.98 in chips) 
Strz: posts small blind $3
mikimiki88: posts big blind $6
baoyi2012: sits out 
LiveTogether: sits out 
*** HOLE CARDS ***
king10clubs: folds 
teunuss: raises $6 to $12
Strz: raises $36 to $48
mikimiki88: folds 
teunuss: folds 
Uncalled bet ($36) returned to Strz
Strz collected $30 from pot
*** SUMMARY ***
Total pot $30 | Rake $0 
Seat 1: teunuss (button) folded before Flop
Seat 2: Strz (small blind) collected ($30)
Seat 3: mikimiki88 (big blind) folded before Flop
Seat 4: king10clubs folded before Flop (didn't bet)


PokerStars Game #102623297266:  Hold'em No Limit ($3/$6 USD) - 2013/08/11 16:25:54 ET
Table 'Crux V 40-100 bb' 6-max Seat #2 is the button
Seat 1: teunuss ($729.01 in chips) 
Seat 2: Strz ($849.20 in chips) 
Seat 3: mikimiki88 ($1234.22 in chips) 
Seat 4: king10clubs ($643.98 in chips) 
Seat 5: baoyi2012 ($600 in chips) 
mikimiki88: posts small blind $3
king10clubs: posts big blind $6
baoyi2012: posts big blind $6
LiveTogether: sits out 
*** HOLE CARDS ***
baoyi2012: raises $12 to $18
teunuss: calls $18
Strz: folds 
mikimiki88: folds 
king10clubs: folds 
*** FLOP *** [Tc 7s 3d]
baoyi2012: checks 
teunuss: bets $30
baoyi2012: calls $30
*** TURN *** [Tc 7s 3d] [Qh]
baoyi2012: bets $90
teunuss: folds 
Uncalled bet ($90) returned to baoyi2012
baoyi2012 collected $102.20 from pot
*** SUMMARY ***
Total pot $105 | Rake $2.80 
Board [Tc 7s 3d Qh]
Seat 1: teunuss folded on the Turn
Seat 2: Strz (button) folded before Flop (didn't bet)
Seat 3: mikimiki88 (small blind) folded before Flop
Seat 4: king10clubs (big blind) folded before Flop
Seat 5: baoyi2012 collected ($102.20)


PokerStars Game #102623343826:  Hold'em No Limit ($3/$6 USD) - 2013/08/11 16:26:49 ET
Table 'Crux V 40-100 bb' 6-max Seat #3 is the button
Seat 1: teunuss ($681.01 in chips) 
Seat 2: Strz ($849.20 in chips) 
Seat 3: mikimiki88 ($1231.22 in chips) 
Seat 4: king10clubs ($637.98 in chips) 
Seat 5: baoyi2012 ($654.20 in chips) 
king10clubs: posts small blind $3
baoyi2012: posts big blind $6
LiveTogether: sits out 
*** HOLE CARDS ***
teunuss: raises $9 to $15
Strz: folds 
mikimiki88: calls $15
king10clubs: folds 
baoyi2012: folds 
*** FLOP *** [Kd 7s 9d]
teunuss: bets $27
mikimiki88: folds 
Uncalled bet ($27) returned to teunuss
teunuss collected $37.24 from pot
teunuss: doesn't show hand 
*** SUMMARY ***
Total pot $39 | Rake $1.76 
Board [Kd 7s 9d]
Seat 1: teunuss collected ($37.24)
Seat 2: Strz folded before Flop (didn't bet)
Seat 3: mikimiki88 (button) folded on the Flop
Seat 4: king10clubs (small blind) folded before Flop
Seat 5: baoyi2012 (big blind) folded before Flop


PokerStars Game #102623371681:  Hold'em No Limit ($3/$6 USD) - 2013/08/11 16:27:22 ET
Table 'Crux V 40-100 bb' 6-max Seat #4 is the button
Seat 1: teunuss ($703.25 in chips) 
Seat 2: Strz ($849.20 in chips) 
Seat 3: mikimiki88 ($1216.22 in chips) 
Seat 4: king10clubs ($634.98 in chips) 
Seat 5: baoyi2012 ($648.20 in chips) 
Seat 6: LiveTogether ($240 in chips) 
baoyi2012: posts small blind $3
LiveTogether: posts big blind $6
*** HOLE CARDS ***
teunuss: raises $12 to $18
Strz: folds 
mikimiki88: folds 
king10clubs: folds 
baoyi2012: calls $15
LiveTogether: folds 
*** FLOP *** [Qd 2h Tc]
baoyi2012: checks 
teunuss: bets $30
baoyi2012: calls $30
*** TURN *** [Qd 2h Tc] [5d]
baoyi2012: checks 
teunuss: bets $150
baoyi2012: folds 
Uncalled bet ($150) returned to teunuss
teunuss collected $99.20 from pot
teunuss: doesn't show hand 
*** SUMMARY ***
Total pot $102 | Rake $2.80 
Board [Qd 2h Tc 5d]
Seat 1: teunuss collected ($99.20)
Seat 2: Strz folded before Flop (didn't bet)
Seat 3: mikimiki88 folded before Flop (didn't bet)
Seat 4: king10clubs (button) folded before Flop (didn't bet)
Seat 5: baoyi2012 (small blind) folded on the Turn
Seat 6: LiveTogether (big blind) folded before Flop


PokerStars Game #102623415592:  Hold'em No Limit ($3/$6 USD) - 2013/08/11 16:28:15 ET
Table 'Crux V 40-100 bb' 6-max Seat #5 is the button
Seat 1: teunuss ($754.45 in chips) 
Seat 2: Strz ($849.20 in chips) 
Seat 3: mikimiki88 ($1216.22 in chips) 
Seat 4: king10clubs ($634.98 in chips) 
Seat 5: baoyi2012 ($600.20 in chips) 
Seat 6: LiveTogether ($240 in chips) 
LiveTogether: posts small blind $3
teunuss: posts big blind $6
*** HOLE CARDS ***
Strz: folds 
mikimiki88: folds 
king10clubs: folds 
baoyi2012: raises $6 to $12
LiveTogether: folds 
teunuss: folds 
Uncalled bet ($6) returned to baoyi2012
baoyi2012 collected $15 from pot
*** SUMMARY ***
Total pot $15 | Rake $0 
Seat 1: teunuss (big blind) folded before Flop
Seat 2: Strz folded before Flop (didn't bet)
Seat 3: mikimiki88 folded before Flop (didn't bet)
Seat 4: king10clubs folded before Flop (didn't bet)
Seat 5: baoyi2012 (button) collected ($15)
Seat 6: LiveTogether (small blind) folded before Flop


PokerStars Game #102623429308:  Hold'em No Limit ($3/$6 USD) - 2013/08/11 16:28:31 ET
Table 'Crux V 40-100 bb' 6-max Seat #6 is the button
Seat 1: teunuss ($748.45 in chips) 
Seat 2: Strz ($849.20 in chips) 
Seat 3: mikimiki88 ($1216.22 in chips) 
Seat 4: king10clubs ($634.98 in chips) 
Seat 5: baoyi2012 ($609.20 in chips) 
Seat 6: LiveTogether ($240 in chips) 
teunuss: posts small blind $3
Strz: posts big blind $6
*** HOLE CARDS ***
mikimiki88: folds 
king10clubs: folds 
baoyi2012: folds 
LiveTogether: raises $6 to $12
teunuss: folds 
Strz: raises $30 to $42
LiveTogether: folds 
Uncalled bet ($30) returned to Strz
Strz collected $27 from pot
*** SUMMARY ***
Total pot $27 | Rake $0 
Seat 1: teunuss (small blind) folded before Flop
Seat 2: Strz (big blind) collected ($27)
Seat 3: mikimiki88 folded before Flop (didn't bet)
Seat 4: king10clubs folded before Flop (didn't bet)
Seat 5: baoyi2012 folded before Flop (didn't bet)
Seat 6: LiveTogether (button) folded before Flop


PokerStars Game #102623446034:  Hold'em No Limit ($3/$6 USD) - 2013/08/11 16:28:52 ET
Table 'Crux V 40-100 bb' 6-max Seat #1 is the button
Seat 1: teunuss ($745.45 in chips) 
Seat 2: Strz ($864.20 in chips) 
Seat 3: mikimiki88 ($1216.22 in chips) 
Seat 4: king10clubs ($634.98 in chips) 
Seat 5: baoyi2012 ($609.20 in chips) 
Seat 6: LiveTogether ($240 in chips) 
Strz: posts small blind $3
mikimiki88: posts big blind $6
*** HOLE CARDS ***
king10clubs: folds 
baoyi2012: raises $12 to $18
LiveTogether: folds 
teunuss: folds 
Strz: calls $15
mikimiki88: folds 
*** FLOP *** [Kd 7d Jd]
Strz: checks 
baoyi2012: bets $42
Strz: calls $42
*** TURN *** [Kd 7d Jd] [4c]
Strz: checks 
baoyi2012: checks 
*** RIVER *** [Kd 7d Jd 4c] [6s]
Strz: bets $54
baoyi2012: calls $54
*** SHOW DOWN ***
Strz: shows [Qs Ks] (a pair of Kings)
baoyi2012: mucks hand 
Strz collected $231.20 from pot
*** SUMMARY ***
Total pot $234 | Rake $2.80 
Board [Kd 7d Jd 4c 6s]
Seat 1: teunuss (button) folded before Flop (didn't bet)
Seat 2: Strz (small blind) showed [Qs Ks] and won ($231.20) with a pair of Kings
Seat 3: mikimiki88 (big blind) folded before Flop
Seat 4: king10clubs folded before Flop (didn't bet)
Seat 5: baoyi2012 mucked
Seat 6: LiveTogether folded before Flop (didn't bet)


PokerStars Game #102623486687:  Hold'em No Limit ($3/$6 USD) - 2013/08/11 16:29:40 ET
Table 'Crux V 40-100 bb' 6-max Seat #2 is the button
Seat 1: teunuss ($745.45 in chips) 
Seat 2: Strz ($981.40 in chips) 
Seat 3: mikimiki88 ($1210.22 in chips) 
Seat 4: king10clubs ($634.98 in chips) 
Seat 5: baoyi2012 ($495.20 in chips) 
Seat 6: LiveTogether ($240 in chips) 
mikimiki88: posts small blind $3
king10clubs: posts big blind $6
*** HOLE CARDS ***
baoyi2012: folds 
LiveTogether: folds 
teunuss: folds 
Strz: raises $6 to $12
mikimiki88: calls $9
king10clubs: folds 
*** FLOP *** [2d 9h 2s]
mikimiki88: checks 
Strz: bets $18
mikimiki88: calls $18
*** TURN *** [2d 9h 2s] [5s]
mikimiki88: checks 
Strz: bets $42
mikimiki88: calls $42
*** RIVER *** [2d 9h 2s 5s] [2c]
mikimiki88: checks 
Strz: checks 
*** SHOW DOWN ***
mikimiki88: shows [Ks Ah] (three of a kind, Deuces)
Strz: mucks hand 
mikimiki88 collected $147.20 from pot
*** SUMMARY ***
Total pot $150 | Rake $2.80 
Board [2d 9h 2s 5s 2c]
Seat 1: teunuss folded before Flop (didn't bet)
Seat 2: Strz (button) mucked
Seat 3: mikimiki88 (small blind) showed [Ks Ah] and won ($147.20) with three of a kind, Deuces
Seat 4: king10clubs (big blind) folded before Flop
Seat 5: baoyi2012 folded before Flop (didn't bet)
Seat 6: LiveTogether folded before Flop (didn't bet)


PokerStars Game #102623013848:  Hold'em No Limit ($3/$6 USD) - 2013/08/11 16:20:22 ET
Table 'Crux V 40-100 bb' 6-max Seat #4 is the button
Seat 1: teunuss ($905.20 in chips) 
Seat 3: mikimiki88 ($853.47 in chips) 
Seat 4: king10clubs ($722.98 in chips) 
Seat 5: tera789 ($166.25 in chips) 
Seat 6: pindrokk ($600 in chips) 
tera789: posts small blind $3
pindrokk: posts big blind $6
Flying Smile: sits out 
*** HOLE CARDS ***
teunuss: raises $12 to $18
mikimiki88: folds 
king10clubs: folds 
tera789: calls $15
pindrokk: folds 
*** FLOP *** [2c Jh Jc]
tera789: checks 
teunuss: bets $27
tera789: folds 
Uncalled bet ($27) returned to teunuss
teunuss collected $40.11 from pot
teunuss: doesn't show hand 
*** SUMMARY ***
Total pot $42 | Rake $1.89 
Board [2c Jh Jc]
Seat 1: teunuss collected ($40.11)
Seat 3: mikimiki88 folded before Flop (didn't bet)
Seat 4: king10clubs (button) folded before Flop (didn't bet)
Seat 5: tera789 (small blind) folded on the Flop
Seat 6: pindrokk (big blind) folded before Flop


PokerStars Game #102623044714:  Hold'em No Limit ($3/$6 USD) - 2013/08/11 16:20:58 ET
Table 'Crux V 40-100 bb' 6-max Seat #5 is the button
Seat 1: teunuss ($927.31 in chips) 
Seat 3: mikimiki88 ($853.47 in chips) 
Seat 4: king10clubs ($722.98 in chips) 
Seat 5: tera789 ($148.25 in chips) 
Seat 6: pindrokk ($600 in chips) 
pindrokk: posts small blind $3
teunuss: posts big blind $6
Flying Smile: sits out 
*** HOLE CARDS ***
mikimiki88: raises $9 to $15
king10clubs: folds 
tera789: calls $15
pindrokk: folds 
teunuss: folds 
*** FLOP *** [Qd 6d Jc]
mikimiki88: checks 
tera789: bets $30
mikimiki88: calls $30
*** TURN *** [Qd 6d Jc] [9s]
mikimiki88: checks 
tera789: bets $103.25 and is all-in
mikimiki88: calls $103.25
*** RIVER *** [Qd 6d Jc 9s] [8h]
*** SHOW DOWN ***
mikimiki88: shows [Qh As] (a pair of Queens)
tera789: mucks hand 
mikimiki88 collected $302.70 from pot
*** SUMMARY ***
Total pot $305.50 | Rake $2.80 
Board [Qd 6d Jc 9s 8h]
Seat 1: teunuss (big blind) folded before Flop
Seat 3: mikimiki88 showed [Qh As] and won ($302.70) with a pair of Queens
Seat 4: king10clubs folded before Flop (didn't bet)
Seat 5: tera789 (button) mucked
Seat 6: pindrokk (small blind) folded before Flop


PokerStars Game #102623089596:  Hold'em No Limit ($3/$6 USD) - 2013/08/11 16:21:49 ET
Table 'Crux V 40-100 bb' 6-max Seat #6 is the button
Seat 1: teunuss ($921.31 in chips) 
Seat 2: Flying Smile ($600 in chips) 
Seat 3: mikimiki88 ($1007.92 in chips) 
Seat 4: king10clubs ($722.98 in chips) 
Seat 6: pindrokk ($600 in chips) 
teunuss: posts small blind $3
Flying Smile: posts big blind $6
*** HOLE CARDS ***
mikimiki88: folds 
tera789 leaves the table
king10clubs: folds 
pindrokk: folds 
teunuss: folds 
Uncalled bet ($3) returned to Flying Smile
Flying Smile collected $6 from pot
*** SUMMARY ***
Total pot $6 | Rake $0 
Seat 1: teunuss (small blind) folded before Flop
Seat 2: Flying Smile (big blind) collected ($6)
Seat 3: mikimiki88 folded before Flop (didn't bet)
Seat 4: king10clubs folded before Flop (didn't bet)
Seat 6: pindrokk (button) folded before Flop (didn't bet)


PokerStars Game #102623099807:  Hold'em No Limit ($3/$6 USD) - 2013/08/11 16:22:01 ET
Table 'Crux V 40-100 bb' 6-max Seat #1 is the button
Seat 1: teunuss ($918.31 in chips) 
Seat 2: Flying Smile ($603 in chips) 
Seat 3: mikimiki88 ($1007.92 in chips) 
Seat 4: king10clubs ($722.98 in chips) 
Seat 6: pindrokk ($600 in chips) 
Flying Smile: posts small blind $3
mikimiki88: posts big blind $6
*** HOLE CARDS ***
king10clubs: folds 
pindrokk: folds 
teunuss: raises $6 to $12
Flying Smile: raises $33 to $45
mikimiki88: folds 
teunuss: folds 
Uncalled bet ($33) returned to Flying Smile
Flying Smile collected $30 from pot
*** SUMMARY ***
Total pot $30 | Rake $0 
Seat 1: teunuss (button) folded before Flop
Seat 2: Flying Smile (small blind) collected ($30)
Seat 3: mikimiki88 (big blind) folded before Flop
Seat 4: king10clubs folded before Flop (didn't bet)
Seat 6: pindrokk folded before Flop (didn't bet)


PokerStars Game #102623121979:  Hold'em No Limit ($3/$6 USD) - 2013/08/11 16:22:27 ET
Table 'Crux V 40-100 bb' 6-max Seat #2 is the button
Seat 1: teunuss ($906.31 in chips) 
Seat 2: Flying Smile ($621 in chips) 
Seat 3: mikimiki88 ($1001.92 in chips) 
Seat 4: king10clubs ($722.98 in chips) 
Seat 6: pindrokk ($600 in chips) 
mikimiki88: posts small blind $3
king10clubs: posts big blind $6
*** HOLE CARDS ***
pindrokk: raises $7.50 to $13.50
teunuss: folds 
Flying Smile: folds 
mikimiki88: folds 
king10clubs: folds 
Uncalled bet ($7.50) returned to pindrokk
pindrokk collected $15 from pot
pindrokk: doesn't show hand 
*** SUMMARY ***
Total pot $15 | Rake $0 
Seat 1: teunuss folded before Flop (didn't bet)
Seat 2: Flying Smile (button) folded before Flop (didn't bet)
Seat 3: mikimiki88 (small blind) folded before Flop
Seat 4: king10clubs (big blind) folded before Flop
Seat 6: pindrokk collected ($15)


PokerStars Game #102623135439:  Hold'em No Limit ($3/$6 USD) - 2013/08/11 16:22:43 ET
Table 'Crux V 40-100 bb' 6-max Seat #3 is the button
Seat 1: teunuss ($906.31 in chips) 
Seat 2: Flying Smile ($621 in chips) 
Seat 3: mikimiki88 ($998.92 in chips) 
Seat 4: king10clubs ($716.98 in chips) 
king10clubs: posts small blind $3
pindrokk: is sitting out 
teunuss: posts big blind $6
*** HOLE CARDS ***
pindrokk leaves the table
Flying Smile: folds 
mikimiki88: folds 
king10clubs: folds 
Uncalled bet ($3) returned to teunuss
teunuss collected $6 from pot
teunuss: doesn't show hand 
*** SUMMARY ***
Total pot $6 | Rake $0 
Seat 1: teunuss (big blind) collected ($6)
Seat 2: Flying Smile folded before Flop (didn't bet)
Seat 3: mikimiki88 (button) folded before Flop (didn't bet)
Seat 4: king10clubs (small blind) folded before Flop


PokerStars Game #102623144447:  Hold'em No Limit ($3/$6 USD) - 2013/08/11 16:22:53 ET
Table 'Crux V 40-100 bb' 6-max Seat #4 is the button
Seat 1: teunuss ($909.31 in chips) 
Seat 3: mikimiki88 ($998.92 in chips) 
Seat 4: king10clubs ($713.98 in chips) 
teunuss: posts small blind $3
Flying Smile: is sitting out 
mikimiki88: posts big blind $6
*** HOLE CARDS ***
Flying Smile leaves the table
king10clubs: raises $6 to $12
teunuss: folds 
mikimiki88: calls $6
*** FLOP *** [Qs 4h Qc]
mikimiki88: checks 
Ner4zzurri joins the table at seat #5 
king10clubs: bets $15
Ner4zzurri leaves the table
mikimiki88: calls $15
*** TURN *** [Qs 4h Qc] [5h]
mikimiki88: checks 
king10clubs: bets $43
mikimiki88: raises $83.48 to $126.48
king10clubs: folds 
Uncalled bet ($83.48) returned to mikimiki88
mikimiki88 collected $141.50 from pot
mikimiki88: doesn't show hand 
*** SUMMARY ***
Total pot $143 | Rake $1.50 
Board [Qs 4h Qc 5h]
Seat 1: teunuss (small blind) folded before Flop
Seat 3: mikimiki88 (big blind) collected ($141.50)
Seat 4: king10clubs (button) folded on the Turn


PokerStars Game #102623200690:  Hold'em No Limit ($3/$6 USD) - 2013/08/11 16:23:59 ET
Table 'Crux V 40-100 bb' 6-max Seat #1 is the button
Seat 1: teunuss ($906.31 in chips) 
Seat 3: mikimiki88 ($1070.42 in chips) 
Seat 4: king10clubs ($643.98 in chips) 
mikimiki88: posts small blind $3
king10clubs: posts big blind $6
*** HOLE CARDS ***
teunuss: raises $6 to $12
mikimiki88: folds 
king10clubs: folds 
Uncalled bet ($6) returned to teunuss
teunuss collected $15 from pot
teunuss: doesn't show hand 
*** SUMMARY ***
Total pot $15 | Rake $0 
Seat 1: teunuss (button) collected ($15)
Seat 3: mikimiki88 (small blind) folded before Flop
Seat 4: king10clubs (big blind) folded before Flop


PokerStars Game #102623215816:  Hold'em No Limit ($3/$6 USD) - 2013/08/11 16:24:17 ET
Table 'Crux V 40-100 bb' 6-max Seat #3 is the button
Seat 1: teunuss ($915.31 in chips) 
Seat 3: mikimiki88 ($1067.42 in chips) 
Seat 4: king10clubs ($637.98 in chips) 
king10clubs: posts small blind $3
teunuss: posts big blind $6
*** HOLE CARDS ***
mikimiki88: raises $6 to $12
king10clubs: folds 
teunuss: calls $6
*** FLOP *** [9h 6h Th]
teunuss: checks 
mikimiki88: bets $18.30
teunuss: calls $18.30
*** TURN *** [9h 6h Th] [7c]
teunuss: checks 
baoyi2012 joins the table at seat #5 
LiveTogether joins the table at seat #6 
Subv joins the table at seat #2 
Subv leaves the table
mikimiki88: bets $44.09
Strz joins the table at seat #2 
teunuss: raises $96.91 to $141
mikimiki88: calls $96.91
*** RIVER *** [9h 6h Th 7c] [Qd]
teunuss: checks 
mikimiki88: checks 
*** SHOW DOWN ***
teunuss: shows [Jd Qc] (a pair of Queens)
mikimiki88: shows [Tc 8c] (a straight, Six to Ten)
mikimiki88 collected $344.10 from pot
*** SUMMARY ***
Total pot $345.60 | Rake $1.50 
Board [9h 6h Th 7c Qd]
Seat 1: teunuss (big blind) showed [Jd Qc] and lost with a pair of Queens
Seat 3: mikimiki88 (button) showed [Tc 8c] and won ($344.10) with a straight, Six to Ten
Seat 4: king10clubs (small blind) folded before Flop


PokerStars Game #102625154045:  Hold'em No Limit ($3/$6 USD) - 2013/08/11 17:05:06 ET
Table 'Crux V 40-100 bb' 6-max Seat #3 is the button
Seat 1: teunuss ($600 in chips) 
Seat 2: Strz ($935.92 in chips) 
Seat 3: mikimiki88 ($1420.87 in chips) 
Seat 4: king10clubs ($694.36 in chips) 
Seat 5: baoyi2012 ($1159 in chips) 
Seat 6: floriiiiider ($609 in chips) 
king10clubs: posts small blind $3
baoyi2012: posts big blind $6
*** HOLE CARDS ***
floriiiiider: raises $12 to $18
teunuss: folds 
Strz: folds 
mikimiki88: raises $26 to $44
king10clubs: folds 
baoyi2012: folds 
floriiiiider: calls $26
*** FLOP *** [Qc Kc Ts]
floriiiiider: checks 
mikimiki88: checks 
*** TURN *** [Qc Kc Ts] [7s]
floriiiiider: checks 
mikimiki88: bets $55.57
floriiiiider: folds 
Uncalled bet ($55.57) returned to mikimiki88
mikimiki88 collected $94.20 from pot
mikimiki88: doesn't show hand 
*** SUMMARY ***
Total pot $97 | Rake $2.80 
Board [Qc Kc Ts 7s]
Seat 1: teunuss folded before Flop (didn't bet)
Seat 2: Strz folded before Flop (didn't bet)
Seat 3: mikimiki88 (button) collected ($94.20)
Seat 4: king10clubs (small blind) folded before Flop
Seat 5: baoyi2012 (big blind) folded before Flop
Seat 6: floriiiiider folded on the Turn


PokerStars Game #102625214807:  Hold'em No Limit ($3/$6 USD) - 2013/08/11 17:06:17 ET
Table 'Crux V 40-100 bb' 6-max Seat #4 is the button
Seat 1: teunuss ($600 in chips) 
Seat 2: Strz ($935.92 in chips) 
Seat 3: mikimiki88 ($1471.07 in chips) 
Seat 4: king10clubs ($691.36 in chips) 
Seat 5: baoyi2012 ($1153 in chips) 
Seat 6: floriiiiider ($600 in chips) 
baoyi2012: posts small blind $3
floriiiiider: posts big blind $6
*** HOLE CARDS ***
teunuss: folds 
Strz: folds 
mikimiki88: folds 
king10clubs: raises $6 to $12
baoyi2012: raises $24 to $36
floriiiiider: calls $30
king10clubs: calls $24
*** FLOP *** [5s 8c Kd]
baoyi2012: checks 
floriiiiider: bets $66
king10clubs: calls $66
baoyi2012: folds 
*** TURN *** [5s 8c Kd] [3d]
floriiiiider: bets $126
king10clubs: folds 
Uncalled bet ($126) returned to floriiiiider
floriiiiider collected $237.20 from pot
floriiiiider: doesn't show hand 
*** SUMMARY ***
Total pot $240 | Rake $2.80 
Board [5s 8c Kd 3d]
Seat 1: teunuss folded before Flop (didn't bet)
Seat 2: Strz folded before Flop (didn't bet)
Seat 3: mikimiki88 folded before Flop (didn't bet)
Seat 4: king10clubs (button) folded on the Turn
Seat 5: baoyi2012 (small blind) folded on the Flop
Seat 6: floriiiiider (big blind) collected ($237.20)


PokerStars Game #102625286597:  Hold'em No Limit ($3/$6 USD) - 2013/08/11 17:07:42 ET
Table 'Crux V 40-100 bb' 6-max Seat #5 is the button
Seat 1: teunuss ($600 in chips) 
Seat 2: Strz ($935.92 in chips) 
Seat 3: mikimiki88 ($1471.07 in chips) 
Seat 4: king10clubs ($600 in chips) 
Seat 5: baoyi2012 ($1117 in chips) 
Seat 6: floriiiiider ($735.20 in chips) 
floriiiiider: posts small blind $3
teunuss: posts big blind $6
*** HOLE CARDS ***
Strz: folds 
mikimiki88: raises $12 to $18
king10clubs: folds 
baoyi2012: calls $18
floriiiiider: folds 
teunuss: folds 
*** FLOP *** [Ah 2d 3d]
mikimiki88: bets $30.51
baoyi2012: raises $41.49 to $72
mikimiki88: calls $41.49
*** TURN *** [Ah 2d 3d] [2s]
mikimiki88: checks 
baoyi2012: bets $168
mikimiki88: folds 
Uncalled bet ($168) returned to baoyi2012
baoyi2012 collected $186.20 from pot
*** SUMMARY ***
Total pot $189 | Rake $2.80 
Board [Ah 2d 3d 2s]
Seat 1: teunuss (big blind) folded before Flop
Seat 2: Strz folded before Flop (didn't bet)
Seat 3: mikimiki88 folded on the Turn
Seat 4: king10clubs folded before Flop (didn't bet)
Seat 5: baoyi2012 (button) collected ($186.20)
Seat 6: floriiiiider (small blind) folded before Flop


PokerStars Game #102625333242:  Hold'em No Limit ($3/$6 USD) - 2013/08/11 17:08:37 ET
Table 'Crux V 40-100 bb' 6-max Seat #6 is the button
Seat 1: teunuss ($600 in chips) 
Seat 2: Strz ($935.92 in chips) 
Seat 3: mikimiki88 ($1381.07 in chips) 
Seat 4: king10clubs ($600 in chips) 
Seat 5: baoyi2012 ($1213.20 in chips) 
Seat 6: floriiiiider ($732.20 in chips) 
teunuss: posts small blind $3
Strz: posts big blind $6
*** HOLE CARDS ***
mikimiki88: folds 
king10clubs: raises $9 to $15
baoyi2012: folds 
floriiiiider: folds 
teunuss: folds 
Strz: calls $9
*** FLOP *** [6s 8d 6h]
Strz: checks 
king10clubs: bets $24
Strz: folds 
Uncalled bet ($24) returned to king10clubs
king10clubs collected $31.52 from pot
king10clubs: doesn't show hand 
*** SUMMARY ***
Total pot $33 | Rake $1.48 
Board [6s 8d 6h]
Seat 1: teunuss (small blind) folded before Flop
Seat 2: Strz (big blind) folded on the Flop
Seat 3: mikimiki88 folded before Flop (didn't bet)
Seat 4: king10clubs collected ($31.52)
Seat 5: baoyi2012 folded before Flop (didn't bet)
Seat 6: floriiiiider (button) folded before Flop (didn't bet)


PokerStars Game #102625360994:  Hold'em No Limit ($3/$6 USD) - 2013/08/11 17:09:11 ET
Table 'Crux V 40-100 bb' 6-max Seat #1 is the button
Seat 1: teunuss ($600 in chips) 
Seat 2: Strz ($920.92 in chips) 
Seat 3: mikimiki88 ($1381.07 in chips) 
Seat 4: king10clubs ($616.52 in chips) 
Seat 5: baoyi2012 ($1213.20 in chips) 
Seat 6: floriiiiider ($732.20 in chips) 
Strz: posts small blind $3
mikimiki88: posts big blind $6
*** HOLE CARDS ***
king10clubs: folds 
baoyi2012: folds 
floriiiiider: raises $9 to $15
teunuss: folds 
Strz: folds 
mikimiki88: folds 
Uncalled bet ($9) returned to floriiiiider
floriiiiider collected $15 from pot
floriiiiider: doesn't show hand 
*** SUMMARY ***
Total pot $15 | Rake $0 
Seat 1: teunuss (button) folded before Flop (didn't bet)
Seat 2: Strz (small blind) folded before Flop
Seat 3: mikimiki88 (big blind) folded before Flop
Seat 4: king10clubs folded before Flop (didn't bet)
Seat 5: baoyi2012 folded before Flop (didn't bet)
Seat 6: floriiiiider collected ($15)


PokerStars Game #102625378409:  Hold'em No Limit ($3/$6 USD) - 2013/08/11 17:09:32 ET
Table 'Crux V 40-100 bb' 6-max Seat #2 is the button
Seat 1: teunuss ($600 in chips) 
Seat 2: Strz ($917.92 in chips) 
Seat 3: mikimiki88 ($1375.07 in chips) 
Seat 4: king10clubs ($616.52 in chips) 
Seat 5: baoyi2012 ($1213.20 in chips) 
Seat 6: floriiiiider ($741.20 in chips) 
mikimiki88: posts small blind $3
king10clubs: posts big blind $6
*** HOLE CARDS ***
baoyi2012: raises $6 to $12
floriiiiider: folds 
teunuss: folds 
Strz: folds 
mikimiki88: folds 
king10clubs: raises $36 to $48
baoyi2012: folds 
Uncalled bet ($36) returned to king10clubs
king10clubs collected $27 from pot
king10clubs: doesn't show hand 
*** SUMMARY ***
Total pot $27 | Rake $0 
Seat 1: teunuss folded before Flop (didn't bet)
Seat 2: Strz (button) folded before Flop (didn't bet)
Seat 3: mikimiki88 (small blind) folded before Flop
Seat 4: king10clubs (big blind) collected ($27)
Seat 5: baoyi2012 folded before Flop
Seat 6: floriiiiider folded before Flop (didn't bet)


PokerStars Game #102625398739:  Hold'em No Limit ($3/$6 USD) - 2013/08/11 17:09:56 ET
Table 'Crux V 40-100 bb' 6-max Seat #3 is the button
Seat 1: teunuss ($600 in chips) 
Seat 2: Strz ($917.92 in chips) 
Seat 3: mikimiki88 ($1372.07 in chips) 
Seat 4: king10clubs ($631.52 in chips) 
Seat 5: baoyi2012 ($1201.20 in chips) 
Seat 6: floriiiiider ($741.20 in chips) 
king10clubs: posts small blind $3
baoyi2012: posts big blind $6
*** HOLE CARDS ***
floriiiiider: folds 
teunuss: raises $12 to $18
Strz: calls $18
mikimiki88: folds 
king10clubs: calls $15
baoyi2012: calls $12
*** FLOP *** [9d 3d Ac]
king10clubs: checks 
baoyi2012: checks 
teunuss: checks 
Strz: checks 
*** TURN *** [9d 3d Ac] [Qd]
king10clubs: checks 
baoyi2012: checks 
teunuss: checks 
Strz: checks 
*** RIVER *** [9d 3d Ac Qd] [4h]
king10clubs: checks 
baoyi2012: checks 
teunuss: checks 
Strz: checks 
*** SHOW DOWN ***
king10clubs: shows [8s 8h] (a pair of Eights)
baoyi2012: mucks hand 
teunuss: mucks hand 
Strz: mucks hand 
king10clubs collected $69.20 from pot
*** SUMMARY ***
Total pot $72 | Rake $2.80 
Board [9d 3d Ac Qd 4h]
Seat 1: teunuss mucked
Seat 2: Strz mucked
Seat 3: mikimiki88 (button) folded before Flop (didn't bet)
Seat 4: king10clubs (small blind) showed [8s 8h] and won ($69.20) with a pair of Eights
Seat 5: baoyi2012 (big blind) mucked
Seat 6: floriiiiider folded before Flop (didn't bet)


PokerStars Game #102624936067:  Hold'em No Limit ($3/$6 USD) - 2013/08/11 17:00:24 ET
Table 'Crux V 40-100 bb' 6-max Seat #6 is the button
Seat 1: teunuss ($600 in chips) 
Seat 2: Strz ($974.08 in chips) 
Seat 4: king10clubs ($658.16 in chips) 
Seat 5: baoyi2012 ($1062.60 in chips) 
Seat 6: floriiiiider ($610.78 in chips) 
teunuss: posts small blind $3
Strz: posts big blind $6
*** HOLE CARDS ***
king10clubs: raises $9 to $15
baoyi2012: calls $15
floriiiiider: folds 
teunuss: folds 
Strz: calls $9
*** FLOP *** [3d 5d 7c]
Strz: bets $36
king10clubs: folds 
baoyi2012: folds 
Uncalled bet ($36) returned to Strz
Strz collected $45.84 from pot
*** SUMMARY ***
Total pot $48 | Rake $2.16 
Board [3d 5d 7c]
Seat 1: teunuss (small blind) folded before Flop
Seat 2: Strz (big blind) collected ($45.84)
Seat 4: king10clubs folded on the Flop
Seat 5: baoyi2012 folded on the Flop
Seat 6: floriiiiider (button) folded before Flop (didn't bet)


PokerStars Game #102624956174:  Hold'em No Limit ($3/$6 USD) - 2013/08/11 17:00:57 ET
Table 'Crux V 40-100 bb' 6-max Seat #1 is the button
Seat 1: teunuss ($600 in chips) 
Seat 2: Strz ($1004.92 in chips) 
Seat 4: king10clubs ($643.16 in chips) 
Seat 5: baoyi2012 ($1047.60 in chips) 
Seat 6: floriiiiider ($610.78 in chips) 
Strz: posts small blind $3
king10clubs: posts big blind $6
*** HOLE CARDS ***
baoyi2012: raises $6 to $12
floriiiiider: raises $33 to $45
teunuss: folds 
Strz: folds 
king10clubs: folds 
baoyi2012: folds 
Uncalled bet ($33) returned to floriiiiider
floriiiiider collected $33 from pot
floriiiiider: doesn't show hand 
*** SUMMARY ***
Total pot $33 | Rake $0 
Seat 1: teunuss (button) folded before Flop (didn't bet)
Seat 2: Strz (small blind) folded before Flop
Seat 4: king10clubs (big blind) folded before Flop
Seat 5: baoyi2012 folded before Flop
Seat 6: floriiiiider collected ($33)


PokerStars Game #102624980476:  Hold'em No Limit ($3/$6 USD) - 2013/08/11 17:01:31 ET
Table 'Crux V 40-100 bb' 6-max Seat #2 is the button
Seat 1: teunuss ($600 in chips) 
Seat 2: Strz ($1001.92 in chips) 
Seat 4: king10clubs ($637.16 in chips) 
Seat 5: baoyi2012 ($1035.60 in chips) 
Seat 6: floriiiiider ($631.78 in chips) 
king10clubs: posts small blind $3
baoyi2012: posts big blind $6
*** HOLE CARDS ***
floriiiiider: folds 
teunuss: raises $9 to $15
Strz: folds 
king10clubs: folds 
baoyi2012: calls $9
*** FLOP *** [Tc 9c Jh]
baoyi2012: checks 
teunuss: checks 
*** TURN *** [Tc 9c Jh] [Ad]
baoyi2012: checks 
teunuss: bets $21
baoyi2012: calls $21
*** RIVER *** [Tc 9c Jh Ad] [5h]
baoyi2012: checks 
teunuss: checks 
*** SHOW DOWN ***
baoyi2012: shows [Ts 5s] (two pair, Tens and Fives)
teunuss: mucks hand 
baoyi2012 collected $72.20 from pot
*** SUMMARY ***
Total pot $75 | Rake $2.80 
Board [Tc 9c Jh Ad 5h]
Seat 1: teunuss mucked
Seat 2: Strz (button) folded before Flop (didn't bet)
Seat 4: king10clubs (small blind) folded before Flop
Seat 5: baoyi2012 (big blind) showed [Ts 5s] and won ($72.20) with two pair, Tens and Fives
Seat 6: floriiiiider folded before Flop (didn't bet)


PokerStars Game #102625022308:  Hold'em No Limit ($3/$6 USD) - 2013/08/11 17:02:26 ET
Table 'Crux V 40-100 bb' 6-max Seat #4 is the button
Seat 1: teunuss ($600 in chips) 
Seat 2: Strz ($1001.92 in chips) 
Seat 4: king10clubs ($634.16 in chips) 
Seat 5: baoyi2012 ($1071.80 in chips) 
Seat 6: floriiiiider ($631.78 in chips) 
baoyi2012: posts small blind $3
floriiiiider: posts big blind $6
mikimiki88: sits out 
*** HOLE CARDS ***
teunuss: folds 
Strz: folds 
king10clubs: raises $6 to $12
baoyi2012: calls $9
floriiiiider: raises $39 to $51
king10clubs: folds 
baoyi2012: folds 
Uncalled bet ($39) returned to floriiiiider
floriiiiider collected $36 from pot
floriiiiider: doesn't show hand 
*** SUMMARY ***
Total pot $36 | Rake $0 
Seat 1: teunuss folded before Flop (didn't bet)
Seat 2: Strz folded before Flop (didn't bet)
Seat 4: king10clubs (button) folded before Flop
Seat 5: baoyi2012 (small blind) folded before Flop
Seat 6: floriiiiider (big blind) collected ($36)


PokerStars Game #102625038144:  Hold'em No Limit ($3/$6 USD) - 2013/08/11 17:02:46 ET
Table 'Crux V 40-100 bb' 6-max Seat #5 is the button
Seat 1: teunuss ($600 in chips) 
Seat 2: Strz ($1001.92 in chips) 
Seat 4: king10clubs ($622.16 in chips) 
Seat 5: baoyi2012 ($1059.80 in chips) 
Seat 6: floriiiiider ($655.78 in chips) 
floriiiiider: posts small blind $3
teunuss: posts big blind $6
mikimiki88: sits out 
*** HOLE CARDS ***
Strz: folds 
king10clubs: folds 
baoyi2012: raises $6 to $12
floriiiiider: raises $33 to $45
teunuss: folds 
baoyi2012: calls $33
*** FLOP *** [Js Ts Jc]
floriiiiider: bets $57
baoyi2012: raises $63 to $120
floriiiiider: folds 
Uncalled bet ($63) returned to baoyi2012
baoyi2012 collected $207.20 from pot
*** SUMMARY ***
Total pot $210 | Rake $2.80 
Board [Js Ts Jc]
Seat 1: teunuss (big blind) folded before Flop
Seat 2: Strz folded before Flop (didn't bet)
Seat 4: king10clubs folded before Flop (didn't bet)
Seat 5: baoyi2012 (button) collected ($207.20)
Seat 6: floriiiiider (small blind) folded on the Flop


PokerStars Game #102625066042:  Hold'em No Limit ($3/$6 USD) - 2013/08/11 17:03:20 ET
Table 'Crux V 40-100 bb' 6-max Seat #6 is the button
Seat 1: teunuss ($600 in chips) 
Seat 2: Strz ($1001.92 in chips) 
Seat 4: king10clubs ($622.16 in chips) 
Seat 5: baoyi2012 ($1165 in chips) 
Seat 6: floriiiiider ($600 in chips) 
teunuss: posts small blind $3
Strz: posts big blind $6
mikimiki88: sits out 
*** HOLE CARDS ***
king10clubs: raises $9 to $15
baoyi2012: calls $15
floriiiiider: folds 
teunuss: folds 
Strz: raises $48 to $63
king10clubs: calls $48
baoyi2012: folds 
*** FLOP *** [Qd 5s 4s]
Strz: checks 
king10clubs: bets $66
Strz: folds 
Uncalled bet ($66) returned to king10clubs
king10clubs collected $141.20 from pot
king10clubs: doesn't show hand 
*** SUMMARY ***
Total pot $144 | Rake $2.80 
Board [Qd 5s 4s]
Seat 1: teunuss (small blind) folded before Flop
Seat 2: Strz (big blind) folded on the Flop
Seat 4: king10clubs collected ($141.20)
Seat 5: baoyi2012 folded before Flop
Seat 6: floriiiiider (button) folded before Flop (didn't bet)


PokerStars Game #102625118828:  Hold'em No Limit ($3/$6 USD) - 2013/08/11 17:04:24 ET
Table 'Crux V 40-100 bb' 6-max Seat #1 is the button
Seat 1: teunuss ($600 in chips) 
Seat 2: Strz ($938.92 in chips) 
Seat 3: mikimiki88 ($1429.87 in chips) 
Seat 4: king10clubs ($700.36 in chips) 
Seat 5: baoyi2012 ($1150 in chips) 
Seat 6: floriiiiider ($600 in chips) 
Strz: posts small blind $3
mikimiki88: posts big blind $6
*** HOLE CARDS ***
king10clubs: folds 
baoyi2012: folds 
floriiiiider: raises $9 to $15
teunuss: folds 
Strz: folds 
mikimiki88: folds 
Uncalled bet ($9) returned to floriiiiider
floriiiiider collected $15 from pot
floriiiiider: doesn't show hand 
*** SUMMARY ***
Total pot $15 | Rake $0 
Seat 1: teunuss (button) folded before Flop (didn't bet)
Seat 2: Strz (small blind) folded before Flop
Seat 3: mikimiki88 (big blind) folded before Flop
Seat 4: king10clubs folded before Flop (didn't bet)
Seat 5: baoyi2012 folded before Flop (didn't bet)
Seat 6: floriiiiider collected ($15)


PokerStars Game #102625138146:  Hold'em No Limit ($3/$6 USD) - 2013/08/11 17:04:47 ET
Table 'Crux V 40-100 bb' 6-max Seat #2 is the button
Seat 1: teunuss ($600 in chips) 
Seat 2: Strz ($935.92 in chips) 
Seat 3: mikimiki88 ($1423.87 in chips) 
Seat 4: king10clubs ($700.36 in chips) 
Seat 5: baoyi2012 ($1150 in chips) 
Seat 6: floriiiiider ($609 in chips) 
mikimiki88: posts small blind $3
king10clubs: posts big blind $6
*** HOLE CARDS ***
baoyi2012: raises $6 to $12
floriiiiider: folds 
teunuss: folds 
Strz: folds 
mikimiki88: folds 
king10clubs: folds 
Uncalled bet ($6) returned to baoyi2012
baoyi2012 collected $15 from pot
*** SUMMARY ***
Total pot $15 | Rake $0 
Seat 1: teunuss folded before Flop (didn't bet)
Seat 2: Strz (button) folded before Flop (didn't bet)
Seat 3: mikimiki88 (small blind) folded before Flop
Seat 4: king10clubs (big blind) folded before Flop
Seat 5: baoyi2012 collected ($15)
Seat 6: floriiiiider folded before Flop (didn't bet)


PokerStars Game #102624767082:  Hold'em No Limit ($3/$6 USD) - 2013/08/11 16:55:14 ET
Table 'Crux V 40-100 bb' 6-max Seat #1 is the button
Seat 1: teunuss ($600 in chips) 
Seat 2: Strz ($753.10 in chips) 
Seat 4: king10clubs ($757.16 in chips) 
Seat 5: baoyi2012 ($1179.20 in chips) 
Seat 6: floriiiiider ($600 in chips) 
Strz: posts small blind $3
mikimiki88: is sitting out 
king10clubs: posts big blind $6
*** HOLE CARDS ***
baoyi2012: raises $6 to $12
floriiiiider: calls $12
teunuss: folds 
Strz: raises $54 to $66
king10clubs: folds 
baoyi2012: folds 
floriiiiider: folds 
Uncalled bet ($54) returned to Strz
Strz collected $42 from pot
*** SUMMARY ***
Total pot $42 | Rake $0 
Seat 1: teunuss (button) folded before Flop (didn't bet)
Seat 2: Strz (small blind) collected ($42)
Seat 4: king10clubs (big blind) folded before Flop
Seat 5: baoyi2012 folded before Flop
Seat 6: floriiiiider folded before Flop


PokerStars Game #102624780104:  Hold'em No Limit ($3/$6 USD) - 2013/08/11 16:55:38 ET
Table 'Crux V 40-100 bb' 6-max Seat #2 is the button
Seat 1: teunuss ($600 in chips) 
Seat 2: Strz ($783.10 in chips) 
Seat 4: king10clubs ($751.16 in chips) 
Seat 5: baoyi2012 ($1167.20 in chips) 
Seat 6: floriiiiider ($600 in chips) 
king10clubs: posts small blind $3
baoyi2012: posts big blind $6
*** HOLE CARDS ***
floriiiiider: folds 
teunuss: folds 
Strz: folds 
king10clubs: folds 
Uncalled bet ($3) returned to baoyi2012
baoyi2012 collected $6 from pot
*** SUMMARY ***
Total pot $6 | Rake $0 
Seat 1: teunuss folded before Flop (didn't bet)
Seat 2: Strz (button) folded before Flop (didn't bet)
Seat 4: king10clubs (small blind) folded before Flop
Seat 5: baoyi2012 (big blind) collected ($6)
Seat 6: floriiiiider folded before Flop (didn't bet)


PokerStars Game #102624794929:  Hold'em No Limit ($3/$6 USD) - 2013/08/11 16:56:06 ET
Table 'Crux V 40-100 bb' 6-max Seat #4 is the button
Seat 1: teunuss ($600 in chips) 
Seat 2: Strz ($783.10 in chips) 
Seat 4: king10clubs ($748.16 in chips) 
Seat 5: baoyi2012 ($1170.20 in chips) 
Seat 6: floriiiiider ($600 in chips) 
baoyi2012: posts small blind $3
floriiiiider: posts big blind $6
*** HOLE CARDS ***
teunuss: folds 
Strz: folds 
king10clubs: raises $6 to $12
baoyi2012: folds 
floriiiiider: calls $6
*** FLOP *** [3d Js 9h]
floriiiiider: checks 
king10clubs: checks 
*** TURN *** [3d Js 9h] [Ac]
floriiiiider: checks 
king10clubs: checks 
*** RIVER *** [3d Js 9h Ac] [Td]
floriiiiider: checks 
king10clubs: checks 
*** SHOW DOWN ***
floriiiiider: shows [8c 8s] (a pair of Eights)
king10clubs: mucks hand 
floriiiiider collected $25.78 from pot
*** SUMMARY ***
Total pot $27 | Rake $1.22 
Board [3d Js 9h Ac Td]
Seat 1: teunuss folded before Flop (didn't bet)
Seat 2: Strz folded before Flop (didn't bet)
Seat 4: king10clubs (button) mucked
Seat 5: baoyi2012 (small blind) folded before Flop
Seat 6: floriiiiider (big blind) showed [8c 8s] and won ($25.78) with a pair of Eights


PokerStars Game #102624812016:  Hold'em No Limit ($3/$6 USD) - 2013/08/11 16:56:38 ET
Table 'Crux V 40-100 bb' 6-max Seat #5 is the button
Seat 1: teunuss ($600 in chips) 
Seat 2: Strz ($783.10 in chips) 
Seat 4: king10clubs ($736.16 in chips) 
Seat 5: baoyi2012 ($1167.20 in chips) 
Seat 6: floriiiiider ($613.78 in chips) 
floriiiiider: posts small blind $3
teunuss: posts big blind $6
*** HOLE CARDS ***
Strz: raises $12 to $18
king10clubs: folds 
baoyi2012: calls $18
floriiiiider: folds 
teunuss: folds 
*** FLOP *** [Ac Ah Qd]
Strz: bets $30
baoyi2012: calls $30
*** TURN *** [Ac Ah Qd] [6h]
Strz: bets $78
baoyi2012: calls $78
*** RIVER *** [Ac Ah Qd 6h] [6d]
Strz: bets $114
baoyi2012: calls $114
*** SHOW DOWN ***
Strz: shows [As Ts] (a full house, Aces full of Sixes)
baoyi2012: mucks hand 
Strz collected $486.20 from pot
*** SUMMARY ***
Total pot $489 | Rake $2.80 
Board [Ac Ah Qd 6h 6d]
Seat 1: teunuss (big blind) folded before Flop
Seat 2: Strz showed [As Ts] and won ($486.20) with a full house, Aces full of Sixes
Seat 4: king10clubs folded before Flop (didn't bet)
Seat 5: baoyi2012 (button) mucked
Seat 6: floriiiiider (small blind) folded before Flop


PokerStars Game #102624845958:  Hold'em No Limit ($3/$6 USD) - 2013/08/11 16:57:42 ET
Table 'Crux V 40-100 bb' 6-max Seat #6 is the button
Seat 1: teunuss ($600 in chips) 
Seat 2: Strz ($1029.30 in chips) 
Seat 4: king10clubs ($736.16 in chips) 
Seat 5: baoyi2012 ($927.20 in chips) 
Seat 6: floriiiiider ($610.78 in chips) 
teunuss: posts small blind $3
Strz: posts big blind $6
*** HOLE CARDS ***
king10clubs: folds 
baoyi2012: folds 
floriiiiider: raises $6 to $12
teunuss: folds 
Strz: folds 
Uncalled bet ($6) returned to floriiiiider
floriiiiider collected $15 from pot
floriiiiider: doesn't show hand 
*** SUMMARY ***
Total pot $15 | Rake $0 
Seat 1: teunuss (small blind) folded before Flop
Seat 2: Strz (big blind) folded before Flop
Seat 4: king10clubs folded before Flop (didn't bet)
Seat 5: baoyi2012 folded before Flop (didn't bet)
Seat 6: floriiiiider (button) collected ($15)


PokerStars Game #102624856716:  Hold'em No Limit ($3/$6 USD) - 2013/08/11 16:58:02 ET
Table 'Crux V 40-100 bb' 6-max Seat #1 is the button
Seat 1: teunuss ($600 in chips) 
Seat 2: Strz ($1023.30 in chips) 
Seat 4: king10clubs ($736.16 in chips) 
Seat 5: baoyi2012 ($927.20 in chips) 
Seat 6: floriiiiider ($619.78 in chips) 
Strz: posts small blind $3
king10clubs: posts big blind $6
*** HOLE CARDS ***
baoyi2012: raises $6 to $12
floriiiiider: folds 
teunuss: folds 
Strz: folds 
king10clubs: folds 
Uncalled bet ($6) returned to baoyi2012
baoyi2012 collected $15 from pot
*** SUMMARY ***
Total pot $15 | Rake $0 
Seat 1: teunuss (button) folded before Flop (didn't bet)
Seat 2: Strz (small blind) folded before Flop
Seat 4: king10clubs (big blind) folded before Flop
Seat 5: baoyi2012 collected ($15)
Seat 6: floriiiiider folded before Flop (didn't bet)


PokerStars Game #102624863700:  Hold'em No Limit ($3/$6 USD) - 2013/08/11 16:58:15 ET
Table 'Crux V 40-100 bb' 6-max Seat #2 is the button
Seat 1: teunuss ($600 in chips) 
Seat 2: Strz ($1020.30 in chips) 
Seat 4: king10clubs ($730.16 in chips) 
Seat 5: baoyi2012 ($936.20 in chips) 
Seat 6: floriiiiider ($619.78 in chips) 
king10clubs: posts small blind $3
baoyi2012: posts big blind $6
*** HOLE CARDS ***
floriiiiider: folds 
teunuss: folds 
Strz: raises $6 to $12
king10clubs: folds 
baoyi2012: calls $6
*** FLOP *** [Ac Tc 8s]
baoyi2012: checks 
Strz: bets $18
baoyi2012: folds 
Uncalled bet ($18) returned to Strz
Strz collected $25.78 from pot
*** SUMMARY ***
Total pot $27 | Rake $1.22 
Board [Ac Tc 8s]
Seat 1: teunuss folded before Flop (didn't bet)
Seat 2: Strz (button) collected ($25.78)
Seat 4: king10clubs (small blind) folded before Flop
Seat 5: baoyi2012 (big blind) folded on the Flop
Seat 6: floriiiiider folded before Flop (didn't bet)


PokerStars Game #102624880443:  Hold'em No Limit ($3/$6 USD) - 2013/08/11 16:58:46 ET
Table 'Crux V 40-100 bb' 6-max Seat #4 is the button
Seat 1: teunuss ($600 in chips) 
Seat 2: Strz ($1034.08 in chips) 
Seat 4: king10clubs ($727.16 in chips) 
Seat 5: baoyi2012 ($924.20 in chips) 
Seat 6: floriiiiider ($619.78 in chips) 
baoyi2012: posts small blind $3
floriiiiider: posts big blind $6
*** HOLE CARDS ***
teunuss: folds 
Strz: raises $12 to $18
king10clubs: folds 
baoyi2012: raises $42 to $60
floriiiiider: folds 
Strz: calls $42
*** FLOP *** [4h 4c 4d]
baoyi2012: bets $108
Strz: folds 
Uncalled bet ($108) returned to baoyi2012
baoyi2012 collected $123.20 from pot
*** SUMMARY ***
Total pot $126 | Rake $2.80 
Board [4h 4c 4d]
Seat 1: teunuss folded before Flop (didn't bet)
Seat 2: Strz folded on the Flop
Seat 4: king10clubs (button) folded before Flop (didn't bet)
Seat 5: baoyi2012 (small blind) collected ($123.20)
Seat 6: floriiiiider (big blind) folded before Flop


PokerStars Game #102624904743:  Hold'em No Limit ($3/$6 USD) - 2013/08/11 16:59:31 ET
Table 'Crux V 40-100 bb' 6-max Seat #5 is the button
Seat 1: teunuss ($600 in chips) 
Seat 2: Strz ($974.08 in chips) 
Seat 4: king10clubs ($727.16 in chips) 
Seat 5: baoyi2012 ($987.40 in chips) 
Seat 6: floriiiiider ($613.78 in chips) 
floriiiiider: posts small blind $3
teunuss: posts big blind $6
*** HOLE CARDS ***
Strz: folds 
king10clubs: raises $9 to $15
baoyi2012: calls $15
floriiiiider: folds 
teunuss: folds 
*** FLOP *** [Th 5d 7c]
king10clubs: bets $23.70
baoyi2012: raises $30.30 to $54
king10clubs: calls $30.30
*** TURN *** [Th 5d 7c] [7s]
king10clubs: checks 
baoyi2012: checks 
*** RIVER *** [Th 5d 7c 7s] [2c]
king10clubs: checks 
baoyi2012: checks 
*** SHOW DOWN ***
king10clubs: shows [Td 3d] (two pair, Tens and Sevens)
baoyi2012: shows [Kd Tc] (two pair, Tens and Sevens - King kicker)
baoyi2012 collected $144.20 from pot
*** SUMMARY ***
Total pot $147 | Rake $2.80 
Board [Th 5d 7c 7s 2c]
Seat 1: teunuss (big blind) folded before Flop
Seat 2: Strz folded before Flop (didn't bet)
Seat 4: king10clubs showed [Td 3d] and lost with two pair, Tens and Sevens
Seat 5: baoyi2012 (button) showed [Kd Tc] and won ($144.20) with two pair, Tens and Sevens
Seat 6: floriiiiider (small blind) folded before Flop


PokerStars Game #102624522978:  Hold'em No Limit ($3/$6 USD) - 2013/08/11 16:50:13 ET
Table 'Crux V 40-100 bb' 6-max Seat #1 is the button
Seat 1: teunuss ($722.85 in chips) 
Seat 2: Strz ($777.10 in chips) 
Seat 3: mikimiki88 ($1319.67 in chips) 
Seat 4: king10clubs ($650.18 in chips) 
Seat 5: baoyi2012 ($524.27 in chips) 
Seat 6: floriiiiider ($600 in chips) 
Strz: posts small blind $3
mikimiki88: posts big blind $6
*** HOLE CARDS ***
king10clubs: folds 
baoyi2012: folds 
floriiiiider: folds 
teunuss: raises $6 to $12
Strz: folds 
mikimiki88: folds 
Uncalled bet ($6) returned to teunuss
teunuss collected $15 from pot
teunuss: doesn't show hand 
*** SUMMARY ***
Total pot $15 | Rake $0 
Seat 1: teunuss (button) collected ($15)
Seat 2: Strz (small blind) folded before Flop
Seat 3: mikimiki88 (big blind) folded before Flop
Seat 4: king10clubs folded before Flop (didn't bet)
Seat 5: baoyi2012 folded before Flop (didn't bet)
Seat 6: floriiiiider folded before Flop (didn't bet)


PokerStars Game #102624540107:  Hold'em No Limit ($3/$6 USD) - 2013/08/11 16:50:34 ET
Table 'Crux V 40-100 bb' 6-max Seat #2 is the button
Seat 1: teunuss ($731.85 in chips) 
Seat 2: Strz ($774.10 in chips) 
Seat 3: mikimiki88 ($1313.67 in chips) 
Seat 4: king10clubs ($650.18 in chips) 
Seat 5: baoyi2012 ($524.27 in chips) 
Seat 6: floriiiiider ($600 in chips) 
mikimiki88: posts small blind $3
king10clubs: posts big blind $6
*** HOLE CARDS ***
baoyi2012: folds 
floriiiiider: folds 
teunuss: raises $9 to $15
Strz: folds 
mikimiki88: folds 
king10clubs: folds 
Uncalled bet ($9) returned to teunuss
teunuss collected $15 from pot
teunuss: doesn't show hand 
*** SUMMARY ***
Total pot $15 | Rake $0 
Seat 1: teunuss collected ($15)
Seat 2: Strz (button) folded before Flop (didn't bet)
Seat 3: mikimiki88 (small blind) folded before Flop
Seat 4: king10clubs (big blind) folded before Flop
Seat 5: baoyi2012 folded before Flop (didn't bet)
Seat 6: floriiiiider folded before Flop (didn't bet)


PokerStars Game #102624572526:  Hold'em No Limit ($3/$6 USD) - 2013/08/11 16:51:14 ET
Table 'Crux V 40-100 bb' 6-max Seat #3 is the button
Seat 1: teunuss ($740.85 in chips) 
Seat 2: Strz ($774.10 in chips) 
Seat 3: mikimiki88 ($1310.67 in chips) 
Seat 4: king10clubs ($644.18 in chips) 
Seat 5: baoyi2012 ($524.27 in chips) 
Seat 6: floriiiiider ($600 in chips) 
king10clubs: posts small blind $3
baoyi2012: posts big blind $6
*** HOLE CARDS ***
floriiiiider: folds 
teunuss: raises $9 to $15
Strz: calls $15
mikimiki88: raises $31 to $46
king10clubs: raises $64.60 to $110.60
baoyi2012: folds 
teunuss: folds 
Strz: folds 
mikimiki88: folds 
Uncalled bet ($64.60) returned to king10clubs
king10clubs collected $128 from pot
king10clubs: doesn't show hand 
*** SUMMARY ***
Total pot $128 | Rake $0 
Seat 1: teunuss folded before Flop
Seat 2: Strz folded before Flop
Seat 3: mikimiki88 (button) folded before Flop
Seat 4: king10clubs (small blind) collected ($128)
Seat 5: baoyi2012 (big blind) folded before Flop
Seat 6: floriiiiider folded before Flop (didn't bet)


PokerStars Game #102624605793:  Hold'em No Limit ($3/$6 USD) - 2013/08/11 16:51:55 ET
Table 'Crux V 40-100 bb' 6-max Seat #4 is the button
Seat 1: teunuss ($725.85 in chips) 
Seat 2: Strz ($759.10 in chips) 
Seat 3: mikimiki88 ($1264.67 in chips) 
Seat 4: king10clubs ($726.18 in chips) 
Seat 5: baoyi2012 ($518.27 in chips) 
Seat 6: floriiiiider ($600 in chips) 
baoyi2012: posts small blind $3
floriiiiider: posts big blind $6
*** HOLE CARDS ***
teunuss: folds 
Strz: folds 
mikimiki88: raises $6 to $12
king10clubs: folds 
baoyi2012: calls $9
floriiiiider: folds 
*** FLOP *** [8d 2s 8s]
baoyi2012: checks 
mikimiki88: bets $20.34
baoyi2012: raises $39.66 to $60
mikimiki88: calls $39.66
*** TURN *** [8d 2s 8s] [Qd]
baoyi2012: checks 
mikimiki88: bets $102
baoyi2012: calls $102
*** RIVER *** [8d 2s 8s Qd] [7h]
baoyi2012: checks 
mikimiki88: bets $350
baoyi2012: folds 
Uncalled bet ($350) returned to mikimiki88
mikimiki88 collected $351.20 from pot
mikimiki88: doesn't show hand 
*** SUMMARY ***
Total pot $354 | Rake $2.80 
Board [8d 2s 8s Qd 7h]
Seat 1: teunuss folded before Flop (didn't bet)
Seat 2: Strz folded before Flop (didn't bet)
Seat 3: mikimiki88 collected ($351.20)
Seat 4: king10clubs (button) folded before Flop (didn't bet)
Seat 5: baoyi2012 (small blind) folded on the River
Seat 6: floriiiiider (big blind) folded before Flop


PokerStars Game #102624698558:  Hold'em No Limit ($3/$6 USD) - 2013/08/11 16:53:50 ET
Table 'Crux V 40-100 bb' 6-max Seat #5 is the button
Seat 1: teunuss ($725.85 in chips) 
Seat 2: Strz ($759.10 in chips) 
Seat 3: mikimiki88 ($1441.87 in chips) 
Seat 4: king10clubs ($726.18 in chips) 
Seat 5: baoyi2012 ($344.27 in chips) 
Seat 6: floriiiiider ($600 in chips) 
floriiiiider: posts small blind $3
teunuss: posts big blind $6
*** HOLE CARDS ***
Strz: folds 
mikimiki88: raises $6 to $12
king10clubs: calls $12
baoyi2012: calls $12
floriiiiider: folds 
teunuss: folds 
*** FLOP *** [Td Qh 6c]
mikimiki88: checks 
king10clubs: bets $30
baoyi2012: folds 
mikimiki88: folds 
Uncalled bet ($30) returned to king10clubs
king10clubs collected $42.98 from pot
king10clubs: doesn't show hand 
*** SUMMARY ***
Total pot $45 | Rake $2.02 
Board [Td Qh 6c]
Seat 1: teunuss (big blind) folded before Flop
Seat 2: Strz folded before Flop (didn't bet)
Seat 3: mikimiki88 folded on the Flop
Seat 4: king10clubs collected ($42.98)
Seat 5: baoyi2012 (button) folded on the Flop
Seat 6: floriiiiider (small blind) folded before Flop


PokerStars Game #102624737635:  Hold'em No Limit ($3/$6 USD) - 2013/08/11 16:54:37 ET
Table 'Crux V 40-100 bb' 6-max Seat #6 is the button
Seat 1: teunuss ($719.85 in chips) 
Seat 2: Strz ($759.10 in chips) 
Seat 3: mikimiki88 ($1429.87 in chips) 
Seat 4: king10clubs ($757.16 in chips) 
Seat 5: baoyi2012 ($588 in chips) 
Seat 6: floriiiiider ($600 in chips) 
teunuss: posts small blind $3
Strz: posts big blind $6
*** HOLE CARDS ***
mikimiki88: folds 
king10clubs: folds 
baoyi2012: raises $12 to $18
floriiiiider: folds 
teunuss: raises $42 to $60
Strz: folds 
baoyi2012: raises $528 to $588 and is all-in
teunuss: calls $528
*** FLOP *** [4c Jc 8h]
*** TURN *** [4c Jc 8h] [Kc]
*** RIVER *** [4c Jc 8h Kc] [8d]
*** SHOW DOWN ***
teunuss: shows [Ts Td] (two pair, Tens and Eights)
baoyi2012: shows [Ac Ks] (two pair, Kings and Eights)
baoyi2012 collected $1179.20 from pot
*** SUMMARY ***
Total pot $1182 | Rake $2.80 
Board [4c Jc 8h Kc 8d]
Seat 1: teunuss (small blind) showed [Ts Td] and lost with two pair, Tens and Eights
Seat 2: Strz (big blind) folded before Flop
Seat 3: mikimiki88 folded before Flop (didn't bet)
Seat 4: king10clubs folded before Flop (didn't bet)
Seat 5: baoyi2012 showed [Ac Ks] and won ($1179.20) with two pair, Kings and Eights
Seat 6: floriiiiider (button) folded before Flop (didn't bet)


PokerStars Game #102624282156:  Hold'em No Limit ($3/$6 USD) - 2013/08/11 16:45:23 ET
Table 'Crux V 40-100 bb' 6-max Seat #3 is the button
Seat 1: teunuss ($728.85 in chips) 
Seat 2: Strz ($765.10 in chips) 
Seat 3: mikimiki88 ($1349.67 in chips) 
Seat 4: king10clubs ($668.18 in chips) 
Seat 5: baoyi2012 ($468.55 in chips) 
Seat 6: LiveTogether ($311.20 in chips) 
king10clubs: posts small blind $3
baoyi2012: posts big blind $6
*** HOLE CARDS ***
LiveTogether: folds 
LiveTogether leaves the table
floriiiiider joins the table at seat #6 
teunuss: folds 
Strz: raises $12 to $18
mikimiki88: folds 
king10clubs: folds 
baoyi2012: folds 
Uncalled bet ($12) returned to Strz
Strz collected $15 from pot
*** SUMMARY ***
Total pot $15 | Rake $0 
Seat 1: teunuss folded before Flop (didn't bet)
Seat 2: Strz collected ($15)
Seat 3: mikimiki88 (button) folded before Flop (didn't bet)
Seat 4: king10clubs (small blind) folded before Flop
Seat 5: baoyi2012 (big blind) folded before Flop
Seat 6: LiveTogether folded before Flop (didn't bet)


PokerStars Game #102624303591:  Hold'em No Limit ($3/$6 USD) - 2013/08/11 16:45:48 ET
Table 'Crux V 40-100 bb' 6-max Seat #4 is the button
Seat 1: teunuss ($728.85 in chips) 
Seat 2: Strz ($774.10 in chips) 
Seat 3: mikimiki88 ($1349.67 in chips) 
Seat 4: king10clubs ($665.18 in chips) 
Seat 5: baoyi2012 ($462.55 in chips) 
Seat 6: floriiiiider ($600 in chips) 
baoyi2012: posts small blind $3
floriiiiider: posts big blind $6
*** HOLE CARDS ***
teunuss: folds 
Strz: folds 
mikimiki88: raises $6 to $12
king10clubs: raises $25.40 to $37.40
baoyi2012: folds 
floriiiiider: folds 
mikimiki88: folds 
Uncalled bet ($25.40) returned to king10clubs
king10clubs collected $33 from pot
king10clubs: doesn't show hand 
*** SUMMARY ***
Total pot $33 | Rake $0 
Seat 1: teunuss folded before Flop (didn't bet)
Seat 2: Strz folded before Flop (didn't bet)
Seat 3: mikimiki88 folded before Flop
Seat 4: king10clubs (button) collected ($33)
Seat 5: baoyi2012 (small blind) folded before Flop
Seat 6: floriiiiider (big blind) folded before Flop


PokerStars Game #102624326877:  Hold'em No Limit ($3/$6 USD) - 2013/08/11 16:46:15 ET
Table 'Crux V 40-100 bb' 6-max Seat #5 is the button
Seat 1: teunuss ($728.85 in chips) 
Seat 2: Strz ($774.10 in chips) 
Seat 3: mikimiki88 ($1337.67 in chips) 
Seat 4: king10clubs ($686.18 in chips) 
Seat 5: baoyi2012 ($459.55 in chips) 
Seat 6: floriiiiider ($600 in chips) 
floriiiiider: posts small blind $3
teunuss: posts big blind $6
*** HOLE CARDS ***
Strz: folds 
mikimiki88: folds 
king10clubs: raises $6 to $12
baoyi2012: calls $12
floriiiiider: folds 
teunuss: folds 
*** FLOP *** [Ac Jh Jd]
king10clubs: checks 
baoyi2012: bets $30
king10clubs: folds 
Uncalled bet ($30) returned to baoyi2012
baoyi2012 collected $31.52 from pot
baoyi2012: shows [4s Js] (three of a kind, Jacks)
*** SUMMARY ***
Total pot $33 | Rake $1.48 
Board [Ac Jh Jd]
Seat 1: teunuss (big blind) folded before Flop
Seat 2: Strz folded before Flop (didn't bet)
Seat 3: mikimiki88 folded before Flop (didn't bet)
Seat 4: king10clubs folded on the Flop
Seat 5: baoyi2012 (button) collected ($31.52)
Seat 6: floriiiiider (small blind) folded before Flop


PokerStars Game #102624360299:  Hold'em No Limit ($3/$6 USD) - 2013/08/11 16:46:55 ET
Table 'Crux V 40-100 bb' 6-max Seat #6 is the button
Seat 1: teunuss ($722.85 in chips) 
Seat 2: Strz ($774.10 in chips) 
Seat 3: mikimiki88 ($1337.67 in chips) 
Seat 4: king10clubs ($674.18 in chips) 
Seat 5: baoyi2012 ($479.07 in chips) 
Seat 6: floriiiiider ($600 in chips) 
teunuss: posts small blind $3
Strz: posts big blind $6
*** HOLE CARDS ***
mikimiki88: folds 
king10clubs: folds 
baoyi2012: folds 
floriiiiider has timed out
floriiiiider: folds 
teunuss: folds 
Uncalled bet ($3) returned to Strz
Strz collected $6 from pot
*** SUMMARY ***
Total pot $6 | Rake $0 
Seat 1: teunuss (small blind) folded before Flop
Seat 2: Strz (big blind) collected ($6)
Seat 3: mikimiki88 folded before Flop (didn't bet)
Seat 4: king10clubs folded before Flop (didn't bet)
Seat 5: baoyi2012 folded before Flop (didn't bet)
Seat 6: floriiiiider (button) folded before Flop (didn't bet)


PokerStars Game #102624394635:  Hold'em No Limit ($3/$6 USD) - 2013/08/11 16:47:36 ET
Table 'Crux V 40-100 bb' 6-max Seat #1 is the button
Seat 1: teunuss ($719.85 in chips) 
Seat 2: Strz ($777.10 in chips) 
Seat 3: mikimiki88 ($1337.67 in chips) 
Seat 4: king10clubs ($674.18 in chips) 
Seat 5: baoyi2012 ($479.07 in chips) 
Seat 6: floriiiiider ($600 in chips) 
Strz: posts small blind $3
mikimiki88: posts big blind $6
*** HOLE CARDS ***
king10clubs: raises $9 to $15
baoyi2012: calls $15
floriiiiider: folds 
teunuss: calls $15
Strz: folds 
mikimiki88: calls $9
*** FLOP *** [5c Qc 3d]
mikimiki88: checks 
king10clubs: checks 
baoyi2012: bets $54
teunuss: folds 
mikimiki88: folds 
king10clubs: folds 
Uncalled bet ($54) returned to baoyi2012
baoyi2012 collected $60.20 from pot
*** SUMMARY ***
Total pot $63 | Rake $2.80 
Board [5c Qc 3d]
Seat 1: teunuss (button) folded on the Flop
Seat 2: Strz (small blind) folded before Flop
Seat 3: mikimiki88 (big blind) folded on the Flop
Seat 4: king10clubs folded on the Flop
Seat 5: baoyi2012 collected ($60.20)
Seat 6: floriiiiider folded before Flop (didn't bet)


PokerStars Game #102624433486:  Hold'em No Limit ($3/$6 USD) - 2013/08/11 16:48:24 ET
Table 'Crux V 40-100 bb' 6-max Seat #2 is the button
Seat 1: teunuss ($704.85 in chips) 
Seat 2: Strz ($774.10 in chips) 
Seat 3: mikimiki88 ($1322.67 in chips) 
Seat 4: king10clubs ($659.18 in chips) 
Seat 5: baoyi2012 ($524.27 in chips) 
Seat 6: floriiiiider ($600 in chips) 
mikimiki88: posts small blind $3
king10clubs: posts big blind $6
*** HOLE CARDS ***
baoyi2012: folds 
floriiiiider: folds 
teunuss: raises $9 to $15
Strz: folds 
mikimiki88: folds 
king10clubs: folds 
Uncalled bet ($9) returned to teunuss
teunuss collected $15 from pot
teunuss: doesn't show hand 
*** SUMMARY ***
Total pot $15 | Rake $0 
Seat 1: teunuss collected ($15)
Seat 2: Strz (button) folded before Flop (didn't bet)
Seat 3: mikimiki88 (small blind) folded before Flop
Seat 4: king10clubs (big blind) folded before Flop
Seat 5: baoyi2012 folded before Flop (didn't bet)
Seat 6: floriiiiider folded before Flop (didn't bet)


PokerStars Game #102624457788:  Hold'em No Limit ($3/$6 USD) - 2013/08/11 16:48:54 ET
Table 'Crux V 40-100 bb' 6-max Seat #3 is the button
Seat 1: teunuss ($713.85 in chips) 
Seat 2: Strz ($774.10 in chips) 
Seat 3: mikimiki88 ($1319.67 in chips) 
Seat 4: king10clubs ($653.18 in chips) 
Seat 5: baoyi2012 ($524.27 in chips) 
Seat 6: floriiiiider ($600 in chips) 
king10clubs: posts small blind $3
baoyi2012: posts big blind $6
*** HOLE CARDS ***
floriiiiider: folds 
teunuss: raises $9 to $15
Strz: folds 
mikimiki88: folds 
king10clubs: folds 
baoyi2012: folds 
Uncalled bet ($9) returned to teunuss
teunuss collected $15 from pot
teunuss: doesn't show hand 
*** SUMMARY ***
Total pot $15 | Rake $0 
Seat 1: teunuss collected ($15)
Seat 2: Strz folded before Flop (didn't bet)
Seat 3: mikimiki88 (button) folded before Flop (didn't bet)
Seat 4: king10clubs (small blind) folded before Flop
Seat 5: baoyi2012 (big blind) folded before Flop
Seat 6: floriiiiider folded before Flop (didn't bet)


PokerStars Game #102624475878:  Hold'em No Limit ($3/$6 USD) - 2013/08/11 16:49:16 ET
Table 'Crux V 40-100 bb' 6-max Seat #4 is the button
Seat 1: teunuss ($722.85 in chips) 
Seat 2: Strz ($774.10 in chips) 
Seat 3: mikimiki88 ($1319.67 in chips) 
Seat 4: king10clubs ($650.18 in chips) 
Seat 5: baoyi2012 ($518.27 in chips) 
Seat 6: floriiiiider ($600 in chips) 
baoyi2012: posts small blind $3
floriiiiider: posts big blind $6
*** HOLE CARDS ***
teunuss: folds 
Strz: raises $12 to $18
mikimiki88: folds 
king10clubs: folds 
baoyi2012: folds 
floriiiiider: folds 
Uncalled bet ($12) returned to Strz
Strz collected $15 from pot
*** SUMMARY ***
Total pot $15 | Rake $0 
Seat 1: teunuss folded before Flop (didn't bet)
Seat 2: Strz collected ($15)
Seat 3: mikimiki88 folded before Flop (didn't bet)
Seat 4: king10clubs (button) folded before Flop (didn't bet)
Seat 5: baoyi2012 (small blind) folded before Flop
Seat 6: floriiiiider (big blind) folded before Flop


PokerStars Game #102624496337:  Hold'em No Limit ($3/$6 USD) - 2013/08/11 16:49:41 ET
Table 'Crux V 40-100 bb' 6-max Seat #5 is the button
Seat 1: teunuss ($722.85 in chips) 
Seat 2: Strz ($783.10 in chips) 
Seat 3: mikimiki88 ($1319.67 in chips) 
Seat 4: king10clubs ($650.18 in chips) 
Seat 5: baoyi2012 ($515.27 in chips) 
Seat 6: floriiiiider ($600 in chips) 
floriiiiider: posts small blind $3
teunuss: posts big blind $6
*** HOLE CARDS ***
Strz: folds 
mikimiki88: folds 
king10clubs: folds 
baoyi2012: folds 
floriiiiider: folds 
Uncalled bet ($3) returned to teunuss
teunuss collected $6 from pot
teunuss: doesn't show hand 
*** SUMMARY ***
Total pot $6 | Rake $0 
Seat 1: teunuss (big blind) collected ($6)
Seat 2: Strz folded before Flop (didn't bet)
Seat 3: mikimiki88 folded before Flop (didn't bet)
Seat 4: king10clubs folded before Flop (didn't bet)
Seat 5: baoyi2012 (button) folded before Flop (didn't bet)
Seat 6: floriiiiider (small blind) folded before Flop


PokerStars Game #102624507594:  Hold'em No Limit ($3/$6 USD) - 2013/08/11 16:49:54 ET
Table 'Crux V 40-100 bb' 6-max Seat #6 is the button
Seat 1: teunuss ($725.85 in chips) 
Seat 2: Strz ($783.10 in chips) 
Seat 3: mikimiki88 ($1319.67 in chips) 
Seat 4: king10clubs ($650.18 in chips) 
Seat 5: baoyi2012 ($515.27 in chips) 
Seat 6: floriiiiider ($600 in chips) 
teunuss: posts small blind $3
Strz: posts big blind $6
*** HOLE CARDS ***
mikimiki88: folds 
king10clubs: folds 
baoyi2012: raises $12 to $18
floriiiiider: folds 
teunuss: folds 
Strz: folds 
Uncalled bet ($12) returned to baoyi2012
baoyi2012 collected $15 from pot
*** SUMMARY ***
Total pot $15 | Rake $0 
Seat 1: teunuss (small blind) folded before Flop
Seat 2: Strz (big blind) folded before Flop
Seat 3: mikimiki88 folded before Flop (didn't bet)
Seat 4: king10clubs folded before Flop (didn't bet)
Seat 5: baoyi2012 collected ($15)
Seat 6: floriiiiider (button) folded before Flop (didn't bet)


PokerStars Game #102626380118:  Hold'em No Limit ($3/$6 USD) - 2013/08/11 17:30:09 ET
Table 'Crux V 40-100 bb' 6-max Seat #4 is the button
Seat 1: teunuss ($881.13 in chips) 
Seat 3: mikimiki88 ($907.95 in chips) 
Seat 4: king10clubs ($600 in chips) 
teunuss: posts small blind $3
mikimiki88: posts big blind $6
*** HOLE CARDS ***
king10clubs: raises $6 to $12
teunuss: calls $9
mikimiki88: folds 
*** FLOP *** [Qh 9c 4d]
teunuss: checks 
king10clubs: bets $21
teunuss: calls $21
*** TURN *** [Qh 9c 4d] [Qd]
teunuss: checks 
king10clubs: bets $42
teunuss: folds 
Uncalled bet ($42) returned to king10clubs
king10clubs collected $70.50 from pot
king10clubs: doesn't show hand 
*** SUMMARY ***
Total pot $72 | Rake $1.50 
Board [Qh 9c 4d Qd]
Seat 1: teunuss (small blind) folded on the Turn
Seat 3: mikimiki88 (big blind) folded before Flop
Seat 4: king10clubs (button) collected ($70.50)


PokerStars Game #102626410146:  Hold'em No Limit ($3/$6 USD) - 2013/08/11 17:30:47 ET
Table 'Crux V 40-100 bb' 6-max Seat #1 is the button
Seat 1: teunuss ($848.13 in chips) 
Seat 3: mikimiki88 ($901.95 in chips) 
Seat 4: king10clubs ($637.50 in chips) 
mikimiki88: posts small blind $3
king10clubs: posts big blind $6
*** HOLE CARDS ***
teunuss: raises $6 to $12
mikimiki88: folds 
king10clubs: calls $6
*** FLOP *** [8s 5s 5h]
king10clubs: checks 
teunuss: checks 
*** TURN *** [8s 5s 5h] [4h]
king10clubs: checks 
teunuss: checks 
*** RIVER *** [8s 5s 5h 4h] [Kc]
king10clubs: checks 
teunuss: checks 
*** SHOW DOWN ***
king10clubs: shows [2d 2s] (two pair, Fives and Deuces)
teunuss: mucks hand 
king10clubs collected $25.78 from pot
*** SUMMARY ***
Total pot $27 | Rake $1.22 
Board [8s 5s 5h 4h Kc]
Seat 1: teunuss (button) mucked
Seat 3: mikimiki88 (small blind) folded before Flop
Seat 4: king10clubs (big blind) showed [2d 2s] and won ($25.78) with two pair, Fives and Deuces


PokerStars Game #102626430226:  Hold'em No Limit ($3/$6 USD) - 2013/08/11 17:31:13 ET
Table 'Crux V 40-100 bb' 6-max Seat #3 is the button
Seat 1: teunuss ($836.13 in chips) 
Seat 3: mikimiki88 ($898.95 in chips) 
Seat 4: king10clubs ($651.28 in chips) 
king10clubs: posts small blind $3
teunuss: posts big blind $6
*** HOLE CARDS ***
mikimiki88: raises $6 to $12
king10clubs: folds 
teunuss: calls $6
*** FLOP *** [Kc Th 4s]
teunuss: checks 
mikimiki88: checks 
*** TURN *** [Kc Th 4s] [7c]
teunuss: bets $21
mikimiki88: calls $21
*** RIVER *** [Kc Th 4s 7c] [9d]
teunuss: bets $48
__P0o_P0o__ joins the table at seat #6 
Stubbikoenig joins the table at seat #2 
DeluxeSamy joins the table at seat #5 
mikimiki88: folds 
Uncalled bet ($48) returned to teunuss
teunuss collected $67.50 from pot
teunuss: doesn't show hand 
*** SUMMARY ***
Total pot $69 | Rake $1.50 
Board [Kc Th 4s 7c 9d]
Seat 1: teunuss (big blind) collected ($67.50)
Seat 3: mikimiki88 (button) folded on the River
Seat 4: king10clubs (small blind) folded before Flop


PokerStars Game #102626480726:  Hold'em No Limit ($3/$6 USD) - 2013/08/11 17:32:17 ET
Table 'Crux V 40-100 bb' 6-max Seat #4 is the button
Seat 1: teunuss ($870.63 in chips) 
Seat 2: Stubbikoenig ($600 in chips) 
Seat 3: mikimiki88 ($865.95 in chips) 
Seat 4: king10clubs ($648.28 in chips) 
DeluxeSamy will be allowed to play after the button
__P0o_P0o__ will be allowed to play after the button
teunuss: posts small blind $3
Stubbikoenig: posts big blind $6
*** HOLE CARDS ***
mikimiki88: raises $6 to $12
king10clubs: folds 
DeluxeSamy leaves the table
teunuss: folds 
Stubbikoenig: folds 
Uncalled bet ($6) returned to mikimiki88
mikimiki88 collected $15 from pot
mikimiki88: doesn't show hand 
*** SUMMARY ***
Total pot $15 | Rake $0 
Seat 1: teunuss (small blind) folded before Flop
Seat 2: Stubbikoenig (big blind) folded before Flop
Seat 3: mikimiki88 collected ($15)
Seat 4: king10clubs (button) folded before Flop (didn't bet)


PokerStars Game #102626491491:  Hold'em No Limit ($3/$6 USD) - 2013/08/11 17:32:31 ET
Table 'Crux V 40-100 bb' 6-max Seat #1 is the button
Seat 1: teunuss ($867.63 in chips) 
Seat 2: Stubbikoenig ($600 in chips) 
Seat 3: mikimiki88 ($874.95 in chips) 
Seat 4: king10clubs ($648.28 in chips) 
Stubbikoenig: posts small blind $3
mikimiki88: posts big blind $6
__P0o_P0o__: sits out 
*** HOLE CARDS ***
king10clubs: folds 
teunuss: raises $6 to $12
Stubbikoenig: folds 
mikimiki88: folds 
Uncalled bet ($6) returned to teunuss
teunuss collected $15 from pot
teunuss: doesn't show hand 
*** SUMMARY ***
Total pot $15 | Rake $0 
Seat 1: teunuss (button) collected ($15)
Seat 2: Stubbikoenig (small blind) folded before Flop
Seat 3: mikimiki88 (big blind) folded before Flop
Seat 4: king10clubs folded before Flop (didn't bet)


PokerStars Game #102626504139:  Hold'em No Limit ($3/$6 USD) - 2013/08/11 17:32:47 ET
Table 'Crux V 40-100 bb' 6-max Seat #2 is the button
Seat 1: teunuss ($876.63 in chips) 
Seat 2: Stubbikoenig ($600 in chips) 
Seat 3: mikimiki88 ($868.95 in chips) 
Seat 4: king10clubs ($648.28 in chips) 
mikimiki88: posts small blind $3
king10clubs: posts big blind $6
__P0o_P0o__: sits out 
*** HOLE CARDS ***
teunuss: folds 
Stubbikoenig: raises $6 to $12
mikimiki88: raises $33 to $45
king10clubs: folds 
Stubbikoenig: folds 
Uncalled bet ($33) returned to mikimiki88
mikimiki88 collected $30 from pot
mikimiki88: doesn't show hand 
*** SUMMARY ***
Total pot $30 | Rake $0 
Seat 1: teunuss folded before Flop (didn't bet)
Seat 2: Stubbikoenig (button) folded before Flop
Seat 3: mikimiki88 (small blind) collected ($30)
Seat 4: king10clubs (big blind) folded before Flop


PokerStars Game #102626521713:  Hold'em No Limit ($3/$6 USD) - 2013/08/11 17:33:09 ET
Table 'Crux V 40-100 bb' 6-max Seat #3 is the button
Seat 1: teunuss ($876.63 in chips) 
Seat 2: Stubbikoenig ($600 in chips) 
Seat 3: mikimiki88 ($886.95 in chips) 
Seat 4: king10clubs ($642.28 in chips) 
Seat 6: __P0o_P0o__ ($240 in chips) 
king10clubs: posts small blind $3
__P0o_P0o__: posts big blind $6
*** HOLE CARDS ***
teunuss: raises $9 to $15
Stubbikoenig: folds 
GregAndrek joins the table at seat #5 
mikimiki88: calls $15
king10clubs: folds 
__P0o_P0o__: folds 
*** FLOP *** [6s Js Qd]
teunuss: bets $27
mikimiki88: calls $27
*** TURN *** [6s Js Qd] [Kc]
teunuss: checks 
mikimiki88: checks 
*** RIVER *** [6s Js Qd Kc] [9h]
teunuss: checks 
mikimiki88: bets $73.96
teunuss: folds 
Uncalled bet ($73.96) returned to mikimiki88
mikimiki88 collected $90.20 from pot
mikimiki88: doesn't show hand 
*** SUMMARY ***
Total pot $93 | Rake $2.80 
Board [6s Js Qd Kc 9h]
Seat 1: teunuss folded on the River
Seat 2: Stubbikoenig folded before Flop (didn't bet)
Seat 3: mikimiki88 (button) collected ($90.20)
Seat 4: king10clubs (small blind) folded before Flop
Seat 6: __P0o_P0o__ (big blind) folded before Flop


PokerStars Game #102626567735:  Hold'em No Limit ($3/$6 USD) - 2013/08/11 17:34:08 ET
Table 'Crux V 40-100 bb' 6-max Seat #6 is the button
Seat 1: teunuss ($834.63 in chips) 
Seat 2: Stubbikoenig ($600 in chips) 
Seat 3: mikimiki88 ($935.15 in chips) 
Seat 6: __P0o_P0o__ ($234 in chips) 
teunuss: posts small blind $3
Stubbikoenig: posts big blind $6
GregAndrek: sits out 
*** HOLE CARDS ***
mikimiki88: raises $12 to $18
__P0o_P0o__: folds 
teunuss: folds 
Stubbikoenig: folds 
Uncalled bet ($12) returned to mikimiki88
mikimiki88 collected $15 from pot
mikimiki88: doesn't show hand 
*** SUMMARY ***
Total pot $15 | Rake $0 
Seat 1: teunuss (small blind) folded before Flop
Seat 2: Stubbikoenig (big blind) folded before Flop
Seat 3: mikimiki88 collected ($15)
Seat 6: __P0o_P0o__ (button) folded before Flop (didn't bet)


PokerStars Game #102626584009:  Hold'em No Limit ($3/$6 USD) - 2013/08/11 17:34:28 ET
Table 'Crux V 40-100 bb' 6-max Seat #1 is the button
Seat 1: teunuss ($831.63 in chips) 
Seat 2: Stubbikoenig ($600 in chips) 
Seat 3: mikimiki88 ($944.15 in chips) 
Seat 6: __P0o_P0o__ ($234 in chips) 
Stubbikoenig: posts small blind $3
mikimiki88: posts big blind $6
GregAndrek: sits out 
*** HOLE CARDS ***
__P0o_P0o__: folds 
teunuss: folds 
Stubbikoenig: folds 
Uncalled bet ($3) returned to mikimiki88
mikimiki88 collected $6 from pot
mikimiki88: doesn't show hand 
*** SUMMARY ***
Total pot $6 | Rake $0 
Seat 1: teunuss (button) folded before Flop (didn't bet)
Seat 2: Stubbikoenig (small blind) folded before Flop
Seat 3: mikimiki88 (big blind) collected ($6)
Seat 6: __P0o_P0o__ folded before Flop (didn't bet)


PokerStars Game #102626588216:  Hold'em No Limit ($3/$6 USD) - 2013/08/11 17:34:34 ET
Table 'Crux V 40-100 bb' 6-max Seat #2 is the button
Seat 1: teunuss ($831.63 in chips) 
Seat 2: Stubbikoenig ($600 in chips) 
Seat 3: mikimiki88 ($947.15 in chips) 
Seat 5: GregAndrek ($600 in chips) 
Seat 6: __P0o_P0o__ ($234 in chips) 
mikimiki88: posts small blind $3
GregAndrek: posts big blind $6
*** HOLE CARDS ***
__P0o_P0o__: folds 
teunuss: raises $9 to $15
Stubbikoenig: folds 
mikimiki88: folds 
GregAndrek: folds 
Uncalled bet ($9) returned to teunuss
teunuss collected $15 from pot
teunuss: doesn't show hand 
*** SUMMARY ***
Total pot $15 | Rake $0 
Seat 1: teunuss collected ($15)
Seat 2: Stubbikoenig (button) folded before Flop (didn't bet)
Seat 3: mikimiki88 (small blind) folded before Flop
Seat 5: GregAndrek (big blind) folded before Flop
Seat 6: __P0o_P0o__ folded before Flop (didn't bet)


PokerStars Game #102626600718:  Hold'em No Limit ($3/$6 USD) - 2013/08/11 17:34:50 ET
Table 'Crux V 40-100 bb' 6-max Seat #3 is the button
Seat 1: teunuss ($840.63 in chips) 
Seat 2: Stubbikoenig ($600 in chips) 
Seat 3: mikimiki88 ($944.15 in chips) 
Seat 5: GregAndrek ($600 in chips) 
Seat 6: __P0o_P0o__ ($234 in chips) 
GregAndrek: posts small blind $3
__P0o_P0o__: posts big blind $6
*** HOLE CARDS ***
teunuss: raises $12 to $18
Stubbikoenig: folds 
mikimiki88: folds 
GregAndrek: folds 
__P0o_P0o__: folds 
Uncalled bet ($12) returned to teunuss
teunuss collected $15 from pot
teunuss: doesn't show hand 
*** SUMMARY ***
Total pot $15 | Rake $0 
Seat 1: teunuss collected ($15)
Seat 2: Stubbikoenig folded before Flop (didn't bet)
Seat 3: mikimiki88 (button) folded before Flop (didn't bet)
Seat 5: GregAndrek (small blind) folded before Flop
Seat 6: __P0o_P0o__ (big blind) folded before Flop


PokerStars Game #102626144529:  Hold'em No Limit ($3/$6 USD) - 2013/08/11 17:25:11 ET
Table 'Crux V 40-100 bb' 6-max Seat #5 is the button
Seat 1: teunuss ($687.20 in chips) 
Seat 2: Strz ($891.12 in chips) 
Seat 3: mikimiki88 ($983.72 in chips) 
Seat 4: king10clubs ($615 in chips) 
Seat 5: baoyi2012 ($1860.57 in chips) 
Seat 6: floriiiiider ($645.20 in chips) 
floriiiiider: posts small blind $3
teunuss: posts big blind $6
*** HOLE CARDS ***
Strz: folds 
mikimiki88: folds 
king10clubs: folds 
baoyi2012: raises $6 to $12
floriiiiider: raises $33 to $45
teunuss: folds 
baoyi2012: calls $33
*** FLOP *** [Jd 4c 6s]
floriiiiider: bets $63
baoyi2012: folds 
Uncalled bet ($63) returned to floriiiiider
floriiiiider collected $93.20 from pot
floriiiiider: doesn't show hand 
*** SUMMARY ***
Total pot $96 | Rake $2.80 
Board [Jd 4c 6s]
Seat 1: teunuss (big blind) folded before Flop
Seat 2: Strz folded before Flop (didn't bet)
Seat 3: mikimiki88 folded before Flop (didn't bet)
Seat 4: king10clubs folded before Flop (didn't bet)
Seat 5: baoyi2012 (button) folded on the Flop
Seat 6: floriiiiider (small blind) collected ($93.20)


PokerStars Game #102626180011:  Hold'em No Limit ($3/$6 USD) - 2013/08/11 17:25:55 ET
Table 'Crux V 40-100 bb' 6-max Seat #6 is the button
Seat 1: teunuss ($681.20 in chips) 
Seat 2: Strz ($891.12 in chips) 
Seat 3: mikimiki88 ($983.72 in chips) 
Seat 4: king10clubs ($615 in chips) 
Seat 5: baoyi2012 ($1815.57 in chips) 
Seat 6: floriiiiider ($693.40 in chips) 
teunuss: posts small blind $3
Strz: posts big blind $6
*** HOLE CARDS ***
mikimiki88: folds 
king10clubs: folds 
baoyi2012: folds 
floriiiiider: raises $6 to $12
teunuss: folds 
Strz: calls $6
*** FLOP *** [2c 6h Qd]
Strz: checks 
floriiiiider: checks 
*** TURN *** [2c 6h Qd] [6c]
Strz: checks 
floriiiiider: checks 
*** RIVER *** [2c 6h Qd 6c] [Kh]
Strz: checks 
floriiiiider: checks 
*** SHOW DOWN ***
Strz: shows [Kd 7d] (two pair, Kings and Sixes)
floriiiiider: mucks hand 
Strz collected $25.78 from pot
*** SUMMARY ***
Total pot $27 | Rake $1.22 
Board [2c 6h Qd 6c Kh]
Seat 1: teunuss (small blind) folded before Flop
Seat 2: Strz (big blind) showed [Kd 7d] and won ($25.78) with two pair, Kings and Sixes
Seat 3: mikimiki88 folded before Flop (didn't bet)
Seat 4: king10clubs folded before Flop (didn't bet)
Seat 5: baoyi2012 folded before Flop (didn't bet)
Seat 6: floriiiiider (button) mucked


PokerStars Game #102626204459:  Hold'em No Limit ($3/$6 USD) - 2013/08/11 17:26:26 ET
Table 'Crux V 40-100 bb' 6-max Seat #1 is the button
Seat 1: teunuss ($678.20 in chips) 
Seat 2: Strz ($904.90 in chips) 
Seat 3: mikimiki88 ($983.72 in chips) 
Seat 4: king10clubs ($615 in chips) 
Seat 5: baoyi2012 ($1815.57 in chips) 
Seat 6: floriiiiider ($681.40 in chips) 
Strz: posts small blind $3
mikimiki88: posts big blind $6
*** HOLE CARDS ***
king10clubs: folds 
baoyi2012: raises $6 to $12
floriiiiider: folds 
teunuss: raises $30 to $42
Strz: folds 
mikimiki88: folds 
baoyi2012: folds 
Uncalled bet ($30) returned to teunuss
teunuss collected $33 from pot
teunuss: doesn't show hand 
*** SUMMARY ***
Total pot $33 | Rake $0 
Seat 1: teunuss (button) collected ($33)
Seat 2: Strz (small blind) folded before Flop
Seat 3: mikimiki88 (big blind) folded before Flop
Seat 4: king10clubs folded before Flop (didn't bet)
Seat 5: baoyi2012 folded before Flop
Seat 6: floriiiiider folded before Flop (didn't bet)


PokerStars Game #102626219356:  Hold'em No Limit ($3/$6 USD) - 2013/08/11 17:26:45 ET
Table 'Crux V 40-100 bb' 6-max Seat #2 is the button
Seat 1: teunuss ($699.20 in chips) 
Seat 2: Strz ($901.90 in chips) 
Seat 3: mikimiki88 ($977.72 in chips) 
Seat 4: king10clubs ($615 in chips) 
Seat 5: baoyi2012 ($1803.57 in chips) 
Seat 6: floriiiiider ($681.40 in chips) 
mikimiki88: posts small blind $3
king10clubs: posts big blind $6
*** HOLE CARDS ***
baoyi2012: folds 
baoyi2012 leaves the table
floriiiiider: raises $12 to $18
teunuss: calls $18
Strz: calls $18
mikimiki88: folds 
king10clubs: calls $12
*** FLOP *** [Tc Qc As]
king10clubs: checks 
floriiiiider: checks 
GregAndrek joins the table at seat #5 
teunuss: bets $51
GregAndrek leaves the table
Strz: folds 
king10clubs: calls $51
floriiiiider: folds 
*** TURN *** [Tc Qc As] [Qs]
king10clubs: checks 
teunuss: bets $138
king10clubs: folds 
Uncalled bet ($138) returned to teunuss
teunuss collected $174.20 from pot
teunuss: doesn't show hand 
*** SUMMARY ***
Total pot $177 | Rake $2.80 
Board [Tc Qc As Qs]
Seat 1: teunuss collected ($174.20)
Seat 2: Strz (button) folded on the Flop
Seat 3: mikimiki88 (small blind) folded before Flop
Seat 4: king10clubs (big blind) folded on the Turn
Seat 5: baoyi2012 folded before Flop (didn't bet)
Seat 6: floriiiiider folded on the Flop


PokerStars Game #102626286889:  Hold'em No Limit ($3/$6 USD) - 2013/08/11 17:28:11 ET
Table 'Crux V 40-100 bb' 6-max Seat #3 is the button
Seat 1: teunuss ($804.40 in chips) 
Seat 2: Strz ($883.90 in chips) 
Seat 3: mikimiki88 ($974.72 in chips) 
Seat 4: king10clubs ($600 in chips) 
king10clubs: posts small blind $3
floriiiiider: is sitting out 
teunuss: posts big blind $6
*** HOLE CARDS ***
Strz: folds 
floriiiiider leaves the table
mikimiki88: raises $6 to $12
king10clubs: folds 
teunuss: folds 
Uncalled bet ($6) returned to mikimiki88
mikimiki88 collected $15 from pot
mikimiki88: doesn't show hand 
*** SUMMARY ***
Total pot $15 | Rake $0 
Seat 1: teunuss (big blind) folded before Flop
Seat 2: Strz folded before Flop (didn't bet)
Seat 3: mikimiki88 (button) collected ($15)
Seat 4: king10clubs (small blind) folded before Flop


PokerStars Game #102626297820:  Hold'em No Limit ($3/$6 USD) - 2013/08/11 17:28:25 ET
Table 'Crux V 40-100 bb' 6-max Seat #4 is the button
Seat 1: teunuss ($798.40 in chips) 
Seat 2: Strz ($883.90 in chips) 
Seat 3: mikimiki88 ($983.72 in chips) 
Seat 4: king10clubs ($600 in chips) 
teunuss: posts small blind $3
Strz: posts big blind $6
*** HOLE CARDS ***
mikimiki88: folds 
king10clubs: raises $6 to $12
teunuss: folds 
Strz: folds 
Uncalled bet ($6) returned to king10clubs
king10clubs collected $15 from pot
king10clubs: doesn't show hand 
*** SUMMARY ***
Total pot $15 | Rake $0 
Seat 1: teunuss (small blind) folded before Flop
Seat 2: Strz (big blind) folded before Flop
Seat 3: mikimiki88 folded before Flop (didn't bet)
Seat 4: king10clubs (button) collected ($15)


PokerStars Game #102626304580:  Hold'em No Limit ($3/$6 USD) - 2013/08/11 17:28:34 ET
Table 'Crux V 40-100 bb' 6-max Seat #1 is the button
Seat 1: teunuss ($795.40 in chips) 
Seat 2: Strz ($877.90 in chips) 
Seat 3: mikimiki88 ($983.72 in chips) 
Seat 4: king10clubs ($609 in chips) 
Strz: posts small blind $3
mikimiki88: posts big blind $6
*** HOLE CARDS ***
king10clubs: folds 
teunuss: raises $6 to $12
Strz: folds 
mikimiki88: calls $6
*** FLOP *** [7h Kd As]
mikimiki88: checks 
teunuss: checks 
*** TURN *** [7h Kd As] [8s]
mikimiki88: bets $21.13
teunuss: calls $21.13
*** RIVER *** [7h Kd As 8s] [4h]
mikimiki88: bets $48.10
teunuss: calls $48.10
*** SHOW DOWN ***
mikimiki88: shows [9c Ts] (high card Ace)
teunuss: shows [Ah 5c] (a pair of Aces)
teunuss collected $163.96 from pot
*** SUMMARY ***
Total pot $165.46 | Rake $1.50 
Board [7h Kd As 8s 4h]
Seat 1: teunuss (button) showed [Ah 5c] and won ($163.96) with a pair of Aces
Seat 2: Strz (small blind) folded before Flop
Seat 3: mikimiki88 (big blind) showed [9c Ts] and lost with high card Ace
Seat 4: king10clubs folded before Flop (didn't bet)


PokerStars Game #102626333249:  Hold'em No Limit ($3/$6 USD) - 2013/08/11 17:29:10 ET
Table 'Crux V 40-100 bb' 6-max Seat #2 is the button
Seat 1: teunuss ($878.13 in chips) 
Seat 2: Strz ($874.90 in chips) 
Seat 3: mikimiki88 ($902.49 in chips) 
Seat 4: king10clubs ($609 in chips) 
mikimiki88: posts small blind $3
king10clubs: posts big blind $6
*** HOLE CARDS ***
teunuss: folds 
Ner4zzurri joins the table at seat #5 
Ner4zzurri leaves the table
Strz: folds 
mikimiki88: calls $3
king10clubs: checks 
*** FLOP *** [9h Jh Ah]
mikimiki88: bets $9.39
king10clubs: folds 
Uncalled bet ($9.39) returned to mikimiki88
mikimiki88 collected $11.46 from pot
mikimiki88: doesn't show hand 
*** SUMMARY ***
Total pot $12 | Rake $0.54 
Board [9h Jh Ah]
Seat 1: teunuss folded before Flop (didn't bet)
Seat 2: Strz (button) folded before Flop (didn't bet)
Seat 3: mikimiki88 (small blind) collected ($11.46)
Seat 4: king10clubs (big blind) folded on the Flop


PokerStars Game #102626372380:  Hold'em No Limit ($3/$6 USD) - 2013/08/11 17:29:59 ET
Table 'Crux V 40-100 bb' 6-max Seat #3 is the button
Seat 1: teunuss ($878.13 in chips) 
Seat 2: Strz ($874.90 in chips) 
Seat 3: mikimiki88 ($907.95 in chips) 
Seat 4: king10clubs ($603 in chips) 
king10clubs: posts small blind $3
teunuss: posts big blind $6
*** HOLE CARDS ***
Strz: folds 
Strz leaves the table
mikimiki88: folds 
king10clubs: folds 
Uncalled bet ($3) returned to teunuss
teunuss collected $6 from pot
teunuss: doesn't show hand 
*** SUMMARY ***
Total pot $6 | Rake $0 
Seat 1: teunuss (big blind) collected ($6)
Seat 2: Strz folded before Flop (didn't bet)
Seat 3: mikimiki88 (button) folded before Flop (didn't bet)
Seat 4: king10clubs (small blind) folded before Flop


PokerStars Game #102625918400:  Hold'em No Limit ($3/$6 USD) - 2013/08/11 17:20:29 ET
Table 'Crux V 40-100 bb' 6-max Seat #5 is the button
Seat 1: teunuss ($696.20 in chips) 
Seat 2: Strz ($960.12 in chips) 
Seat 3: mikimiki88 ($1319.85 in chips) 
Seat 4: king10clubs ($639 in chips) 
Seat 5: baoyi2012 ($1432.60 in chips) 
Seat 6: floriiiiider ($645.20 in chips) 
floriiiiider: posts small blind $3
teunuss: posts big blind $6
*** HOLE CARDS ***
Strz: folds 
mikimiki88: folds 
king10clubs: folds 
baoyi2012: folds 
floriiiiider: raises $12 to $18
teunuss: folds 
Uncalled bet ($12) returned to floriiiiider
floriiiiider collected $12 from pot
floriiiiider: doesn't show hand 
*** SUMMARY ***
Total pot $12 | Rake $0 
Seat 1: teunuss (big blind) folded before Flop
Seat 2: Strz folded before Flop (didn't bet)
Seat 3: mikimiki88 folded before Flop (didn't bet)
Seat 4: king10clubs folded before Flop (didn't bet)
Seat 5: baoyi2012 (button) folded before Flop (didn't bet)
Seat 6: floriiiiider (small blind) collected ($12)


PokerStars Game #102625938598:  Hold'em No Limit ($3/$6 USD) - 2013/08/11 17:20:54 ET
Table 'Crux V 40-100 bb' 6-max Seat #6 is the button
Seat 1: teunuss ($690.20 in chips) 
Seat 2: Strz ($960.12 in chips) 
Seat 3: mikimiki88 ($1319.85 in chips) 
Seat 4: king10clubs ($639 in chips) 
Seat 5: baoyi2012 ($1432.60 in chips) 
Seat 6: floriiiiider ($651.20 in chips) 
teunuss: posts small blind $3
Strz: posts big blind $6
*** HOLE CARDS ***
mikimiki88: folds 
king10clubs: raises $9 to $15
baoyi2012: calls $15
floriiiiider: folds 
teunuss: folds 
Strz: folds 
*** FLOP *** [6h Qc 3h]
king10clubs: checks 
baoyi2012: bets $30
king10clubs: folds 
Uncalled bet ($30) returned to baoyi2012
baoyi2012 collected $37.24 from pot
*** SUMMARY ***
Total pot $39 | Rake $1.76 
Board [6h Qc 3h]
Seat 1: teunuss (small blind) folded before Flop
Seat 2: Strz (big blind) folded before Flop
Seat 3: mikimiki88 folded before Flop (didn't bet)
Seat 4: king10clubs folded on the Flop
Seat 5: baoyi2012 collected ($37.24)
Seat 6: floriiiiider (button) folded before Flop (didn't bet)


PokerStars Game #102625964716:  Hold'em No Limit ($3/$6 USD) - 2013/08/11 17:21:26 ET
Table 'Crux V 40-100 bb' 6-max Seat #1 is the button
Seat 1: teunuss ($687.20 in chips) 
Seat 2: Strz ($954.12 in chips) 
Seat 3: mikimiki88 ($1319.85 in chips) 
Seat 4: king10clubs ($624 in chips) 
Seat 5: baoyi2012 ($1454.84 in chips) 
Seat 6: floriiiiider ($651.20 in chips) 
Strz: posts small blind $3
mikimiki88: posts big blind $6
*** HOLE CARDS ***
king10clubs: folds 
baoyi2012: raises $6 to $12
floriiiiider: folds 
teunuss: folds 
Strz: folds 
mikimiki88: calls $6
*** FLOP *** [3h 5h 8c]
mikimiki88: checks 
baoyi2012: checks 
*** TURN *** [3h 5h 8c] [Qd]
mikimiki88: bets $21.13
baoyi2012: calls $21.13
*** RIVER *** [3h 5h 8c Qd] [Ah]
mikimiki88: checks 
baoyi2012: checks 
*** SHOW DOWN ***
mikimiki88: shows [6s 9s] (high card Ace)
baoyi2012: shows [2s Ac] (a pair of Aces)
baoyi2012 collected $66.46 from pot
*** SUMMARY ***
Total pot $69.26 | Rake $2.80 
Board [3h 5h 8c Qd Ah]
Seat 1: teunuss (button) folded before Flop (didn't bet)
Seat 2: Strz (small blind) folded before Flop
Seat 3: mikimiki88 (big blind) showed [6s 9s] and lost with high card Ace
Seat 4: king10clubs folded before Flop (didn't bet)
Seat 5: baoyi2012 showed [2s Ac] and won ($66.46) with a pair of Aces
Seat 6: floriiiiider folded before Flop (didn't bet)


PokerStars Game #102626001088:  Hold'em No Limit ($3/$6 USD) - 2013/08/11 17:22:11 ET
Table 'Crux V 40-100 bb' 6-max Seat #2 is the button
Seat 1: teunuss ($687.20 in chips) 
Seat 2: Strz ($951.12 in chips) 
Seat 3: mikimiki88 ($1286.72 in chips) 
Seat 4: king10clubs ($624 in chips) 
Seat 5: baoyi2012 ($1488.17 in chips) 
Seat 6: floriiiiider ($651.20 in chips) 
mikimiki88: posts small blind $3
king10clubs: posts big blind $6
*** HOLE CARDS ***
baoyi2012: raises $6 to $12
floriiiiider: folds 
teunuss: folds 
Strz: folds 
mikimiki88: folds 
king10clubs: folds 
Uncalled bet ($6) returned to baoyi2012
baoyi2012 collected $15 from pot
*** SUMMARY ***
Total pot $15 | Rake $0 
Seat 1: teunuss folded before Flop (didn't bet)
Seat 2: Strz (button) folded before Flop (didn't bet)
Seat 3: mikimiki88 (small blind) folded before Flop
Seat 4: king10clubs (big blind) folded before Flop
Seat 5: baoyi2012 collected ($15)
Seat 6: floriiiiider folded before Flop (didn't bet)


PokerStars Game #102626012709:  Hold'em No Limit ($3/$6 USD) - 2013/08/11 17:22:26 ET
Table 'Crux V 40-100 bb' 6-max Seat #3 is the button
Seat 1: teunuss ($687.20 in chips) 
Seat 2: Strz ($951.12 in chips) 
Seat 3: mikimiki88 ($1283.72 in chips) 
Seat 4: king10clubs ($618 in chips) 
Seat 5: baoyi2012 ($1497.17 in chips) 
Seat 6: floriiiiider ($651.20 in chips) 
king10clubs: posts small blind $3
baoyi2012: posts big blind $6
*** HOLE CARDS ***
floriiiiider: folds 
teunuss: folds 
Strz: raises $12 to $18
mikimiki88: calls $18
king10clubs: folds 
baoyi2012: raises $36 to $54
Strz: folds 
mikimiki88: calls $36
*** FLOP *** [Qs 8d Ac]
baoyi2012: bets $102
mikimiki88: calls $102
*** TURN *** [Qs 8d Ac] [7h]
baoyi2012: bets $144
mikimiki88: calls $144
*** RIVER *** [Qs 8d Ac 7h] [6d]
baoyi2012: bets $1197.17 and is all-in
mikimiki88: folds 
Uncalled bet ($1197.17) returned to baoyi2012
baoyi2012 collected $618.20 from pot
*** SUMMARY ***
Total pot $621 | Rake $2.80 
Board [Qs 8d Ac 7h 6d]
Seat 1: teunuss folded before Flop (didn't bet)
Seat 2: Strz folded before Flop
Seat 3: mikimiki88 (button) folded on the River
Seat 4: king10clubs (small blind) folded before Flop
Seat 5: baoyi2012 (big blind) collected ($618.20)
Seat 6: floriiiiider folded before Flop (didn't bet)


PokerStars Game #102626094167:  Hold'em No Limit ($3/$6 USD) - 2013/08/11 17:24:08 ET
Table 'Crux V 40-100 bb' 6-max Seat #4 is the button
Seat 1: teunuss ($687.20 in chips) 
Seat 2: Strz ($933.12 in chips) 
Seat 3: mikimiki88 ($983.72 in chips) 
Seat 4: king10clubs ($615 in chips) 
Seat 5: baoyi2012 ($1815.37 in chips) 
Seat 6: floriiiiider ($651.20 in chips) 
baoyi2012: posts small blind $3
floriiiiider: posts big blind $6
*** HOLE CARDS ***
teunuss: folds 
Strz: raises $12 to $18
mikimiki88: folds 
king10clubs: folds 
baoyi2012: raises $24 to $42
floriiiiider: folds 
Strz: calls $24
*** FLOP *** [2c 5s 4s]
baoyi2012: checks 
Strz: checks 
*** TURN *** [2c 5s 4s] [3d]
baoyi2012: checks 
Strz: checks 
*** RIVER *** [2c 5s 4s 3d] [9c]
baoyi2012: checks 
Strz: checks 
*** SHOW DOWN ***
baoyi2012: shows [Kc Ks] (a pair of Kings)
Strz: mucks hand 
baoyi2012 collected $87.20 from pot
*** SUMMARY ***
Total pot $90 | Rake $2.80 
Board [2c 5s 4s 3d 9c]
Seat 1: teunuss folded before Flop (didn't bet)
Seat 2: Strz mucked
Seat 3: mikimiki88 folded before Flop (didn't bet)
Seat 4: king10clubs (button) folded before Flop (didn't bet)
Seat 5: baoyi2012 (small blind) showed [Kc Ks] and won ($87.20) with a pair of Kings
Seat 6: floriiiiider (big blind) folded before Flop


PokerStars Game #102625688414:  Hold'em No Limit ($3/$6 USD) - 2013/08/11 17:15:48 ET
Table 'Crux V 40-100 bb' 6-max Seat #4 is the button
Seat 1: teunuss ($630.20 in chips) 
Seat 2: Strz ($969.12 in chips) 
Seat 3: mikimiki88 ($1352.85 in chips) 
Seat 4: king10clubs ($670.72 in chips) 
Seat 5: baoyi2012 ($1378.40 in chips) 
Seat 6: floriiiiider ($600 in chips) 
baoyi2012: posts small blind $3
floriiiiider: posts big blind $6
*** HOLE CARDS ***
teunuss: raises $12 to $18
Strz: folds 
mikimiki88: folds 
king10clubs: calls $18
baoyi2012: calls $15
floriiiiider: calls $12
*** FLOP *** [9s Jd Kc]
baoyi2012: checks 
floriiiiider: checks 
teunuss: bets $48
king10clubs: folds 
baoyi2012: calls $48
floriiiiider: folds 
*** TURN *** [9s Jd Kc] [3s]
baoyi2012: checks 
teunuss: checks 
*** RIVER *** [9s Jd Kc 3s] [9c]
baoyi2012: checks 
teunuss: checks 
*** SHOW DOWN ***
baoyi2012: shows [Js Ks] (two pair, Kings and Jacks)
teunuss: mucks hand 
baoyi2012 collected $165.20 from pot
*** SUMMARY ***
Total pot $168 | Rake $2.80 
Board [9s Jd Kc 3s 9c]
Seat 1: teunuss mucked
Seat 2: Strz folded before Flop (didn't bet)
Seat 3: mikimiki88 folded before Flop (didn't bet)
Seat 4: king10clubs (button) folded on the Flop
Seat 5: baoyi2012 (small blind) showed [Js Ks] and won ($165.20) with two pair, Kings and Jacks
Seat 6: floriiiiider (big blind) folded on the Flop


PokerStars Game #102625738223:  Hold'em No Limit ($3/$6 USD) - 2013/08/11 17:16:48 ET
Table 'Crux V 40-100 bb' 6-max Seat #5 is the button
Seat 1: teunuss ($600 in chips) 
Seat 2: Strz ($969.12 in chips) 
Seat 3: mikimiki88 ($1352.85 in chips) 
Seat 4: king10clubs ($652.72 in chips) 
Seat 5: baoyi2012 ($1477.60 in chips) 
Seat 6: floriiiiider ($600 in chips) 
floriiiiider: posts small blind $3
teunuss: posts big blind $6
*** HOLE CARDS ***
Strz: folds 
mikimiki88: folds 
king10clubs: folds 
baoyi2012: raises $12 to $18
floriiiiider: folds 
teunuss: folds 
Uncalled bet ($12) returned to baoyi2012
baoyi2012 collected $15 from pot
*** SUMMARY ***
Total pot $15 | Rake $0 
Seat 1: teunuss (big blind) folded before Flop
Seat 2: Strz folded before Flop (didn't bet)
Seat 3: mikimiki88 folded before Flop (didn't bet)
Seat 4: king10clubs folded before Flop (didn't bet)
Seat 5: baoyi2012 (button) collected ($15)
Seat 6: floriiiiider (small blind) folded before Flop


PokerStars Game #102625752351:  Hold'em No Limit ($3/$6 USD) - 2013/08/11 17:17:05 ET
Table 'Crux V 40-100 bb' 6-max Seat #6 is the button
Seat 1: teunuss ($600 in chips) 
Seat 2: Strz ($969.12 in chips) 
Seat 3: mikimiki88 ($1352.85 in chips) 
Seat 4: king10clubs ($652.72 in chips) 
Seat 5: baoyi2012 ($1486.60 in chips) 
Seat 6: floriiiiider ($600 in chips) 
teunuss: posts small blind $3
Strz: posts big blind $6
*** HOLE CARDS ***
mikimiki88: folds 
king10clubs: folds 
baoyi2012: folds 
floriiiiider: folds 
teunuss: raises $12 to $18
Strz: folds 
Uncalled bet ($12) returned to teunuss
teunuss collected $12 from pot
teunuss: doesn't show hand 
*** SUMMARY ***
Total pot $12 | Rake $0 
Seat 1: teunuss (small blind) collected ($12)
Seat 2: Strz (big blind) folded before Flop
Seat 3: mikimiki88 folded before Flop (didn't bet)
Seat 4: king10clubs folded before Flop (didn't bet)
Seat 5: baoyi2012 folded before Flop (didn't bet)
Seat 6: floriiiiider (button) folded before Flop (didn't bet)


PokerStars Game #102625773258:  Hold'em No Limit ($3/$6 USD) - 2013/08/11 17:17:31 ET
Table 'Crux V 40-100 bb' 6-max Seat #1 is the button
Seat 1: teunuss ($606 in chips) 
Seat 2: Strz ($963.12 in chips) 
Seat 3: mikimiki88 ($1352.85 in chips) 
Seat 4: king10clubs ($652.72 in chips) 
Seat 5: baoyi2012 ($1486.60 in chips) 
Seat 6: floriiiiider ($600 in chips) 
Strz: posts small blind $3
mikimiki88: posts big blind $6
*** HOLE CARDS ***
king10clubs: folds 
baoyi2012: raises $6 to $12
floriiiiider: raises $33 to $45
teunuss: folds 
Strz: folds 
mikimiki88: folds 
baoyi2012: calls $33
*** FLOP *** [6h 6s 2c]
baoyi2012: checks 
floriiiiider: bets $63
baoyi2012: folds 
Uncalled bet ($63) returned to floriiiiider
floriiiiider collected $96.20 from pot
floriiiiider: doesn't show hand 
*** SUMMARY ***
Total pot $99 | Rake $2.80 
Board [6h 6s 2c]
Seat 1: teunuss (button) folded before Flop (didn't bet)
Seat 2: Strz (small blind) folded before Flop
Seat 3: mikimiki88 (big blind) folded before Flop
Seat 4: king10clubs folded before Flop (didn't bet)
Seat 5: baoyi2012 folded on the Flop
Seat 6: floriiiiider collected ($96.20)


PokerStars Game #102625807861:  Hold'em No Limit ($3/$6 USD) - 2013/08/11 17:18:13 ET
Table 'Crux V 40-100 bb' 6-max Seat #2 is the button
Seat 1: teunuss ($606 in chips) 
Seat 2: Strz ($960.12 in chips) 
Seat 3: mikimiki88 ($1346.85 in chips) 
Seat 4: king10clubs ($652.72 in chips) 
Seat 5: baoyi2012 ($1441.60 in chips) 
Seat 6: floriiiiider ($651.20 in chips) 
mikimiki88: posts small blind $3
king10clubs: posts big blind $6
*** HOLE CARDS ***
baoyi2012: folds 
floriiiiider: folds 
teunuss: raises $9 to $15
Strz: folds 
mikimiki88: folds 
king10clubs: calls $9
*** FLOP *** [2d 4d 5h]
king10clubs: checks 
teunuss: bets $21
king10clubs: calls $21
*** TURN *** [2d 4d 5h] [9d]
king10clubs: checks 
teunuss: bets $54
king10clubs: calls $54
*** RIVER *** [2d 4d 5h 9d] [3s]
king10clubs: checks 
teunuss: checks 
*** SHOW DOWN ***
king10clubs: shows [Ts Tc] (a pair of Tens)
teunuss: shows [Ad 3h] (a straight, Ace to Five)
teunuss collected $180.20 from pot
*** SUMMARY ***
Total pot $183 | Rake $2.80 
Board [2d 4d 5h 9d 3s]
Seat 1: teunuss showed [Ad 3h] and won ($180.20) with a straight, Ace to Five
Seat 2: Strz (button) folded before Flop (didn't bet)
Seat 3: mikimiki88 (small blind) folded before Flop
Seat 4: king10clubs (big blind) showed [Ts Tc] and lost with a pair of Tens
Seat 5: baoyi2012 folded before Flop (didn't bet)
Seat 6: floriiiiider folded before Flop (didn't bet)


PokerStars Game #102625858600:  Hold'em No Limit ($3/$6 USD) - 2013/08/11 17:19:15 ET
Table 'Crux V 40-100 bb' 6-max Seat #3 is the button
Seat 1: teunuss ($696.20 in chips) 
Seat 2: Strz ($960.12 in chips) 
Seat 3: mikimiki88 ($1343.85 in chips) 
Seat 4: king10clubs ($600 in chips) 
Seat 5: baoyi2012 ($1441.60 in chips) 
Seat 6: floriiiiider ($651.20 in chips) 
king10clubs: posts small blind $3
baoyi2012: posts big blind $6
*** HOLE CARDS ***
floriiiiider: folds 
teunuss: folds 
Strz: folds 
mikimiki88: raises $6 to $12
king10clubs: raises $33 to $45
baoyi2012: folds 
mikimiki88: folds 
Uncalled bet ($33) returned to king10clubs
king10clubs collected $30 from pot
king10clubs: doesn't show hand 
*** SUMMARY ***
Total pot $30 | Rake $0 
Seat 1: teunuss folded before Flop (didn't bet)
Seat 2: Strz folded before Flop (didn't bet)
Seat 3: mikimiki88 (button) folded before Flop
Seat 4: king10clubs (small blind) collected ($30)
Seat 5: baoyi2012 (big blind) folded before Flop
Seat 6: floriiiiider folded before Flop (didn't bet)


PokerStars Game #102625890810:  Hold'em No Limit ($3/$6 USD) - 2013/08/11 17:19:55 ET
Table 'Crux V 40-100 bb' 6-max Seat #4 is the button
Seat 1: teunuss ($696.20 in chips) 
Seat 2: Strz ($960.12 in chips) 
Seat 3: mikimiki88 ($1331.85 in chips) 
Seat 4: king10clubs ($618 in chips) 
Seat 5: baoyi2012 ($1435.60 in chips) 
Seat 6: floriiiiider ($651.20 in chips) 
baoyi2012: posts small blind $3
floriiiiider: posts big blind $6
*** HOLE CARDS ***
teunuss: folds 
Strz: folds 
mikimiki88: raises $6 to $12
king10clubs: raises $26 to $38
baoyi2012: folds 
floriiiiider: folds 
mikimiki88: folds 
Uncalled bet ($26) returned to king10clubs
king10clubs collected $33 from pot
king10clubs: doesn't show hand 
*** SUMMARY ***
Total pot $33 | Rake $0 
Seat 1: teunuss folded before Flop (didn't bet)
Seat 2: Strz folded before Flop (didn't bet)
Seat 3: mikimiki88 folded before Flop
Seat 4: king10clubs (button) collected ($33)
Seat 5: baoyi2012 (small blind) folded before Flop
Seat 6: floriiiiider (big blind) folded before Flop


PokerStars Game #102625460109:  Hold'em No Limit ($3/$6 USD) - 2013/08/11 17:11:10 ET
Table 'Crux V 40-100 bb' 6-max Seat #4 is the button
Seat 1: teunuss ($600 in chips) 
Seat 2: Strz ($899.92 in chips) 
Seat 3: mikimiki88 ($1372.07 in chips) 
Seat 4: king10clubs ($682.72 in chips) 
Seat 5: baoyi2012 ($1183.20 in chips) 
Seat 6: floriiiiider ($741.20 in chips) 
baoyi2012: posts small blind $3
floriiiiider: posts big blind $6
*** HOLE CARDS ***
teunuss: folds 
Strz: folds 
mikimiki88: folds 
king10clubs: raises $6 to $12
baoyi2012: folds 
floriiiiider: raises $33 to $45
king10clubs: folds 
Uncalled bet ($33) returned to floriiiiider
floriiiiider collected $27 from pot
floriiiiider: doesn't show hand 
*** SUMMARY ***
Total pot $27 | Rake $0 
Seat 1: teunuss folded before Flop (didn't bet)
Seat 2: Strz folded before Flop (didn't bet)
Seat 3: mikimiki88 folded before Flop (didn't bet)
Seat 4: king10clubs (button) folded before Flop
Seat 5: baoyi2012 (small blind) folded before Flop
Seat 6: floriiiiider (big blind) collected ($27)


PokerStars Game #102625481076:  Hold'em No Limit ($3/$6 USD) - 2013/08/11 17:11:36 ET
Table 'Crux V 40-100 bb' 6-max Seat #5 is the button
Seat 1: teunuss ($600 in chips) 
Seat 2: Strz ($899.92 in chips) 
Seat 3: mikimiki88 ($1372.07 in chips) 
Seat 4: king10clubs ($670.72 in chips) 
Seat 5: baoyi2012 ($1180.20 in chips) 
Seat 6: floriiiiider ($756.20 in chips) 
floriiiiider: posts small blind $3
teunuss: posts big blind $6
*** HOLE CARDS ***
Strz: folds 
mikimiki88: folds 
king10clubs: folds 
baoyi2012: raises $6 to $12
floriiiiider: raises $33 to $45
teunuss: folds 
baoyi2012: calls $33
*** FLOP *** [Tc 6c 7h]
floriiiiider: bets $66
baoyi2012: calls $66
*** TURN *** [Tc 6c 7h] [9d]
floriiiiider: checks 
baoyi2012: bets $168
floriiiiider: calls $168
*** RIVER *** [Tc 6c 7h 9d] [4s]
floriiiiider: checks 
baoyi2012: checks 
*** SHOW DOWN ***
floriiiiider: shows [Kc Kh] (a pair of Kings)
baoyi2012: shows [4c 4h] (three of a kind, Fours)
baoyi2012 collected $561.20 from pot
*** SUMMARY ***
Total pot $564 | Rake $2.80 
Board [Tc 6c 7h 9d 4s]
Seat 1: teunuss (big blind) folded before Flop
Seat 2: Strz folded before Flop (didn't bet)
Seat 3: mikimiki88 folded before Flop (didn't bet)
Seat 4: king10clubs folded before Flop (didn't bet)
Seat 5: baoyi2012 (button) showed [4c 4h] and won ($561.20) with three of a kind, Fours
Seat 6: floriiiiider (small blind) showed [Kc Kh] and lost with a pair of Kings


PokerStars Game #102625543953:  Hold'em No Limit ($3/$6 USD) - 2013/08/11 17:12:52 ET
Table 'Crux V 40-100 bb' 6-max Seat #6 is the button
Seat 1: teunuss ($600 in chips) 
Seat 2: Strz ($899.92 in chips) 
Seat 3: mikimiki88 ($1372.07 in chips) 
Seat 4: king10clubs ($670.72 in chips) 
Seat 5: baoyi2012 ($1462.40 in chips) 
Seat 6: floriiiiider ($600 in chips) 
teunuss: posts small blind $3
Strz: posts big blind $6
*** HOLE CARDS ***
mikimiki88: folds 
king10clubs: folds 
baoyi2012: raises $6 to $12
floriiiiider: folds 
teunuss: folds 
Strz: calls $6
*** FLOP *** [8c Ts 7d]
Strz: checks 
baoyi2012: bets $24
Strz: raises $36 to $60
baoyi2012: calls $36
*** TURN *** [8c Ts 7d] [Tc]
Strz: bets $108
baoyi2012: folds 
Uncalled bet ($108) returned to Strz
Strz collected $144.20 from pot
*** SUMMARY ***
Total pot $147 | Rake $2.80 
Board [8c Ts 7d Tc]
Seat 1: teunuss (small blind) folded before Flop
Seat 2: Strz (big blind) collected ($144.20)
Seat 3: mikimiki88 folded before Flop (didn't bet)
Seat 4: king10clubs folded before Flop (didn't bet)
Seat 5: baoyi2012 folded on the Turn
Seat 6: floriiiiider (button) folded before Flop (didn't bet)


PokerStars Game #102625582465:  Hold'em No Limit ($3/$6 USD) - 2013/08/11 17:13:39 ET
Table 'Crux V 40-100 bb' 6-max Seat #1 is the button
Seat 1: teunuss ($600 in chips) 
Seat 2: Strz ($972.12 in chips) 
Seat 3: mikimiki88 ($1372.07 in chips) 
Seat 4: king10clubs ($670.72 in chips) 
Seat 5: baoyi2012 ($1390.40 in chips) 
Seat 6: floriiiiider ($600 in chips) 
Strz: posts small blind $3
mikimiki88: posts big blind $6
*** HOLE CARDS ***
king10clubs: folds 
baoyi2012: folds 
floriiiiider: folds 
teunuss: raises $6 to $12
Strz: folds 
mikimiki88: calls $6
*** FLOP *** [7c 4d Jh]
mikimiki88: checks 
teunuss: bets $18
mikimiki88: calls $18
*** TURN *** [7c 4d Jh] [Td]
mikimiki88: checks 
teunuss: bets $45
mikimiki88: folds 
Uncalled bet ($45) returned to teunuss
teunuss collected $60.20 from pot
teunuss: doesn't show hand 
*** SUMMARY ***
Total pot $63 | Rake $2.80 
Board [7c 4d Jh Td]
Seat 1: teunuss (button) collected ($60.20)
Seat 2: Strz (small blind) folded before Flop
Seat 3: mikimiki88 (big blind) folded on the Turn
Seat 4: king10clubs folded before Flop (didn't bet)
Seat 5: baoyi2012 folded before Flop (didn't bet)
Seat 6: floriiiiider folded before Flop (didn't bet)


PokerStars Game #102625637582:  Hold'em No Limit ($3/$6 USD) - 2013/08/11 17:14:46 ET
Table 'Crux V 40-100 bb' 6-max Seat #2 is the button
Seat 1: teunuss ($630.20 in chips) 
Seat 2: Strz ($969.12 in chips) 
Seat 3: mikimiki88 ($1342.07 in chips) 
Seat 4: king10clubs ($670.72 in chips) 
Seat 5: baoyi2012 ($1390.40 in chips) 
Seat 6: floriiiiider ($600 in chips) 
mikimiki88: posts small blind $3
king10clubs: posts big blind $6
*** HOLE CARDS ***
baoyi2012: folds 
floriiiiider: folds 
teunuss: folds 
Strz: folds 
mikimiki88: folds 
Uncalled bet ($3) returned to king10clubs
king10clubs collected $6 from pot
king10clubs: doesn't show hand 
*** SUMMARY ***
Total pot $6 | Rake $0 
Seat 1: teunuss folded before Flop (didn't bet)
Seat 2: Strz (button) folded before Flop (didn't bet)
Seat 3: mikimiki88 (small blind) folded before Flop
Seat 4: king10clubs (big blind) collected ($6)
Seat 5: baoyi2012 folded before Flop (didn't bet)
Seat 6: floriiiiider folded before Flop (didn't bet)


PokerStars Game #102625647588:  Hold'em No Limit ($3/$6 USD) - 2013/08/11 17:14:58 ET
Table 'Crux V 40-100 bb' 6-max Seat #3 is the button
Seat 1: teunuss ($630.20 in chips) 
Seat 2: Strz ($969.12 in chips) 
Seat 3: mikimiki88 ($1339.07 in chips) 
Seat 4: king10clubs ($673.72 in chips) 
Seat 5: baoyi2012 ($1390.40 in chips) 
Seat 6: floriiiiider ($600 in chips) 
king10clubs: posts small blind $3
baoyi2012: posts big blind $6
*** HOLE CARDS ***
floriiiiider: folds 
teunuss: folds 
Strz: folds 
mikimiki88: raises $6 to $12
king10clubs: folds 
baoyi2012: calls $6
*** FLOP *** [Ad 6h 8d]
baoyi2012: checks 
mikimiki88: checks 
*** TURN *** [Ad 6h 8d] [3c]
baoyi2012: checks 
mikimiki88: checks 
*** RIVER *** [Ad 6h 8d 3c] [Ac]
baoyi2012: checks 
mikimiki88: checks 
*** SHOW DOWN ***
baoyi2012: shows [4d Qd] (a pair of Aces)
mikimiki88: shows [2s 2d] (two pair, Aces and Deuces)
mikimiki88 collected $25.78 from pot
*** SUMMARY ***
Total pot $27 | Rake $1.22 
Board [Ad 6h 8d 3c Ac]
Seat 1: teunuss folded before Flop (didn't bet)
Seat 2: Strz folded before Flop (didn't bet)
Seat 3: mikimiki88 (button) showed [2s 2d] and won ($25.78) with two pair, Aces and Deuces
Seat 4: king10clubs (small blind) folded before Flop
Seat 5: baoyi2012 (big blind) showed [4d Qd] and lost with a pair of Aces
Seat 6: floriiiiider folded before Flop (didn't bet)


PokerStars Game #102627300808:  Hold'em No Limit ($3/$6 USD) - 2013/08/11 17:50:05 ET
Table 'Crux V 40-100 bb' 6-max Seat #1 is the button
Seat 1: teunuss ($943.45 in chips) 
Seat 3: mikimiki88 ($1356.58 in chips) 
Seat 4: king10clubs ($600 in chips) 
Seat 6: q1q23q ($562.99 in chips) 
mikimiki88: posts small blind $3
king10clubs: posts big blind $6
*** HOLE CARDS ***
q1q23q: folds 
teunuss: raises $6 to $12
mikimiki88: folds 
king10clubs: folds 
Uncalled bet ($6) returned to teunuss
teunuss collected $15 from pot
teunuss: doesn't show hand 
*** SUMMARY ***
Total pot $15 | Rake $0 
Seat 1: teunuss (button) collected ($15)
Seat 3: mikimiki88 (small blind) folded before Flop
Seat 4: king10clubs (big blind) folded before Flop
Seat 6: q1q23q folded before Flop (didn't bet)


PokerStars Game #102627477204:  Hold'em No Limit ($3/$6 USD) - 2013/08/11 17:54:05 ET
Table 'Crux V 40-100 bb' 6-max Seat #3 is the button
Seat 1: GP Bar-T ($358.19 in chips) 
Seat 3: mikimiki88 ($1547.68 in chips) 
Seat 4: king10clubs ($612 in chips) 
Seat 5: Strz ($874.90 in chips) 
king10clubs: posts small blind $3
Strz: posts big blind $6
DeluxeSamy: sits out 
GP Bar-T: posts big blind $6
*** HOLE CARDS ***
GP Bar-T: checks 
mikimiki88: raises $18 to $24
king10clubs: folds 
Strz: folds 
GP Bar-T: folds 
Uncalled bet ($18) returned to mikimiki88
mikimiki88 collected $21 from pot
mikimiki88: doesn't show hand 
*** SUMMARY ***
Total pot $21 | Rake $0 
Seat 1: GP Bar-T folded before Flop
Seat 3: mikimiki88 (button) collected ($21)
Seat 4: king10clubs (small blind) folded before Flop
Seat 5: Strz (big blind) folded before Flop


PokerStars Game #102627489711:  Hold'em No Limit ($3/$6 USD) - 2013/08/11 17:54:22 ET
Table 'Crux V 40-100 bb' 6-max Seat #4 is the button
Seat 1: GP Bar-T ($352.19 in chips) 
Seat 3: mikimiki88 ($1562.68 in chips) 
Seat 4: king10clubs ($609 in chips) 
Seat 5: Strz ($868.90 in chips) 
Seat 6: DeluxeSamy ($240 in chips) 
Strz: posts small blind $3
DeluxeSamy: posts big blind $6
*** HOLE CARDS ***
GP Bar-T: folds 
mikimiki88: raises $6 to $12
king10clubs: raises $24 to $36
Strz: folds 
DeluxeSamy: folds 
mikimiki88: folds 
Uncalled bet ($24) returned to king10clubs
king10clubs collected $33 from pot
king10clubs: doesn't show hand 
*** SUMMARY ***
Total pot $33 | Rake $0 
Seat 1: GP Bar-T folded before Flop (didn't bet)
Seat 3: mikimiki88 folded before Flop
Seat 4: king10clubs (button) collected ($33)
Seat 5: Strz (small blind) folded before Flop
Seat 6: DeluxeSamy (big blind) folded before Flop


PokerStars Game #102627509116:  Hold'em No Limit ($3/$6 USD) - 2013/08/11 17:54:49 ET
Table 'Crux V 40-100 bb' 6-max Seat #5 is the button
Seat 1: GP Bar-T ($352.19 in chips) 
Seat 3: mikimiki88 ($1550.68 in chips) 
Seat 4: king10clubs ($630 in chips) 
Seat 5: Strz ($865.90 in chips) 
Seat 6: DeluxeSamy ($234 in chips) 
DeluxeSamy: posts small blind $3
GP Bar-T: posts big blind $6
*** HOLE CARDS ***
mikimiki88: folds 
king10clubs: raises $9 to $15
Strz: folds 
DeluxeSamy: folds 
GP Bar-T: folds 
Uncalled bet ($9) returned to king10clubs
king10clubs collected $15 from pot
king10clubs: doesn't show hand 
*** SUMMARY ***
Total pot $15 | Rake $0 
Seat 1: GP Bar-T (big blind) folded before Flop
Seat 3: mikimiki88 folded before Flop (didn't bet)
Seat 4: king10clubs collected ($15)
Seat 5: Strz (button) folded before Flop (didn't bet)
Seat 6: DeluxeSamy (small blind) folded before Flop


PokerStars Game #102627309039:  Hold'em No Limit ($3/$6 USD) - 2013/08/11 17:50:16 ET
Table 'Crux V 40-100 bb' 6-max Seat #4 is the button
Seat 3: mikimiki88 ($1353.58 in chips) 
Seat 4: king10clubs ($600 in chips) 
king10clubs: posts small blind $3
q1q23q: is sitting out 
teunuss: is sitting out 
mikimiki88: posts big blind $6
*** HOLE CARDS ***
q1q23q leaves the table
king10clubs: raises $6 to $12
mikimiki88: calls $6
*** FLOP *** [Kc Js Ad]
mikimiki88: checks 
Ner4zzurri joins the table at seat #5 
king10clubs: bets $16.70
Ner4zzurri leaves the table
mikimiki88: folds 
Uncalled bet ($16.70) returned to king10clubs
king10clubs collected $23.50 from pot
king10clubs: doesn't show hand 
*** SUMMARY ***
Total pot $24 | Rake $0.50 
Board [Kc Js Ad]
Seat 3: mikimiki88 (big blind) folded on the Flop
Seat 4: king10clubs (button) (small blind) collected ($23.50)


PokerStars Game #102627325528:  Hold'em No Limit ($3/$6 USD) - 2013/08/11 17:50:39 ET
Table 'Crux V 40-100 bb' 6-max Seat #3 is the button
Seat 3: mikimiki88 ($1341.58 in chips) 
Seat 4: king10clubs ($611.50 in chips) 
mikimiki88: posts small blind $3
king10clubs: posts big blind $6
*** HOLE CARDS ***
teunuss leaves the table
mikimiki88: raises $6 to $12
king10clubs: folds 
Uncalled bet ($6) returned to mikimiki88
mikimiki88 collected $12 from pot
mikimiki88: doesn't show hand 
*** SUMMARY ***
Total pot $12 | Rake $0 
Seat 3: mikimiki88 (button) (small blind) collected ($12)
Seat 4: king10clubs (big blind) folded before Flop


PokerStars Game #102627334706:  Hold'em No Limit ($3/$6 USD) - 2013/08/11 17:50:51 ET
Table 'Crux V 40-100 bb' 6-max Seat #4 is the button
Seat 3: mikimiki88 ($1347.58 in chips) 
Seat 4: king10clubs ($605.50 in chips) 
king10clubs: posts small blind $3
mikimiki88: posts big blind $6
*** HOLE CARDS ***
king10clubs: raises $6 to $12
mikimiki88: calls $6
*** FLOP *** [Qs Qh Td]
mikimiki88: checks 
king10clubs: checks 
*** TURN *** [Qs Qh Td] [3h]
mikimiki88: checks 
king10clubs: checks 
*** RIVER *** [Qs Qh Td 3h] [2s]
mikimiki88: checks 
king10clubs: checks 
*** SHOW DOWN ***
mikimiki88: shows [Kc Jd] (a pair of Queens)
king10clubs: mucks hand 
mikimiki88 collected $23.50 from pot
*** SUMMARY ***
Total pot $24 | Rake $0.50 
Board [Qs Qh Td 3h 2s]
Seat 3: mikimiki88 (big blind) showed [Kc Jd] and won ($23.50) with a pair of Queens
Seat 4: king10clubs (button) (small blind) mucked


PokerStars Game #102627362410:  Hold'em No Limit ($3/$6 USD) - 2013/08/11 17:51:29 ET
Table 'Crux V 40-100 bb' 6-max Seat #3 is the button
Seat 3: mikimiki88 ($1359.08 in chips) 
Seat 4: king10clubs ($600 in chips) 
mikimiki88: posts small blind $3
king10clubs: posts big blind $6
*** HOLE CARDS ***
mikimiki88: raises $6 to $12
king10clubs: folds 
Uncalled bet ($6) returned to mikimiki88
mikimiki88 collected $12 from pot
mikimiki88: doesn't show hand 
*** SUMMARY ***
Total pot $12 | Rake $0 
Seat 3: mikimiki88 (button) (small blind) collected ($12)
Seat 4: king10clubs (big blind) folded before Flop


PokerStars Game #102627370879:  Hold'em No Limit ($3/$6 USD) - 2013/08/11 17:51:40 ET
Table 'Crux V 40-100 bb' 6-max Seat #4 is the button
Seat 3: mikimiki88 ($1365.08 in chips) 
Seat 4: king10clubs ($600 in chips) 
king10clubs: posts small blind $3
mikimiki88: posts big blind $6
*** HOLE CARDS ***
king10clubs: raises $6 to $12
mikimiki88: calls $6
*** FLOP *** [Jh Qd 8s]
mikimiki88: checks 
king10clubs: bets $16.80
mikimiki88: calls $16.80
*** TURN *** [Jh Qd 8s] [Kh]
mikimiki88: checks 
GP Bar-T joins the table at seat #1 
king10clubs: bets $43.60
Strz joins the table at seat #5 
DeluxeSamy joins the table at seat #6 
mikimiki88: calls $43.60
*** RIVER *** [Jh Qd 8s Kh] [8h]
mikimiki88: checks 
king10clubs: bets $122.70
mikimiki88: calls $122.70
*** SHOW DOWN ***
king10clubs: shows [Ad 9s] (a pair of Eights)
mikimiki88: shows [Qh 4h] (a flush, King high)
mikimiki88 collected $389.70 from pot
*** SUMMARY ***
Total pot $390.20 | Rake $0.50 
Board [Jh Qd 8s Kh 8h]
Seat 3: mikimiki88 (big blind) showed [Qh 4h] and won ($389.70) with a flush, King high
Seat 4: king10clubs (button) (small blind) showed [Ad 9s] and lost with a pair of Eights


PokerStars Game #102627466543:  Hold'em No Limit ($3/$6 USD) - 2013/08/11 17:53:51 ET
Table 'Crux V 40-100 bb' 6-max Seat #3 is the button
Seat 3: mikimiki88 ($1559.68 in chips) 
Seat 4: king10clubs ($600 in chips) 
mikimiki88: posts small blind $3
king10clubs: posts big blind $6
*** HOLE CARDS ***
mikimiki88: raises $6 to $12
king10clubs: raises $33 to $45
mikimiki88: folds 
Uncalled bet ($33) returned to king10clubs
king10clubs collected $24 from pot
king10clubs: doesn't show hand 
*** SUMMARY ***
Total pot $24 | Rake $0 
Seat 3: mikimiki88 (button) (small blind) folded before Flop
Seat 4: king10clubs (big blind) collected ($24)


PokerStars Game #102627084170:  Hold'em No Limit ($3/$6 USD) - 2013/08/11 17:45:18 ET
Table 'Crux V 40-100 bb' 6-max Seat #4 is the button
Seat 1: teunuss ($949.45 in chips) 
Seat 3: mikimiki88 ($1060.47 in chips) 
Seat 4: king10clubs ($600 in chips) 
Seat 5: nipe1955 ($301 in chips) 
Seat 6: q1q23q ($253 in chips) 
nipe1955: posts small blind $3
q1q23q: posts big blind $6
*** HOLE CARDS ***
teunuss: folds 
mikimiki88: raises $6 to $12
king10clubs: folds 
nipe1955: calls $9
q1q23q: folds 
*** FLOP *** [8c Td 4d]
nipe1955: checks 
mikimiki88: bets $23.49
nipe1955: calls $23.49
*** TURN *** [8c Td 4d] [8d]
nipe1955: checks 
mikimiki88: bets $60.82
nipe1955: calls $60.82
*** RIVER *** [8c Td 4d 8d] [Jc]
nipe1955: bets $204
mikimiki88: calls $204
*** SHOW DOWN ***
nipe1955: shows [Qh Tc] (two pair, Tens and Eights)
mikimiki88: shows [7d 9d] (a flush, Ten high)
mikimiki88 collected $603.82 from pot
*** SUMMARY ***
Total pot $606.62 | Rake $2.80 
Board [8c Td 4d 8d Jc]
Seat 1: teunuss folded before Flop (didn't bet)
Seat 3: mikimiki88 showed [7d 9d] and won ($603.82) with a flush, Ten high
Seat 4: king10clubs (button) folded before Flop (didn't bet)
Seat 5: nipe1955 (small blind) showed [Qh Tc] and lost with two pair, Tens and Eights
Seat 6: q1q23q (big blind) folded before Flop


PokerStars Game #102627145071:  Hold'em No Limit ($3/$6 USD) - 2013/08/11 17:46:38 ET
Table 'Crux V 40-100 bb' 6-max Seat #6 is the button
Seat 1: teunuss ($949.45 in chips) 
Seat 3: mikimiki88 ($1363.98 in chips) 
Seat 4: king10clubs ($600 in chips) 
Seat 6: q1q23q ($247 in chips) 
teunuss: posts small blind $3
mikimiki88: posts big blind $6
*** HOLE CARDS ***
king10clubs: folds 
q1q23q: raises $9 to $15
teunuss: folds 
mikimiki88: folds 
Uncalled bet ($9) returned to q1q23q
q1q23q collected $15 from pot
q1q23q: doesn't show hand 
*** SUMMARY ***
Total pot $15 | Rake $0 
Seat 1: teunuss (small blind) folded before Flop
Seat 3: mikimiki88 (big blind) folded before Flop
Seat 4: king10clubs folded before Flop (didn't bet)
Seat 6: q1q23q (button) collected ($15)


PokerStars Game #102627160820:  Hold'em No Limit ($3/$6 USD) - 2013/08/11 17:46:59 ET
Table 'Crux V 40-100 bb' 6-max Seat #1 is the button
Seat 1: teunuss ($946.45 in chips) 
Seat 3: mikimiki88 ($1357.98 in chips) 
Seat 4: king10clubs ($600 in chips) 
Seat 5: nipe1955 ($250.69 in chips) 
Seat 6: q1q23q ($256 in chips) 
mikimiki88: posts small blind $3
king10clubs: posts big blind $6
*** HOLE CARDS ***
nipe1955: folds 
q1q23q: raises $12 to $18
teunuss: folds 
mikimiki88: raises $23 to $41
king10clubs: folds 
q1q23q: raises $215 to $256 and is all-in
mikimiki88: folds 
Uncalled bet ($215) returned to q1q23q
q1q23q collected $88 from pot
q1q23q: doesn't show hand 
*** SUMMARY ***
Total pot $88 | Rake $0 
Seat 1: teunuss (button) folded before Flop (didn't bet)
Seat 3: mikimiki88 (small blind) folded before Flop
Seat 4: king10clubs (big blind) folded before Flop
Seat 5: nipe1955 folded before Flop (didn't bet)
Seat 6: q1q23q collected ($88)


PokerStars Game #102627188736:  Hold'em No Limit ($3/$6 USD) - 2013/08/11 17:47:36 ET
Table 'Crux V 40-100 bb' 6-max Seat #3 is the button
Seat 1: teunuss ($946.45 in chips) 
Seat 3: mikimiki88 ($1316.98 in chips) 
Seat 4: king10clubs ($600 in chips) 
Seat 5: nipe1955 ($250.69 in chips) 
Seat 6: q1q23q ($303 in chips) 
king10clubs: posts small blind $3
nipe1955: posts big blind $6
*** HOLE CARDS ***
q1q23q: folds 
teunuss: folds 
mikimiki88: raises $6 to $12
king10clubs: folds 
nipe1955: calls $6
*** FLOP *** [7h 9d Ac]
nipe1955: bets $18
mikimiki88: calls $18
*** TURN *** [7h 9d Ac] [9h]
nipe1955: bets $18
mikimiki88: calls $18
*** RIVER *** [7h 9d Ac 9h] [6c]
nipe1955: checks 
mikimiki88: checks 
*** SHOW DOWN ***
nipe1955: shows [7d 8s] (two pair, Nines and Sevens)
mikimiki88: shows [7c Jc] (two pair, Nines and Sevens)
nipe1955 collected $48.10 from pot
mikimiki88 collected $48.10 from pot
*** SUMMARY ***
Total pot $99 | Rake $2.80 
Board [7h 9d Ac 9h 6c]
Seat 1: teunuss folded before Flop (didn't bet)
Seat 3: mikimiki88 (button) showed [7c Jc] and won ($48.10) with two pair, Nines and Sevens
Seat 4: king10clubs (small blind) folded before Flop
Seat 5: nipe1955 (big blind) showed [7d 8s] and won ($48.10) with two pair, Nines and Sevens
Seat 6: q1q23q folded before Flop (didn't bet)


PokerStars Game #102627216356:  Hold'em No Limit ($3/$6 USD) - 2013/08/11 17:48:13 ET
Table 'Crux V 40-100 bb' 6-max Seat #4 is the button
Seat 1: teunuss ($946.45 in chips) 
Seat 3: mikimiki88 ($1317.08 in chips) 
Seat 4: king10clubs ($600 in chips) 
Seat 5: nipe1955 ($250.79 in chips) 
Seat 6: q1q23q ($303 in chips) 
nipe1955: posts small blind $3
q1q23q: posts big blind $6
*** HOLE CARDS ***
teunuss: folds 
mikimiki88: folds 
king10clubs: raises $6 to $12
nipe1955: calls $9
q1q23q: calls $6
*** FLOP *** [3s Ad 8h]
nipe1955: checks 
q1q23q: checks 
king10clubs: checks 
*** TURN *** [3s Ad 8h] [4d]
nipe1955: bets $36
q1q23q: raises $60 to $96
king10clubs: folds 
nipe1955: calls $60
*** RIVER *** [3s Ad 8h 4d] [Jh]
nipe1955: checks 
q1q23q: bets $150
nipe1955: calls $142.79 and is all-in
Uncalled bet ($7.21) returned to q1q23q
*** SHOW DOWN ***
q1q23q: shows [4h Ah] (two pair, Aces and Fours)
nipe1955: mucks hand 
q1q23q collected $510.78 from pot
*** SUMMARY ***
Total pot $513.58 | Rake $2.80 
Board [3s Ad 8h 4d Jh]
Seat 1: teunuss folded before Flop (didn't bet)
Seat 3: mikimiki88 folded before Flop (didn't bet)
Seat 4: king10clubs (button) folded on the Turn
Seat 5: nipe1955 (small blind) mucked
Seat 6: q1q23q (big blind) showed [4h Ah] and won ($510.78) with two pair, Aces and Fours


PokerStars Game #102627260126:  Hold'em No Limit ($3/$6 USD) - 2013/08/11 17:49:11 ET
Table 'Crux V 40-100 bb' 6-max Seat #6 is the button
Seat 1: teunuss ($946.45 in chips) 
Seat 3: mikimiki88 ($1317.08 in chips) 
Seat 4: king10clubs ($600 in chips) 
Seat 6: q1q23q ($562.99 in chips) 
nipe1955 leaves the table
teunuss: posts small blind $3
mikimiki88: posts big blind $6
*** HOLE CARDS ***
king10clubs: raises $9 to $15
q1q23q: folds 
teunuss: folds 
mikimiki88: calls $9
*** FLOP *** [7s 8s 9h]
mikimiki88: checks 
king10clubs: bets $23
mikimiki88: raises $55.03 to $78.03
king10clubs: folds 
Uncalled bet ($55.03) returned to mikimiki88
mikimiki88 collected $77.50 from pot
mikimiki88: doesn't show hand 
*** SUMMARY ***
Total pot $79 | Rake $1.50 
Board [7s 8s 9h]
Seat 1: teunuss (small blind) folded before Flop
Seat 3: mikimiki88 (big blind) collected ($77.50)
Seat 4: king10clubs folded on the Flop
Seat 6: q1q23q (button) folded before Flop (didn't bet)


PokerStars Game #102626862263:  Hold'em No Limit ($3/$6 USD) - 2013/08/11 17:40:27 ET
Table 'Crux V 40-100 bb' 6-max Seat #3 is the button
Seat 1: teunuss ($943.25 in chips) 
Seat 2: Hurloon ($600 in chips) 
Seat 3: mikimiki88 ($1090.47 in chips) 
Seat 4: king10clubs ($621.28 in chips) 
Seat 5: nipe1955 ($250 in chips) 
king10clubs: posts small blind $3
nipe1955: posts big blind $6
q1q23q: sits out 
*** HOLE CARDS ***
teunuss: folds 
Hurloon: raises $9 to $15
mikimiki88: folds 
king10clubs: folds 
nipe1955: calls $9
*** FLOP *** [8h As Ah]
nipe1955: checks 
Hurloon: bets $15
nipe1955: calls $15
*** TURN *** [8h As Ah] [8c]
nipe1955: checks 
Hurloon: bets $30
nipe1955: folds 
Uncalled bet ($30) returned to Hurloon
Hurloon collected $60.20 from pot
Hurloon: doesn't show hand 
*** SUMMARY ***
Total pot $63 | Rake $2.80 
Board [8h As Ah 8c]
Seat 1: teunuss folded before Flop (didn't bet)
Seat 2: Hurloon collected ($60.20)
Seat 3: mikimiki88 (button) folded before Flop (didn't bet)
Seat 4: king10clubs (small blind) folded before Flop
Seat 5: nipe1955 (big blind) folded on the Turn


PokerStars Game #102626893936:  Hold'em No Limit ($3/$6 USD) - 2013/08/11 17:41:08 ET
Table 'Crux V 40-100 bb' 6-max Seat #4 is the button
Seat 1: teunuss ($943.25 in chips) 
Seat 2: Hurloon ($630.20 in chips) 
Seat 3: mikimiki88 ($1090.47 in chips) 
Seat 4: king10clubs ($618.28 in chips) 
Seat 5: nipe1955 ($220 in chips) 
Seat 6: q1q23q ($240 in chips) 
nipe1955: posts small blind $3
q1q23q: posts big blind $6
*** HOLE CARDS ***
teunuss: folds 
Hurloon: folds 
mikimiki88: raises $6 to $12
king10clubs: raises $30 to $42
nipe1955: raises $178 to $220 and is all-in
q1q23q: folds 
mikimiki88: folds 
king10clubs: folds 
Uncalled bet ($178) returned to nipe1955
nipe1955 collected $102 from pot
*** SUMMARY ***
Total pot $102 | Rake $0 
Seat 1: teunuss folded before Flop (didn't bet)
Seat 2: Hurloon folded before Flop (didn't bet)
Seat 3: mikimiki88 folded before Flop
Seat 4: king10clubs (button) folded before Flop
Seat 5: nipe1955 (small blind) collected ($102)
Seat 6: q1q23q (big blind) folded before Flop


PokerStars Game #102626919548:  Hold'em No Limit ($3/$6 USD) - 2013/08/11 17:41:42 ET
Table 'Crux V 40-100 bb' 6-max Seat #5 is the button
Seat 1: teunuss ($943.25 in chips) 
Seat 2: Hurloon ($630.20 in chips) 
Seat 3: mikimiki88 ($1078.47 in chips) 
Seat 4: king10clubs ($600 in chips) 
Seat 5: nipe1955 ($280 in chips) 
Seat 6: q1q23q ($234 in chips) 
q1q23q: posts small blind $3
teunuss: posts big blind $6
*** HOLE CARDS ***
Hurloon: folds 
mikimiki88: folds 
king10clubs: folds 
nipe1955: raises $6 to $12
q1q23q: folds 
teunuss: calls $6
*** FLOP *** [2s 9d 6s]
teunuss: checks 
nipe1955: bets $18
teunuss: raises $42 to $60
nipe1955: calls $42
*** TURN *** [2s 9d 6s] [Th]
teunuss: checks 
nipe1955: checks 
*** RIVER *** [2s 9d 6s Th] [Js]
teunuss: checks 
nipe1955: checks 
*** SHOW DOWN ***
teunuss: shows [9h Kh] (a pair of Nines)
nipe1955: mucks hand 
teunuss collected $144.20 from pot
*** SUMMARY ***
Total pot $147 | Rake $2.80 
Board [2s 9d 6s Th Js]
Seat 1: teunuss (big blind) showed [9h Kh] and won ($144.20) with a pair of Nines
Seat 2: Hurloon folded before Flop (didn't bet)
Seat 3: mikimiki88 folded before Flop (didn't bet)
Seat 4: king10clubs folded before Flop (didn't bet)
Seat 5: nipe1955 (button) mucked
Seat 6: q1q23q (small blind) folded before Flop


PokerStars Game #102626959348:  Hold'em No Limit ($3/$6 USD) - 2013/08/11 17:42:33 ET
Table 'Crux V 40-100 bb' 6-max Seat #6 is the button
Seat 1: teunuss ($1015.45 in chips) 
Seat 3: mikimiki88 ($1078.47 in chips) 
Seat 4: king10clubs ($600 in chips) 
Seat 5: nipe1955 ($208 in chips) 
Seat 6: q1q23q ($231 in chips) 
teunuss: posts small blind $3
Hurloon: is sitting out 
mikimiki88: posts big blind $6
*** HOLE CARDS ***
king10clubs: folds 
nipe1955: raises $6 to $12
q1q23q: folds 
teunuss: folds 
mikimiki88: folds 
Uncalled bet ($6) returned to nipe1955
nipe1955 collected $15 from pot
*** SUMMARY ***
Total pot $15 | Rake $0 
Seat 1: teunuss (small blind) folded before Flop
Seat 3: mikimiki88 (big blind) folded before Flop
Seat 4: king10clubs folded before Flop (didn't bet)
Seat 5: nipe1955 collected ($15)
Seat 6: q1q23q (button) folded before Flop (didn't bet)


PokerStars Game #102626973292:  Hold'em No Limit ($3/$6 USD) - 2013/08/11 17:42:52 ET
Table 'Crux V 40-100 bb' 6-max Seat #1 is the button
Seat 1: teunuss ($1012.45 in chips) 
Seat 3: mikimiki88 ($1072.47 in chips) 
Seat 4: king10clubs ($600 in chips) 
Seat 5: nipe1955 ($217 in chips) 
Seat 6: q1q23q ($231 in chips) 
mikimiki88: posts small blind $3
king10clubs: posts big blind $6
*** HOLE CARDS ***
nipe1955: raises $6 to $12
q1q23q: folds 
teunuss: folds 
mikimiki88: folds 
king10clubs: folds 
Uncalled bet ($6) returned to nipe1955
nipe1955 collected $15 from pot
*** SUMMARY ***
Total pot $15 | Rake $0 
Seat 1: teunuss (button) folded before Flop (didn't bet)
Seat 3: mikimiki88 (small blind) folded before Flop
Seat 4: king10clubs (big blind) folded before Flop
Seat 5: nipe1955 collected ($15)
Seat 6: q1q23q folded before Flop (didn't bet)


PokerStars Game #102626983139:  Hold'em No Limit ($3/$6 USD) - 2013/08/11 17:43:05 ET
Table 'Crux V 40-100 bb' 6-max Seat #3 is the button
Seat 1: teunuss ($1012.45 in chips) 
Seat 3: mikimiki88 ($1069.47 in chips) 
Seat 4: king10clubs ($600 in chips) 
Seat 5: nipe1955 ($226 in chips) 
Seat 6: q1q23q ($231 in chips) 
king10clubs: posts small blind $3
nipe1955: posts big blind $6
*** HOLE CARDS ***
q1q23q: folds 
teunuss: folds 
mikimiki88: folds 
king10clubs: folds 
Uncalled bet ($3) returned to nipe1955
nipe1955 collected $6 from pot
*** SUMMARY ***
Total pot $6 | Rake $0 
Seat 1: teunuss folded before Flop (didn't bet)
Seat 3: mikimiki88 (button) folded before Flop (didn't bet)
Seat 4: king10clubs (small blind) folded before Flop
Seat 5: nipe1955 (big blind) collected ($6)
Seat 6: q1q23q folded before Flop (didn't bet)


PokerStars Game #102626995777:  Hold'em No Limit ($3/$6 USD) - 2013/08/11 17:43:21 ET
Table 'Crux V 40-100 bb' 6-max Seat #4 is the button
Seat 1: teunuss ($1012.45 in chips) 
Seat 3: mikimiki88 ($1069.47 in chips) 
Seat 4: king10clubs ($600 in chips) 
Seat 5: nipe1955 ($229 in chips) 
Seat 6: q1q23q ($231 in chips) 
nipe1955: posts small blind $3
q1q23q: posts big blind $6
*** HOLE CARDS ***
teunuss: folds 
mikimiki88: folds 
king10clubs: folds 
nipe1955: raises $6 to $12
q1q23q: folds 
Uncalled bet ($6) returned to nipe1955
nipe1955 collected $12 from pot
*** SUMMARY ***
Total pot $12 | Rake $0 
Seat 1: teunuss folded before Flop (didn't bet)
Seat 3: mikimiki88 folded before Flop (didn't bet)
Seat 4: king10clubs (button) folded before Flop (didn't bet)
Seat 5: nipe1955 (small blind) collected ($12)
Seat 6: q1q23q (big blind) folded before Flop


PokerStars Game #102627007756:  Hold'em No Limit ($3/$6 USD) - 2013/08/11 17:43:37 ET
Table 'Crux V 40-100 bb' 6-max Seat #5 is the button
Seat 1: teunuss ($1012.45 in chips) 
Seat 3: mikimiki88 ($1069.47 in chips) 
Seat 4: king10clubs ($600 in chips) 
Seat 5: nipe1955 ($235 in chips) 
Seat 6: q1q23q ($225 in chips) 
q1q23q: posts small blind $3
teunuss: posts big blind $6
*** HOLE CARDS ***
mikimiki88: folds 
king10clubs: folds 
nipe1955: folds 
q1q23q: folds 
Uncalled bet ($3) returned to teunuss
teunuss collected $6 from pot
teunuss: doesn't show hand 
*** SUMMARY ***
Total pot $6 | Rake $0 
Seat 1: teunuss (big blind) collected ($6)
Seat 3: mikimiki88 folded before Flop (didn't bet)
Seat 4: king10clubs folded before Flop (didn't bet)
Seat 5: nipe1955 (button) folded before Flop (didn't bet)
Seat 6: q1q23q (small blind) folded before Flop


PokerStars Game #102627025662:  Hold'em No Limit ($3/$6 USD) - 2013/08/11 17:44:01 ET
Table 'Crux V 40-100 bb' 6-max Seat #6 is the button
Seat 1: teunuss ($1015.45 in chips) 
Seat 3: mikimiki88 ($1069.47 in chips) 
Seat 4: king10clubs ($600 in chips) 
Seat 5: nipe1955 ($235 in chips) 
Seat 6: q1q23q ($244 in chips) 
teunuss: posts small blind $3
mikimiki88: posts big blind $6
*** HOLE CARDS ***
king10clubs: folds 
nipe1955: raises $18 to $24
q1q23q: folds 
teunuss: raises $42 to $66
mikimiki88: folds 
nipe1955: raises $169 to $235 and is all-in
teunuss: folds 
Uncalled bet ($169) returned to nipe1955
nipe1955 collected $138 from pot
*** SUMMARY ***
Total pot $138 | Rake $0 
Seat 1: teunuss (small blind) folded before Flop
Seat 3: mikimiki88 (big blind) folded before Flop
Seat 4: king10clubs folded before Flop (didn't bet)
Seat 5: nipe1955 collected ($138)
Seat 6: q1q23q (button) folded before Flop (didn't bet)


PokerStars Game #102627044790:  Hold'em No Limit ($3/$6 USD) - 2013/08/11 17:44:26 ET
Table 'Crux V 40-100 bb' 6-max Seat #1 is the button
Seat 1: teunuss ($949.45 in chips) 
Seat 3: mikimiki88 ($1063.47 in chips) 
Seat 4: king10clubs ($600 in chips) 
Seat 5: nipe1955 ($307 in chips) 
Seat 6: q1q23q ($244 in chips) 
mikimiki88: posts small blind $3
king10clubs: posts big blind $6
*** HOLE CARDS ***
nipe1955: folds 
q1q23q: folds 
teunuss: folds 
mikimiki88: folds 
Uncalled bet ($3) returned to king10clubs
king10clubs collected $6 from pot
king10clubs: doesn't show hand 
*** SUMMARY ***
Total pot $6 | Rake $0 
Seat 1: teunuss (button) folded before Flop (didn't bet)
Seat 3: mikimiki88 (small blind) folded before Flop
Seat 4: king10clubs (big blind) collected ($6)
Seat 5: nipe1955 folded before Flop (didn't bet)
Seat 6: q1q23q folded before Flop (didn't bet)


PokerStars Game #102627066438:  Hold'em No Limit ($3/$6 USD) - 2013/08/11 17:44:54 ET
Table 'Crux V 40-100 bb' 6-max Seat #3 is the button
Seat 1: teunuss ($949.45 in chips) 
Seat 3: mikimiki88 ($1060.47 in chips) 
Seat 4: king10clubs ($603 in chips) 
Seat 5: nipe1955 ($307 in chips) 
Seat 6: q1q23q ($244 in chips) 
king10clubs: posts small blind $3
nipe1955: posts big blind $6
*** HOLE CARDS ***
q1q23q: raises $12 to $18
teunuss: folds 
mikimiki88: folds 
king10clubs: folds 
nipe1955: folds 
Uncalled bet ($12) returned to q1q23q
q1q23q collected $15 from pot
q1q23q: doesn't show hand 
*** SUMMARY ***
Total pot $15 | Rake $0 
Seat 1: teunuss folded before Flop (didn't bet)
Seat 3: mikimiki88 (button) folded before Flop (didn't bet)
Seat 4: king10clubs (small blind) folded before Flop
Seat 5: nipe1955 (big blind) folded before Flop
Seat 6: q1q23q collected ($15)


PokerStars Game #102626615036:  Hold'em No Limit ($3/$6 USD) - 2013/08/11 17:35:08 ET
Table 'Crux V 40-100 bb' 6-max Seat #5 is the button
Seat 1: teunuss ($849.63 in chips) 
Seat 2: Stubbikoenig ($600 in chips) 
Seat 3: mikimiki88 ($944.15 in chips) 
Seat 5: GregAndrek ($600 in chips) 
Seat 6: __P0o_P0o__ ($228 in chips) 
__P0o_P0o__: posts small blind $3
teunuss: posts big blind $6
*** HOLE CARDS ***
Stubbikoenig: folds 
mikimiki88: raises $6 to $12
GregAndrek: folds 
__P0o_P0o__: folds 
teunuss: calls $6
*** FLOP *** [7h Qs 2d]
teunuss: checks 
mikimiki88: bets $15.21
teunuss: folds 
Uncalled bet ($15.21) returned to mikimiki88
mikimiki88 collected $25.78 from pot
mikimiki88: doesn't show hand 
*** SUMMARY ***
Total pot $27 | Rake $1.22 
Board [7h Qs 2d]
Seat 1: teunuss (big blind) folded on the Flop
Seat 2: Stubbikoenig folded before Flop (didn't bet)
Seat 3: mikimiki88 collected ($25.78)
Seat 5: GregAndrek (button) folded before Flop (didn't bet)
Seat 6: __P0o_P0o__ (small blind) folded before Flop


PokerStars Game #102626633280:  Hold'em No Limit ($3/$6 USD) - 2013/08/11 17:35:32 ET
Table 'Crux V 40-100 bb' 6-max Seat #6 is the button
Seat 1: teunuss ($837.63 in chips) 
Seat 2: Stubbikoenig ($600 in chips) 
Seat 3: mikimiki88 ($957.93 in chips) 
Seat 5: GregAndrek ($600 in chips) 
Seat 6: __P0o_P0o__ ($225 in chips) 
teunuss: posts small blind $3
Stubbikoenig: posts big blind $6
*** HOLE CARDS ***
mikimiki88: folds 
GregAndrek: raises $9 to $15
__P0o_P0o__: folds 
teunuss: folds 
Stubbikoenig: folds 
Uncalled bet ($9) returned to GregAndrek
GregAndrek collected $15 from pot
GregAndrek: doesn't show hand 
*** SUMMARY ***
Total pot $15 | Rake $0 
Seat 1: teunuss (small blind) folded before Flop
Seat 2: Stubbikoenig (big blind) folded before Flop
Seat 3: mikimiki88 folded before Flop (didn't bet)
Seat 5: GregAndrek collected ($15)
Seat 6: __P0o_P0o__ (button) folded before Flop (didn't bet)


PokerStars Game #102626648904:  Hold'em No Limit ($3/$6 USD) - 2013/08/11 17:35:52 ET
Table 'Crux V 40-100 bb' 6-max Seat #1 is the button
Seat 1: teunuss ($834.63 in chips) 
Seat 2: Stubbikoenig ($600 in chips) 
Seat 3: mikimiki88 ($957.93 in chips) 
Seat 5: GregAndrek ($609 in chips) 
Seat 6: __P0o_P0o__ ($225 in chips) 
Stubbikoenig: posts small blind $3
mikimiki88: posts big blind $6
*** HOLE CARDS ***
GregAndrek: raises $12 to $18
__P0o_P0o__: folds 
teunuss: folds 
Stubbikoenig: folds 
mikimiki88: folds 
Uncalled bet ($12) returned to GregAndrek
GregAndrek collected $15 from pot
GregAndrek: doesn't show hand 
*** SUMMARY ***
Total pot $15 | Rake $0 
Seat 1: teunuss (button) folded before Flop (didn't bet)
Seat 2: Stubbikoenig (small blind) folded before Flop
Seat 3: mikimiki88 (big blind) folded before Flop
Seat 5: GregAndrek collected ($15)
Seat 6: __P0o_P0o__ folded before Flop (didn't bet)


PokerStars Game #102626662208:  Hold'em No Limit ($3/$6 USD) - 2013/08/11 17:36:09 ET
Table 'Crux V 40-100 bb' 6-max Seat #2 is the button
Seat 1: teunuss ($834.63 in chips) 
Seat 2: Stubbikoenig ($600 in chips) 
Seat 3: mikimiki88 ($951.93 in chips) 
Seat 5: GregAndrek ($618 in chips) 
Seat 6: __P0o_P0o__ ($225 in chips) 
mikimiki88: posts small blind $3
GregAndrek: posts big blind $6
*** HOLE CARDS ***
__P0o_P0o__: folds 
teunuss: folds 
Stubbikoenig: raises $6 to $12
mikimiki88: folds 
GregAndrek: folds 
Uncalled bet ($6) returned to Stubbikoenig
Stubbikoenig collected $15 from pot
Stubbikoenig: doesn't show hand 
*** SUMMARY ***
Total pot $15 | Rake $0 
Seat 1: teunuss folded before Flop (didn't bet)
Seat 2: Stubbikoenig (button) collected ($15)
Seat 3: mikimiki88 (small blind) folded before Flop
Seat 5: GregAndrek (big blind) folded before Flop
Seat 6: __P0o_P0o__ folded before Flop (didn't bet)


PokerStars Game #102626679001:  Hold'em No Limit ($3/$6 USD) - 2013/08/11 17:36:30 ET
Table 'Crux V 40-100 bb' 6-max Seat #3 is the button
Seat 1: teunuss ($834.63 in chips) 
Seat 2: Stubbikoenig ($609 in chips) 
Seat 3: mikimiki88 ($948.93 in chips) 
Seat 5: GregAndrek ($612 in chips) 
Seat 6: __P0o_P0o__ ($225 in chips) 
GregAndrek: posts small blind $3
__P0o_P0o__: posts big blind $6
*** HOLE CARDS ***
teunuss: raises $12 to $18
Stubbikoenig: folds 
mikimiki88: folds 
GregAndrek: folds 
__P0o_P0o__: folds 
Uncalled bet ($12) returned to teunuss
teunuss collected $15 from pot
teunuss: doesn't show hand 
*** SUMMARY ***
Total pot $15 | Rake $0 
Seat 1: teunuss collected ($15)
Seat 2: Stubbikoenig folded before Flop (didn't bet)
Seat 3: mikimiki88 (button) folded before Flop (didn't bet)
Seat 5: GregAndrek (small blind) folded before Flop
Seat 6: __P0o_P0o__ (big blind) folded before Flop


PokerStars Game #102626708343:  Hold'em No Limit ($3/$6 USD) - 2013/08/11 17:37:08 ET
Table 'Crux V 40-100 bb' 6-max Seat #5 is the button
Seat 1: teunuss ($843.63 in chips) 
Seat 2: Stubbikoenig ($609 in chips) 
Seat 3: mikimiki88 ($948.93 in chips) 
Seat 5: GregAndrek ($609 in chips) 
Seat 6: __P0o_P0o__ ($219 in chips) 
__P0o_P0o__: posts small blind $3
teunuss: posts big blind $6
*** HOLE CARDS ***
Stubbikoenig: folds 
mikimiki88: folds 
GregAndrek: folds 
__P0o_P0o__: raises $9.42 to $15.42
teunuss: calls $9.42
*** FLOP *** [6c 6d 2h]
__P0o_P0o__: bets $24
teunuss: calls $24
*** TURN *** [6c 6d 2h] [Td]
__P0o_P0o__: bets $48
teunuss: calls $48
*** RIVER *** [6c 6d 2h Td] [9d]
__P0o_P0o__: checks 
Stubbikoenig leaves the table
teunuss: bets $141
__P0o_P0o__: folds 
Uncalled bet ($141) returned to teunuss
teunuss collected $172.04 from pot
teunuss: doesn't show hand 
*** SUMMARY ***
Total pot $174.84 | Rake $2.80 
Board [6c 6d 2h Td 9d]
Seat 1: teunuss (big blind) collected ($172.04)
Seat 2: Stubbikoenig folded before Flop (didn't bet)
Seat 3: mikimiki88 folded before Flop (didn't bet)
Seat 5: GregAndrek (button) folded before Flop (didn't bet)
Seat 6: __P0o_P0o__ (small blind) folded on the River


PokerStars Game #102626745559:  Hold'em No Limit ($3/$6 USD) - 2013/08/11 17:37:56 ET
Table 'Crux V 40-100 bb' 6-max Seat #6 is the button
Seat 1: teunuss ($928.25 in chips) 
Seat 3: mikimiki88 ($948.93 in chips) 
Seat 5: GregAndrek ($609 in chips) 
Seat 6: __P0o_P0o__ ($131.58 in chips) 
teunuss: posts small blind $3
mikimiki88: posts big blind $6
king10clubs: sits out 
*** HOLE CARDS ***
GregAndrek: folds 
__P0o_P0o__: folds 
teunuss: folds 
Uncalled bet ($3) returned to mikimiki88
mikimiki88 collected $6 from pot
mikimiki88: doesn't show hand 
*** SUMMARY ***
Total pot $6 | Rake $0 
Seat 1: teunuss (small blind) folded before Flop
Seat 3: mikimiki88 (big blind) collected ($6)
Seat 5: GregAndrek folded before Flop (didn't bet)
Seat 6: __P0o_P0o__ (button) folded before Flop (didn't bet)


PokerStars Game #102626753602:  Hold'em No Limit ($3/$6 USD) - 2013/08/11 17:38:06 ET
Table 'Crux V 40-100 bb' 6-max Seat #1 is the button
Seat 1: teunuss ($925.25 in chips) 
Seat 3: mikimiki88 ($951.93 in chips) 
Seat 4: king10clubs ($639.28 in chips) 
Seat 5: GregAndrek ($609 in chips) 
Seat 6: __P0o_P0o__ ($131.58 in chips) 
mikimiki88: posts small blind $3
king10clubs: posts big blind $6
*** HOLE CARDS ***
GregAndrek: folds 
__P0o_P0o__: raises $9 to $15
teunuss: folds 
mikimiki88: folds 
king10clubs: folds 
Uncalled bet ($9) returned to __P0o_P0o__
__P0o_P0o__ collected $15 from pot
__P0o_P0o__: doesn't show hand 
*** SUMMARY ***
Total pot $15 | Rake $0 
Seat 1: teunuss (button) folded before Flop (didn't bet)
Seat 3: mikimiki88 (small blind) folded before Flop
Seat 4: king10clubs (big blind) folded before Flop
Seat 5: GregAndrek folded before Flop (didn't bet)
Seat 6: __P0o_P0o__ collected ($15)


PokerStars Game #102626767296:  Hold'em No Limit ($3/$6 USD) - 2013/08/11 17:38:24 ET
Table 'Crux V 40-100 bb' 6-max Seat #3 is the button
Seat 1: teunuss ($925.25 in chips) 
Seat 3: mikimiki88 ($948.93 in chips) 
Seat 4: king10clubs ($633.28 in chips) 
Seat 6: __P0o_P0o__ ($140.58 in chips) 
king10clubs: posts small blind $3
GregAndrek: is sitting out 
__P0o_P0o__: posts big blind $6
*** HOLE CARDS ***
teunuss: folds 
mikimiki88: raises $6 to $12
king10clubs: folds 
__P0o_P0o__: raises $128.58 to $140.58 and is all-in
Hurloon joins the table at seat #2 
mikimiki88: calls $128.58
*** FLOP *** [4c 5s 3c]
*** TURN *** [4c 5s 3c] [4s]
*** RIVER *** [4c 5s 3c 4s] [Kd]
*** SHOW DOWN ***
__P0o_P0o__: shows [Jh 2h] (a pair of Fours)
mikimiki88: shows [Js Ac] (a pair of Fours - Ace kicker)
mikimiki88 collected $282.66 from pot
*** SUMMARY ***
Total pot $284.16 | Rake $1.50 
Board [4c 5s 3c 4s Kd]
Seat 1: teunuss folded before Flop (didn't bet)
Seat 3: mikimiki88 (button) showed [Js Ac] and won ($282.66) with a pair of Fours
Seat 4: king10clubs (small blind) folded before Flop
Seat 6: __P0o_P0o__ (big blind) showed [Jh 2h] and lost with a pair of Fours


PokerStars Game #102626784292:  Hold'em No Limit ($3/$6 USD) - 2013/08/11 17:38:46 ET
Table 'Crux V 40-100 bb' 6-max Seat #4 is the button
Seat 1: teunuss ($925.25 in chips) 
Seat 2: Hurloon ($600 in chips) 
Seat 3: mikimiki88 ($1091.01 in chips) 
Seat 4: king10clubs ($630.28 in chips) 
teunuss: posts small blind $3
Hurloon: posts big blind $6
*** HOLE CARDS ***
__P0o_P0o__ leaves the table
mikimiki88: folds 
GregAndrek leaves the table
dRobespierre joins the table at seat #5 
dRobespierre leaves the table
king10clubs: raises $6 to $12
teunuss: raises $33 to $45
Hurloon: folds 
king10clubs: folds 
Uncalled bet ($33) returned to teunuss
teunuss collected $30 from pot
teunuss: doesn't show hand 
*** SUMMARY ***
Total pot $30 | Rake $0 
Seat 1: teunuss (small blind) collected ($30)
Seat 2: Hurloon (big blind) folded before Flop
Seat 3: mikimiki88 folded before Flop (didn't bet)
Seat 4: king10clubs (button) folded before Flop


PokerStars Game #102626804461:  Hold'em No Limit ($3/$6 USD) - 2013/08/11 17:39:12 ET
Table 'Crux V 40-100 bb' 6-max Seat #1 is the button
Seat 1: teunuss ($943.25 in chips) 
Seat 2: Hurloon ($600 in chips) 
Seat 3: mikimiki88 ($1091.01 in chips) 
Seat 4: king10clubs ($618.28 in chips) 
Hurloon: posts small blind $3
mikimiki88: posts big blind $6
*** HOLE CARDS ***
king10clubs: raises $9 to $15
floriiiiider joins the table at seat #5 
teunuss: folds 
floriiiiider leaves the table
Hurloon: folds 
mikimiki88: folds 
Uncalled bet ($9) returned to king10clubs
king10clubs collected $15 from pot
king10clubs: doesn't show hand 
*** SUMMARY ***
Total pot $15 | Rake $0 
Seat 1: teunuss (button) folded before Flop (didn't bet)
Seat 2: Hurloon (small blind) folded before Flop
Seat 3: mikimiki88 (big blind) folded before Flop
Seat 4: king10clubs collected ($15)


PokerStars Game #102626814939:  Hold'em No Limit ($3/$6 USD) - 2013/08/11 17:39:25 ET
Table 'Crux V 40-100 bb' 6-max Seat #2 is the button
Seat 1: teunuss ($943.25 in chips) 
Seat 2: Hurloon ($600 in chips) 
Seat 3: mikimiki88 ($1085.01 in chips) 
Seat 4: king10clubs ($627.28 in chips) 
mikimiki88: posts small blind $3
king10clubs: posts big blind $6
*** HOLE CARDS ***
teunuss: folds 
Hurloon: folds 
mikimiki88: calls $3
king10clubs: checks 
*** FLOP *** [Qd 6s Ac]
mikimiki88: checks 
king10clubs: checks 
*** TURN *** [Qd 6s Ac] [9c]
nipe1955 joins the table at seat #5 
q1q23q joins the table at seat #6 
mikimiki88: checks 
king10clubs: checks 
*** RIVER *** [Qd 6s Ac 9c] [7h]
mikimiki88: bets $8.13
king10clubs: folds 
Uncalled bet ($8.13) returned to mikimiki88
mikimiki88 collected $11.46 from pot
mikimiki88: doesn't show hand 
*** SUMMARY ***
Total pot $12 | Rake $0.54 
Board [Qd 6s Ac 9c 7h]
Seat 1: teunuss folded before Flop (didn't bet)
Seat 2: Hurloon (button) folded before Flop (didn't bet)
Seat 3: mikimiki88 (small blind) collected ($11.46)
Seat 4: king10clubs (big blind) folded on the River


PokerStars Game #102627915149:  Hold'em No Limit ($3/$6 USD) - 2013/08/11 18:05:53 ET
Table 'Crux V 40-100 bb' 6-max Seat #6 is the button
Seat 1: GP Bar-T ($295.59 in chips) 
Seat 2: Flying Smile ($621 in chips) 
Seat 3: floriiiiider ($641 in chips) 
Seat 4: king10clubs ($609 in chips) 
Seat 5: Strz ($923.30 in chips) 
Seat 6: DeluxeSamy ($293.95 in chips) 
GP Bar-T: posts small blind $3
Flying Smile: posts big blind $6
*** HOLE CARDS ***
floriiiiider: folds 
king10clubs: folds 
Strz: folds 
DeluxeSamy: folds 
GP Bar-T: raises $6 to $12
Flying Smile: calls $6
*** FLOP *** [4d 7c Qs]
GP Bar-T: bets $12
Flying Smile: calls $12
*** TURN *** [4d 7c Qs] [Kd]
GP Bar-T: bets $25
Flying Smile: raises $59 to $84
GP Bar-T: raises $187.59 to $271.59 and is all-in
Flying Smile: calls $187.59
*** RIVER *** [4d 7c Qs Kd] [2s]
*** SHOW DOWN ***
GP Bar-T: shows [As 2d] (a pair of Deuces)
Flying Smile: shows [7s Kh] (two pair, Kings and Sevens)
Flying Smile collected $588.38 from pot
*** SUMMARY ***
Total pot $591.18 | Rake $2.80 
Board [4d 7c Qs Kd 2s]
Seat 1: GP Bar-T (small blind) showed [As 2d] and lost with a pair of Deuces
Seat 2: Flying Smile (big blind) showed [7s Kh] and won ($588.38) with two pair, Kings and Sevens
Seat 3: floriiiiider folded before Flop (didn't bet)
Seat 4: king10clubs folded before Flop (didn't bet)
Seat 5: Strz folded before Flop (didn't bet)
Seat 6: DeluxeSamy (button) folded before Flop (didn't bet)


PokerStars Game #102627965394:  Hold'em No Limit ($3/$6 USD) - 2013/08/11 18:07:01 ET
Table 'Crux V 40-100 bb' 6-max Seat #2 is the button
Seat 2: Flying Smile ($913.79 in chips) 
Seat 3: floriiiiider ($641 in chips) 
Seat 4: king10clubs ($609 in chips) 
Seat 5: Strz ($923.30 in chips) 
Seat 6: DeluxeSamy ($293.95 in chips) 
floriiiiider: posts small blind $3
king10clubs: posts big blind $6
*** HOLE CARDS ***
Strz: folds 
GP Bar-T leaves the table
DeluxeSamy: folds 
DeluxeSamy leaves the table
Strz leaves the table
Flying Smile: raises $6 to $12
floriiiiider: folds 
elvn89 joins the table at seat #5 
elvn89 leaves the table
TTSIP joins the table at seat #5 
king10clubs: calls $6
*** FLOP *** [9d As Kd]
king10clubs: checks 
Flying Smile: bets $18
king10clubs: folds 
Uncalled bet ($18) returned to Flying Smile
Flying Smile collected $25.78 from pot
*** SUMMARY ***
Total pot $27 | Rake $1.22 
Board [9d As Kd]
Seat 2: Flying Smile (button) collected ($25.78)
Seat 3: floriiiiider (small blind) folded before Flop
Seat 4: king10clubs (big blind) folded on the Flop
Seat 5: Strz folded before Flop (didn't bet)
Seat 6: DeluxeSamy folded before Flop (didn't bet)


PokerStars Game #102627530668:  Hold'em No Limit ($3/$6 USD) - 2013/08/11 17:55:19 ET
Table 'Crux V 40-100 bb' 6-max Seat #6 is the button
Seat 1: GP Bar-T ($346.19 in chips) 
Seat 4: king10clubs ($639 in chips) 
Seat 5: Strz ($865.90 in chips) 
Seat 6: DeluxeSamy ($231 in chips) 
GP Bar-T: posts small blind $3
mikimiki88: is sitting out 
king10clubs: posts big blind $6
*** HOLE CARDS ***
Strz: folds 
DeluxeSamy: raises $6 to $12
GP Bar-T: folds 
king10clubs: calls $6
*** FLOP *** [Ac Js Th]
king10clubs: checks 
DeluxeSamy: bets $18
king10clubs: folds 
Uncalled bet ($18) returned to DeluxeSamy
DeluxeSamy collected $25.78 from pot
DeluxeSamy: doesn't show hand 
*** SUMMARY ***
Total pot $27 | Rake $1.22 
Board [Ac Js Th]
Seat 1: GP Bar-T (small blind) folded before Flop
Seat 4: king10clubs (big blind) folded on the Flop
Seat 5: Strz folded before Flop (didn't bet)
Seat 6: DeluxeSamy (button) collected ($25.78)


PokerStars Game #102627541644:  Hold'em No Limit ($3/$6 USD) - 2013/08/11 17:55:41 ET
Table 'Crux V 40-100 bb' 6-max Seat #1 is the button
Seat 1: GP Bar-T ($343.19 in chips) 
Seat 4: king10clubs ($627 in chips) 
Seat 5: Strz ($865.90 in chips) 
Seat 6: DeluxeSamy ($244.78 in chips) 
Hurloon was removed from the table for failing to post
king10clubs: posts small blind $3
Strz: posts big blind $6
*** HOLE CARDS ***
DeluxeSamy: folds 
GP Bar-T: raises $12 to $18
q1q23q joins the table at seat #2 
king10clubs: folds 
Strz: folds 
Uncalled bet ($12) returned to GP Bar-T
GP Bar-T collected $15 from pot
GP Bar-T: doesn't show hand 
*** SUMMARY ***
Total pot $15 | Rake $0 
Seat 1: GP Bar-T (button) collected ($15)
Seat 4: king10clubs (small blind) folded before Flop
Seat 5: Strz (big blind) folded before Flop
Seat 6: DeluxeSamy folded before Flop (didn't bet)


PokerStars Game #102627550514:  Hold'em No Limit ($3/$6 USD) - 2013/08/11 17:55:59 ET
Table 'Crux V 40-100 bb' 6-max Seat #4 is the button
Seat 1: GP Bar-T ($352.19 in chips) 
Seat 4: king10clubs ($624 in chips) 
Seat 5: Strz ($859.90 in chips) 
Seat 6: DeluxeSamy ($244.78 in chips) 
Strz: posts small blind $3
DeluxeSamy: posts big blind $6
*** HOLE CARDS ***
GP Bar-T: raises $12 to $18
king10clubs: folds 
Strz: folds 
DeluxeSamy: folds 
Uncalled bet ($12) returned to GP Bar-T
GP Bar-T collected $15 from pot
GP Bar-T: doesn't show hand 
*** SUMMARY ***
Total pot $15 | Rake $0 
Seat 1: GP Bar-T collected ($15)
Seat 4: king10clubs (button) folded before Flop (didn't bet)
Seat 5: Strz (small blind) folded before Flop
Seat 6: DeluxeSamy (big blind) folded before Flop


PokerStars Game #102627557614:  Hold'em No Limit ($3/$6 USD) - 2013/08/11 17:56:13 ET
Table 'Crux V 40-100 bb' 6-max Seat #5 is the button
Seat 1: GP Bar-T ($361.19 in chips) 
Seat 4: king10clubs ($624 in chips) 
Seat 5: Strz ($856.90 in chips) 
Seat 6: DeluxeSamy ($238.78 in chips) 
DeluxeSamy: posts small blind $3
GP Bar-T: posts big blind $6
*** HOLE CARDS ***
king10clubs: folds 
Strz: raises $6 to $12
DeluxeSamy: folds 
GP Bar-T: raises $30 to $42
Strz: folds 
Uncalled bet ($30) returned to GP Bar-T
GP Bar-T collected $27 from pot
GP Bar-T: doesn't show hand 
*** SUMMARY ***
Total pot $27 | Rake $0 
Seat 1: GP Bar-T (big blind) collected ($27)
Seat 4: king10clubs folded before Flop (didn't bet)
Seat 5: Strz (button) folded before Flop
Seat 6: DeluxeSamy (small blind) folded before Flop


PokerStars Game #102627569056:  Hold'em No Limit ($3/$6 USD) - 2013/08/11 17:56:35 ET
Table 'Crux V 40-100 bb' 6-max Seat #6 is the button
Seat 1: GP Bar-T ($376.19 in chips) 
Seat 4: king10clubs ($624 in chips) 
Seat 5: Strz ($844.90 in chips) 
Seat 6: DeluxeSamy ($235.78 in chips) 
GP Bar-T: posts small blind $3
king10clubs: posts big blind $6
*** HOLE CARDS ***
Strz: raises $12 to $18
DeluxeSamy: folds 
GP Bar-T: folds 
king10clubs: folds 
Uncalled bet ($12) returned to Strz
Strz collected $15 from pot
*** SUMMARY ***
Total pot $15 | Rake $0 
Seat 1: GP Bar-T (small blind) folded before Flop
Seat 4: king10clubs (big blind) folded before Flop
Seat 5: Strz collected ($15)
Seat 6: DeluxeSamy (button) folded before Flop (didn't bet)


PokerStars Game #102627573629:  Hold'em No Limit ($3/$6 USD) - 2013/08/11 17:56:44 ET
Table 'Crux V 40-100 bb' 6-max Seat #1 is the button
Seat 1: GP Bar-T ($373.19 in chips) 
Seat 4: king10clubs ($618 in chips) 
Seat 5: Strz ($853.90 in chips) 
Seat 6: DeluxeSamy ($235.78 in chips) 
king10clubs: posts small blind $3
Strz: posts big blind $6
*** HOLE CARDS ***
DeluxeSamy: folds 
GP Bar-T: folds 
king10clubs: folds 
Uncalled bet ($3) returned to Strz
Strz collected $6 from pot
*** SUMMARY ***
Total pot $6 | Rake $0 
Seat 1: GP Bar-T (button) folded before Flop (didn't bet)
Seat 4: king10clubs (small blind) folded before Flop
Seat 5: Strz (big blind) collected ($6)
Seat 6: DeluxeSamy folded before Flop (didn't bet)


PokerStars Game #102627579623:  Hold'em No Limit ($3/$6 USD) - 2013/08/11 17:56:56 ET
Table 'Crux V 40-100 bb' 6-max Seat #4 is the button
Seat 1: GP Bar-T ($373.19 in chips) 
Seat 4: king10clubs ($615 in chips) 
Seat 5: Strz ($856.90 in chips) 
Seat 6: DeluxeSamy ($235.78 in chips) 
Strz: posts small blind $3
DeluxeSamy: posts big blind $6
*** HOLE CARDS ***
GP Bar-T: folds 
king10clubs: raises $6 to $12
Strz: folds 
DeluxeSamy: folds 
Uncalled bet ($6) returned to king10clubs
king10clubs collected $15 from pot
king10clubs: doesn't show hand 
*** SUMMARY ***
Total pot $15 | Rake $0 
Seat 1: GP Bar-T folded before Flop (didn't bet)
Seat 4: king10clubs (button) collected ($15)
Seat 5: Strz (small blind) folded before Flop
Seat 6: DeluxeSamy (big blind) folded before Flop


PokerStars Game #102627590226:  Hold'em No Limit ($3/$6 USD) - 2013/08/11 17:57:17 ET
Table 'Crux V 40-100 bb' 6-max Seat #5 is the button
Seat 1: GP Bar-T ($373.19 in chips) 
Seat 4: king10clubs ($624 in chips) 
Seat 5: Strz ($853.90 in chips) 
Seat 6: DeluxeSamy ($229.78 in chips) 
DeluxeSamy: posts small blind $3
GP Bar-T: posts big blind $6
*** HOLE CARDS ***
king10clubs: folds 
Strz: folds 
DeluxeSamy: raises $6 to $12
GP Bar-T: calls $6
*** FLOP *** [8c Kc Ks]
DeluxeSamy: bets $12
GP Bar-T: folds 
Uncalled bet ($12) returned to DeluxeSamy
DeluxeSamy collected $22.92 from pot
DeluxeSamy: doesn't show hand 
*** SUMMARY ***
Total pot $24 | Rake $1.08 
Board [8c Kc Ks]
Seat 1: GP Bar-T (big blind) folded on the Flop
Seat 4: king10clubs folded before Flop (didn't bet)
Seat 5: Strz (button) folded before Flop (didn't bet)
Seat 6: DeluxeSamy (small blind) collected ($22.92)


PokerStars Game #102627603253:  Hold'em No Limit ($3/$6 USD) - 2013/08/11 17:57:42 ET
Table 'Crux V 40-100 bb' 6-max Seat #6 is the button
Seat 1: GP Bar-T ($361.19 in chips) 
Seat 4: king10clubs ($624 in chips) 
Seat 5: Strz ($853.90 in chips) 
Seat 6: DeluxeSamy ($240.70 in chips) 
GP Bar-T: posts small blind $3
king10clubs: posts big blind $6
*** HOLE CARDS ***
Strz: raises $12 to $18
DeluxeSamy: folds 
GP Bar-T: folds 
king10clubs: folds 
Uncalled bet ($12) returned to Strz
Strz collected $15 from pot
*** SUMMARY ***
Total pot $15 | Rake $0 
Seat 1: GP Bar-T (small blind) folded before Flop
Seat 4: king10clubs (big blind) folded before Flop
Seat 5: Strz collected ($15)
Seat 6: DeluxeSamy (button) folded before Flop (didn't bet)


PokerStars Game #102627608170:  Hold'em No Limit ($3/$6 USD) - 2013/08/11 17:57:52 ET
Table 'Crux V 40-100 bb' 6-max Seat #1 is the button
Seat 1: GP Bar-T ($358.19 in chips) 
Seat 4: king10clubs ($618 in chips) 
Seat 5: Strz ($862.90 in chips) 
Seat 6: DeluxeSamy ($240.70 in chips) 
king10clubs: posts small blind $3
Strz: posts big blind $6
*** HOLE CARDS ***
DeluxeSamy: raises $6 to $12
GP Bar-T: calls $12
king10clubs: folds 
Strz: folds 
*** FLOP *** [Qs 2h 3c]
DeluxeSamy: bets $18
GP Bar-T: calls $18
*** TURN *** [Qs 2h 3c] [Kc]
DeluxeSamy: bets $48
GP Bar-T: folds 
Uncalled bet ($48) returned to DeluxeSamy
DeluxeSamy collected $67.50 from pot
DeluxeSamy: doesn't show hand 
*** SUMMARY ***
Total pot $69 | Rake $1.50 
Board [Qs 2h 3c Kc]
Seat 1: GP Bar-T (button) folded on the Turn
Seat 4: king10clubs (small blind) folded before Flop
Seat 5: Strz (big blind) folded before Flop
Seat 6: DeluxeSamy collected ($67.50)


PokerStars Game #102627626546:  Hold'em No Limit ($3/$6 USD) - 2013/08/11 17:58:29 ET
Table 'Crux V 40-100 bb' 6-max Seat #4 is the button
Seat 1: GP Bar-T ($328.19 in chips) 
Seat 4: king10clubs ($615 in chips) 
Seat 5: Strz ($856.90 in chips) 
Seat 6: DeluxeSamy ($278.20 in chips) 
Strz: posts small blind $3
DeluxeSamy: posts big blind $6
*** HOLE CARDS ***
GP Bar-T: folds 
king10clubs: raises $6 to $12
Strz: folds 
DeluxeSamy: raises $33 to $45
king10clubs: folds 
Uncalled bet ($33) returned to DeluxeSamy
DeluxeSamy collected $27 from pot
DeluxeSamy: doesn't show hand 
*** SUMMARY ***
Total pot $27 | Rake $0 
Seat 1: GP Bar-T folded before Flop (didn't bet)
Seat 4: king10clubs (button) folded before Flop
Seat 5: Strz (small blind) folded before Flop
Seat 6: DeluxeSamy (big blind) collected ($27)


PokerStars Game #102627636429:  Hold'em No Limit ($3/$6 USD) - 2013/08/11 17:58:48 ET
Table 'Crux V 40-100 bb' 6-max Seat #5 is the button
Seat 1: GP Bar-T ($328.19 in chips) 
Seat 4: king10clubs ($603 in chips) 
Seat 5: Strz ($853.90 in chips) 
Seat 6: DeluxeSamy ($293.20 in chips) 
DeluxeSamy: posts small blind $3
GP Bar-T: posts big blind $6
*** HOLE CARDS ***
king10clubs: folds 
Strz: folds 
DeluxeSamy: raises $6 to $12
GP Bar-T: calls $6
*** FLOP *** [8h Tc Ad]
DeluxeSamy: bets $15
GP Bar-T: calls $15
*** TURN *** [8h Tc Ad] [Kc]
DeluxeSamy: checks 
GP Bar-T: checks 
*** RIVER *** [8h Tc Ad Kc] [4h]
DeluxeSamy: checks 
GP Bar-T: bets $30
DeluxeSamy: folds 
Uncalled bet ($30) returned to GP Bar-T
GP Bar-T collected $52.50 from pot
GP Bar-T: doesn't show hand 
*** SUMMARY ***
Total pot $54 | Rake $1.50 
Board [8h Tc Ad Kc 4h]
Seat 1: GP Bar-T (big blind) collected ($52.50)
Seat 4: king10clubs folded before Flop (didn't bet)
Seat 5: Strz (button) folded before Flop (didn't bet)
Seat 6: DeluxeSamy (small blind) folded on the River


PokerStars Game #102627656606:  Hold'em No Limit ($3/$6 USD) - 2013/08/11 17:59:28 ET
Table 'Crux V 40-100 bb' 6-max Seat #6 is the button
Seat 1: GP Bar-T ($353.69 in chips) 
Seat 4: king10clubs ($603 in chips) 
Seat 5: Strz ($853.90 in chips) 
Seat 6: DeluxeSamy ($266.20 in chips) 
GP Bar-T: posts small blind $3
king10clubs: posts big blind $6
*** HOLE CARDS ***
Strz: folds 
DeluxeSamy: raises $6 to $12
GP Bar-T: folds 
king10clubs: raises $30 to $42
DeluxeSamy: raises $224.20 to $266.20 and is all-in
king10clubs: calls $224.20
*** FIRST FLOP *** [8c 8h 6c]
*** FIRST TURN *** [8c 8h 6c] [4h]
*** FIRST RIVER *** [8c 8h 6c 4h] [Qh]
*** SECOND FLOP *** [As 9d 2h]
*** SECOND TURN *** [As 9d 2h] [5d]
*** SECOND RIVER *** [As 9d 2h 5d] [6d]
*** FIRST SHOW DOWN ***
king10clubs: shows [7h 7d] (two pair, Eights and Sevens)
DeluxeSamy: shows [Jc Ac] (a pair of Eights)
king10clubs collected $266.95 from pot
*** SECOND SHOW DOWN ***
king10clubs: shows [7h 7d] (a pair of Sevens)
DeluxeSamy: shows [Jc Ac] (a pair of Aces)
DeluxeSamy collected $266.95 from pot
*** SUMMARY ***
Total pot $535.40 | Rake $1.50 
Hand was run twice
FIRST Board [8c 8h 6c 4h Qh]
SECOND Board [As 9d 2h 5d 6d]
Seat 1: GP Bar-T (small blind) folded before Flop
Seat 4: king10clubs (big blind) showed [7h 7d] and won ($266.95) with two pair, Eights and Sevens, and lost with a pair of Sevens
Seat 5: Strz folded before Flop (didn't bet)
Seat 6: DeluxeSamy (button) showed [Jc Ac] and lost with a pair of Eights, and won ($266.95) with a pair of Aces


PokerStars Game #102627685087:  Hold'em No Limit ($3/$6 USD) - 2013/08/11 18:00:22 ET
Table 'Crux V 40-100 bb' 6-max Seat #1 is the button
Seat 1: GP Bar-T ($350.69 in chips) 
Seat 4: king10clubs ($603.75 in chips) 
Seat 5: Strz ($853.90 in chips) 
Seat 6: DeluxeSamy ($266.95 in chips) 
king10clubs: posts small blind $3
Strz: posts big blind $6
*** HOLE CARDS ***
DeluxeSamy: folds 
GP Bar-T: folds 
king10clubs: folds 
Uncalled bet ($3) returned to Strz
Strz collected $6 from pot
*** SUMMARY ***
Total pot $6 | Rake $0 
Seat 1: GP Bar-T (button) folded before Flop (didn't bet)
Seat 4: king10clubs (small blind) folded before Flop
Seat 5: Strz (big blind) collected ($6)
Seat 6: DeluxeSamy folded before Flop (didn't bet)


PokerStars Game #102627689065:  Hold'em No Limit ($3/$6 USD) - 2013/08/11 18:00:30 ET
Table 'Crux V 40-100 bb' 6-max Seat #4 is the button
Seat 1: GP Bar-T ($350.69 in chips) 
Seat 4: king10clubs ($600.75 in chips) 
Seat 5: Strz ($856.90 in chips) 
Seat 6: DeluxeSamy ($266.95 in chips) 
Strz: posts small blind $3
DeluxeSamy: posts big blind $6
*** HOLE CARDS ***
GP Bar-T: folds 
king10clubs: raises $6 to $12
Strz: folds 
DeluxeSamy: raises $33 to $45
king10clubs: folds 
Uncalled bet ($33) returned to DeluxeSamy
DeluxeSamy collected $27 from pot
DeluxeSamy: doesn't show hand 
*** SUMMARY ***
Total pot $27 | Rake $0 
Seat 1: GP Bar-T folded before Flop (didn't bet)
Seat 4: king10clubs (button) folded before Flop
Seat 5: Strz (small blind) folded before Flop
Seat 6: DeluxeSamy (big blind) collected ($27)


PokerStars Game #102627697890:  Hold'em No Limit ($3/$6 USD) - 2013/08/11 18:00:46 ET
Table 'Crux V 40-100 bb' 6-max Seat #5 is the button
Seat 1: GP Bar-T ($350.69 in chips) 
Seat 4: king10clubs ($600 in chips) 
Seat 5: Strz ($853.90 in chips) 
Seat 6: DeluxeSamy ($281.95 in chips) 
DeluxeSamy: posts small blind $3
GP Bar-T: posts big blind $6
*** HOLE CARDS ***
king10clubs: raises $9 to $15
Strz: folds 
DeluxeSamy: raises $24 to $39
GP Bar-T: folds 
king10clubs: folds 
Uncalled bet ($24) returned to DeluxeSamy
DeluxeSamy collected $36 from pot
DeluxeSamy: doesn't show hand 
*** SUMMARY ***
Total pot $36 | Rake $0 
Seat 1: GP Bar-T (big blind) folded before Flop
Seat 4: king10clubs folded before Flop
Seat 5: Strz (button) folded before Flop (didn't bet)
Seat 6: DeluxeSamy (small blind) collected ($36)


PokerStars Game #102627711981:  Hold'em No Limit ($3/$6 USD) - 2013/08/11 18:01:10 ET
Table 'Crux V 40-100 bb' 6-max Seat #6 is the button
Seat 1: GP Bar-T ($344.69 in chips) 
Seat 4: king10clubs ($600 in chips) 
Seat 5: Strz ($853.90 in chips) 
Seat 6: DeluxeSamy ($302.95 in chips) 
GP Bar-T: posts small blind $3
king10clubs: posts big blind $6
*** HOLE CARDS ***
Strz: folds 
DeluxeSamy: raises $6 to $12
GP Bar-T: folds 
king10clubs: folds 
Uncalled bet ($6) returned to DeluxeSamy
DeluxeSamy collected $15 from pot
DeluxeSamy: doesn't show hand 
*** SUMMARY ***
Total pot $15 | Rake $0 
Seat 1: GP Bar-T (small blind) folded before Flop
Seat 4: king10clubs (big blind) folded before Flop
Seat 5: Strz folded before Flop (didn't bet)
Seat 6: DeluxeSamy (button) collected ($15)


PokerStars Game #102627718450:  Hold'em No Limit ($3/$6 USD) - 2013/08/11 18:01:21 ET
Table 'Crux V 40-100 bb' 6-max Seat #1 is the button
Seat 1: GP Bar-T ($341.69 in chips) 
Seat 4: king10clubs ($600 in chips) 
Seat 5: Strz ($853.90 in chips) 
Seat 6: DeluxeSamy ($311.95 in chips) 
mikimiki88 was removed from the table for failing to post
king10clubs: posts small blind $3
Strz: posts big blind $6
*** HOLE CARDS ***
floriiiiider joins the table at seat #3 
DeluxeSamy: folds 
GP Bar-T: folds 
king10clubs: folds 
Uncalled bet ($3) returned to Strz
Strz collected $6 from pot
*** SUMMARY ***
Total pot $6 | Rake $0 
Seat 1: GP Bar-T (button) folded before Flop (didn't bet)
Seat 4: king10clubs (small blind) folded before Flop
Seat 5: Strz (big blind) collected ($6)
Seat 6: DeluxeSamy folded before Flop (didn't bet)


PokerStars Game #102627726406:  Hold'em No Limit ($3/$6 USD) - 2013/08/11 18:01:33 ET
Table 'Crux V 40-100 bb' 6-max Seat #4 is the button
Seat 1: GP Bar-T ($341.69 in chips) 
Seat 4: king10clubs ($600 in chips) 
Seat 5: Strz ($856.90 in chips) 
Seat 6: DeluxeSamy ($311.95 in chips) 
Strz: posts small blind $3
DeluxeSamy: posts big blind $6
floriiiiider: sits out 
*** HOLE CARDS ***
GP Bar-T: folds 
king10clubs: raises $6 to $12
Strz: folds 
DeluxeSamy: folds 
Uncalled bet ($6) returned to king10clubs
king10clubs collected $15 from pot
king10clubs: doesn't show hand 
*** SUMMARY ***
Total pot $15 | Rake $0 
Seat 1: GP Bar-T folded before Flop (didn't bet)
Seat 4: king10clubs (button) collected ($15)
Seat 5: Strz (small blind) folded before Flop
Seat 6: DeluxeSamy (big blind) folded before Flop


PokerStars Game #102627733279:  Hold'em No Limit ($3/$6 USD) - 2013/08/11 18:01:44 ET
Table 'Crux V 40-100 bb' 6-max Seat #5 is the button
Seat 1: GP Bar-T ($341.69 in chips) 
Seat 4: king10clubs ($609 in chips) 
Seat 5: Strz ($853.90 in chips) 
Seat 6: DeluxeSamy ($305.95 in chips) 
DeluxeSamy: posts small blind $3
GP Bar-T: posts big blind $6
floriiiiider: sits out 
*** HOLE CARDS ***
king10clubs: raises $9 to $15
Strz: folds 
DeluxeSamy: folds 
GP Bar-T: folds 
Uncalled bet ($9) returned to king10clubs
king10clubs collected $15 from pot
king10clubs: doesn't show hand 
*** SUMMARY ***
Total pot $15 | Rake $0 
Seat 1: GP Bar-T (big blind) folded before Flop
Seat 4: king10clubs collected ($15)
Seat 5: Strz (button) folded before Flop (didn't bet)
Seat 6: DeluxeSamy (small blind) folded before Flop


PokerStars Game #102627742272:  Hold'em No Limit ($3/$6 USD) - 2013/08/11 18:01:58 ET
Table 'Crux V 40-100 bb' 6-max Seat #6 is the button
Seat 1: GP Bar-T ($335.69 in chips) 
Seat 3: floriiiiider ($663.40 in chips) 
Seat 4: king10clubs ($618 in chips) 
Seat 5: Strz ($853.90 in chips) 
Seat 6: DeluxeSamy ($302.95 in chips) 
GP Bar-T: posts small blind $3
floriiiiider: posts big blind $6
*** HOLE CARDS ***
king10clubs: folds 
Strz: folds 
DeluxeSamy: folds 
GP Bar-T: raises $12 to $18
floriiiiider: calls $12
*** FLOP *** [4c 4d 6h]
GP Bar-T: bets $18
floriiiiider: calls $18
*** TURN *** [4c 4d 6h] [7d]
GP Bar-T: bets $40
floriiiiider: calls $40
*** RIVER *** [4c 4d 6h 7d] [Tc]
GP Bar-T: bets $80
floriiiiider: calls $80
*** SHOW DOWN ***
GP Bar-T: shows [5d 7c] (two pair, Sevens and Fours)
floriiiiider: shows [8c 7s] (two pair, Sevens and Fours)
GP Bar-T collected $154.60 from pot
floriiiiider collected $154.60 from pot
*** SUMMARY ***
Total pot $312 | Rake $2.80 
Board [4c 4d 6h 7d Tc]
Seat 1: GP Bar-T (small blind) showed [5d 7c] and won ($154.60) with two pair, Sevens and Fours
Seat 3: floriiiiider (big blind) showed [8c 7s] and won ($154.60) with two pair, Sevens and Fours
Seat 4: king10clubs folded before Flop (didn't bet)
Seat 5: Strz folded before Flop (didn't bet)
Seat 6: DeluxeSamy (button) folded before Flop (didn't bet)


PokerStars Game #102627774410:  Hold'em No Limit ($3/$6 USD) - 2013/08/11 18:02:43 ET
Table 'Crux V 40-100 bb' 6-max Seat #1 is the button
Seat 1: GP Bar-T ($334.29 in chips) 
Seat 3: floriiiiider ($662 in chips) 
Seat 4: king10clubs ($618 in chips) 
Seat 5: Strz ($853.90 in chips) 
Seat 6: DeluxeSamy ($302.95 in chips) 
q1q23q was removed from the table for failing to post
floriiiiider: posts small blind $3
king10clubs: posts big blind $6
*** HOLE CARDS ***
Strz: raises $12 to $18
Flying Smile joins the table at seat #2 
DeluxeSamy: folds 
GP Bar-T: calls $18
floriiiiider: folds 
king10clubs: folds 
*** FLOP *** [Td 4c 7s]
Strz: bets $30
GP Bar-T: calls $30
*** TURN *** [Td 4c 7s] [Qh]
Strz: bets $78
GP Bar-T: folds 
Uncalled bet ($78) returned to Strz
Strz collected $102.20 from pot
*** SUMMARY ***
Total pot $105 | Rake $2.80 
Board [Td 4c 7s Qh]
Seat 1: GP Bar-T (button) folded on the Turn
Seat 3: floriiiiider (small blind) folded before Flop
Seat 4: king10clubs (big blind) folded before Flop
Seat 5: Strz collected ($102.20)
Seat 6: DeluxeSamy folded before Flop (didn't bet)


PokerStars Game #102627804862:  Hold'em No Limit ($3/$6 USD) - 2013/08/11 18:03:25 ET
Table 'Crux V 40-100 bb' 6-max Seat #3 is the button
Seat 1: GP Bar-T ($286.29 in chips) 
Seat 3: floriiiiider ($659 in chips) 
Seat 4: king10clubs ($612 in chips) 
Seat 5: Strz ($908.10 in chips) 
Seat 6: DeluxeSamy ($302.95 in chips) 
king10clubs: posts small blind $3
Strz: posts big blind $6
Flying Smile: sits out 
*** HOLE CARDS ***
DeluxeSamy: folds 
GP Bar-T: folds 
floriiiiider: folds 
king10clubs: folds 
Uncalled bet ($3) returned to Strz
Strz collected $6 from pot
*** SUMMARY ***
Total pot $6 | Rake $0 
Seat 1: GP Bar-T folded before Flop (didn't bet)
Seat 3: floriiiiider (button) folded before Flop (didn't bet)
Seat 4: king10clubs (small blind) folded before Flop
Seat 5: Strz (big blind) collected ($6)
Seat 6: DeluxeSamy folded before Flop (didn't bet)


PokerStars Game #102627814329:  Hold'em No Limit ($3/$6 USD) - 2013/08/11 18:03:38 ET
Table 'Crux V 40-100 bb' 6-max Seat #4 is the button
Seat 1: GP Bar-T ($286.29 in chips) 
Seat 3: floriiiiider ($659 in chips) 
Seat 4: king10clubs ($609 in chips) 
Seat 5: Strz ($911.10 in chips) 
Seat 6: DeluxeSamy ($302.95 in chips) 
Strz: posts small blind $3
DeluxeSamy: posts big blind $6
Flying Smile: sits out 
*** HOLE CARDS ***
GP Bar-T: raises $12 to $18
floriiiiider: calls $18
king10clubs: folds 
Strz: calls $15
DeluxeSamy: folds 
*** FLOP *** [Td 4s 6d]
Strz: checks 
GP Bar-T: bets $25
floriiiiider: folds 
Strz: folds 
Uncalled bet ($25) returned to GP Bar-T
GP Bar-T collected $57.30 from pot
GP Bar-T: doesn't show hand 
*** SUMMARY ***
Total pot $60 | Rake $2.70 
Board [Td 4s 6d]
Seat 1: GP Bar-T collected ($57.30)
Seat 3: floriiiiider folded on the Flop
Seat 4: king10clubs (button) folded before Flop (didn't bet)
Seat 5: Strz (small blind) folded on the Flop
Seat 6: DeluxeSamy (big blind) folded before Flop


PokerStars Game #102627854135:  Hold'em No Limit ($3/$6 USD) - 2013/08/11 18:04:31 ET
Table 'Crux V 40-100 bb' 6-max Seat #5 is the button
Seat 1: GP Bar-T ($325.59 in chips) 
Seat 3: floriiiiider ($641 in chips) 
Seat 4: king10clubs ($609 in chips) 
Seat 5: Strz ($893.10 in chips) 
Seat 6: DeluxeSamy ($296.95 in chips) 
DeluxeSamy: posts small blind $3
GP Bar-T: posts big blind $6
Flying Smile: sits out 
*** HOLE CARDS ***
floriiiiider: folds 
king10clubs: folds 
Strz: raises $6 to $12
DeluxeSamy: folds 
GP Bar-T: calls $6
*** FLOP *** [Qh 6h Td]
GP Bar-T: checks 
Strz: bets $18
GP Bar-T: calls $18
*** TURN *** [Qh 6h Td] [2c]
GP Bar-T: checks 
Strz: bets $60
GP Bar-T is connected 
GP Bar-T: folds 
Uncalled bet ($60) returned to Strz
Strz collected $60.20 from pot
*** SUMMARY ***
Total pot $63 | Rake $2.80 
Board [Qh 6h Td 2c]
Seat 1: GP Bar-T (big blind) folded on the Turn
Seat 3: floriiiiider folded before Flop (didn't bet)
Seat 4: king10clubs folded before Flop (didn't bet)
Seat 5: Strz (button) collected ($60.20)
Seat 6: DeluxeSamy (small blind) folded before Flop
