

PokerStars Game #102597282523:  Hold'em No Limit ($3/$6 USD) - 2013/08/11 5:29:03 ET
Table 'Lorcia IV 40-100 bb' 6-max Seat #1 is the button
Seat 1: ZarubaNT ($600 in chips) 
Seat 2: HoldenUte03 ($240 in chips) 
Seat 3: QB0970016888 ($306.90 in chips) 
Seat 4: vjxbkf ($600 in chips) 
HoldenUte03: posts small blind $3
QB0970016888: posts big blind $6
*** HOLE CARDS ***
vjxbkf: folds 
ZarubaNT: raises $6 to $12
HoldenUte03: folds 
QB0970016888: folds 
Uncalled bet ($6) returned to ZarubaNT
Blazterr joins the table at seat #5 
ZarubaNT collected $15 from pot
ZarubaNT: doesn't show hand 
*** SUMMARY ***
Total pot $15 | Rake $0 
Seat 1: ZarubaNT (button) collected ($15)
Seat 2: HoldenUte03 (small blind) folded before Flop
Seat 3: QB0970016888 (big blind) folded before Flop
Seat 4: vjxbkf folded before Flop (didn't bet)


PokerStars Game #102597292200:  Hold'em No Limit ($3/$6 USD) - 2013/08/11 5:29:28 ET
Table 'Lorcia IV 40-100 bb' 6-max Seat #2 is the button
Seat 1: ZarubaNT ($609 in chips) 
Seat 2: HoldenUte03 ($237 in chips) 
Seat 3: QB0970016888 ($300.90 in chips) 
Seat 4: vjxbkf ($600 in chips) 
QB0970016888: posts small blind $3
vjxbkf: posts big blind $6
Blazterr: sits out 
*** HOLE CARDS ***
ZarubaNT: folds 
HoldenUte03: folds 
d`svictoriae joins the table at seat #6 
QB0970016888: raises $9 to $15
vjxbkf: calls $9
*** FLOP *** [4c Kd 7h]
QB0970016888: bets $18
vjxbkf: calls $18
*** TURN *** [4c Kd 7h] [2c]
QB0970016888: checks 
vjxbkf: bets $39
QB0970016888: folds 
Uncalled bet ($39) returned to vjxbkf
vjxbkf collected $64.50 from pot
vjxbkf: doesn't show hand 
*** SUMMARY ***
Total pot $66 | Rake $1.50 
Board [4c Kd 7h 2c]
Seat 1: ZarubaNT folded before Flop (didn't bet)
Seat 2: HoldenUte03 (button) folded before Flop (didn't bet)
Seat 3: QB0970016888 (small blind) folded on the Turn
Seat 4: vjxbkf (big blind) collected ($64.50)


PokerStars Game #102597555331:  Hold'em No Limit ($3/$6 USD) - 2013/08/11 5:40:28 ET
Table 'Lorcia IV 40-100 bb' 6-max Seat #4 is the button
Seat 1: ZarubaNT ($609 in chips) 
Seat 2: HoldenUte03 ($309.24 in chips) 
Seat 3: QB0970016888 ($268.10 in chips) 
Seat 4: vjxbkf ($645.20 in chips) 
Seat 5: Blazterr ($225 in chips) 
Seat 6: d`svictoriae ($465 in chips) 
Blazterr: posts small blind $3
d`svictoriae: posts big blind $6
*** HOLE CARDS ***
ZarubaNT: folds 
HoldenUte03: calls $6
QB0970016888: raises $12 to $18
vjxbkf: folds 
Blazterr: folds 
d`svictoriae: calls $12
HoldenUte03: folds 
*** FLOP *** [8c Qd 8h]
d`svictoriae: checks 
QB0970016888: bets $30
d`svictoriae: calls $30
*** TURN *** [8c Qd 8h] [7c]
d`svictoriae: checks 
QB0970016888: checks 
*** RIVER *** [8c Qd 8h 7c] [7d]
d`svictoriae: checks 
QB0970016888: bets $96
d`svictoriae: folds 
Uncalled bet ($96) returned to QB0970016888
QB0970016888 collected $102.20 from pot
QB0970016888: doesn't show hand 
*** SUMMARY ***
Total pot $105 | Rake $2.80 
Board [8c Qd 8h 7c 7d]
Seat 1: ZarubaNT folded before Flop (didn't bet)
Seat 2: HoldenUte03 folded before Flop
Seat 3: QB0970016888 collected ($102.20)
Seat 4: vjxbkf (button) folded before Flop (didn't bet)
Seat 5: Blazterr (small blind) folded before Flop
Seat 6: d`svictoriae (big blind) folded on the River


PokerStars Game #102597610508:  Hold'em No Limit ($3/$6 USD) - 2013/08/11 5:42:44 ET
Table 'Lorcia IV 40-100 bb' 6-max Seat #5 is the button
Seat 1: ZarubaNT ($609 in chips) 
Seat 2: HoldenUte03 ($303.24 in chips) 
Seat 3: QB0970016888 ($322.30 in chips) 
Seat 4: vjxbkf ($645.20 in chips) 
Seat 5: Blazterr ($222 in chips) 
Seat 6: d`svictoriae ($417 in chips) 
d`svictoriae: posts small blind $3
ZarubaNT: posts big blind $6
*** HOLE CARDS ***
HoldenUte03: folds 
QB0970016888: folds 
vjxbkf: folds 
Blazterr: raises $6 to $12
d`svictoriae: calls $9
ZarubaNT: calls $6
*** FLOP *** [Th Kd Jc]
d`svictoriae: checks 
ZarubaNT: checks 
Blazterr: checks 
*** TURN *** [Th Kd Jc] [5c]
d`svictoriae: checks 
ZarubaNT: checks 
Blazterr: checks 
*** RIVER *** [Th Kd Jc 5c] [Ad]
d`svictoriae: checks 
ZarubaNT: checks 
Blazterr: checks 
*** SHOW DOWN ***
d`svictoriae: shows [Td 9s] (a pair of Tens)
ZarubaNT: mucks hand 
Blazterr: shows [2d As] (a pair of Aces)
Blazterr collected $34.38 from pot
*** SUMMARY ***
Total pot $36 | Rake $1.62 
Board [Th Kd Jc 5c Ad]
Seat 1: ZarubaNT (big blind) mucked
Seat 2: HoldenUte03 folded before Flop (didn't bet)
Seat 3: QB0970016888 folded before Flop (didn't bet)
Seat 4: vjxbkf folded before Flop (didn't bet)
Seat 5: Blazterr (button) showed [2d As] and won ($34.38) with a pair of Aces
Seat 6: d`svictoriae (small blind) showed [Td 9s] and lost with a pair of Tens


PokerStars Game #102597646528:  Hold'em No Limit ($3/$6 USD) - 2013/08/11 5:44:12 ET
Table 'Lorcia IV 40-100 bb' 6-max Seat #6 is the button
Seat 1: ZarubaNT ($600 in chips) 
Seat 2: HoldenUte03 ($303.24 in chips) 
Seat 3: QB0970016888 ($322.30 in chips) 
Seat 4: vjxbkf ($645.20 in chips) 
Seat 5: Blazterr ($244.38 in chips) 
Seat 6: d`svictoriae ($405 in chips) 
ZarubaNT: posts small blind $3
HoldenUte03: posts big blind $6
*** HOLE CARDS ***
QB0970016888: folds 
vjxbkf: folds 
Blazterr: folds 
d`svictoriae: folds 
ZarubaNT: folds 
Uncalled bet ($3) returned to HoldenUte03
HoldenUte03 collected $6 from pot
*** SUMMARY ***
Total pot $6 | Rake $0 
Seat 1: ZarubaNT (small blind) folded before Flop
Seat 2: HoldenUte03 (big blind) collected ($6)
Seat 3: QB0970016888 folded before Flop (didn't bet)
Seat 4: vjxbkf folded before Flop (didn't bet)
Seat 5: Blazterr folded before Flop (didn't bet)
Seat 6: d`svictoriae (button) folded before Flop (didn't bet)


PokerStars Game #102597654178:  Hold'em No Limit ($3/$6 USD) - 2013/08/11 5:44:31 ET
Table 'Lorcia IV 40-100 bb' 6-max Seat #1 is the button
Seat 1: ZarubaNT ($600 in chips) 
Seat 2: HoldenUte03 ($306.24 in chips) 
Seat 3: QB0970016888 ($322.30 in chips) 
Seat 4: vjxbkf ($645.20 in chips) 
Seat 5: Blazterr ($244.38 in chips) 
Seat 6: d`svictoriae ($405 in chips) 
HoldenUte03: posts small blind $3
QB0970016888: posts big blind $6
*** HOLE CARDS ***
vjxbkf: folds 
Blazterr: raises $9 to $15
d`svictoriae: folds 
ZarubaNT: folds 
HoldenUte03: folds 
QB0970016888: folds 
Uncalled bet ($9) returned to Blazterr
Blazterr collected $15 from pot
HoldenUte03 leaves the table
Blazterr: doesn't show hand 
*** SUMMARY ***
Total pot $15 | Rake $0 
Seat 1: ZarubaNT (button) folded before Flop (didn't bet)
Seat 2: HoldenUte03 (small blind) folded before Flop
Seat 3: QB0970016888 (big blind) folded before Flop
Seat 4: vjxbkf folded before Flop (didn't bet)
Seat 5: Blazterr collected ($15)
Seat 6: d`svictoriae folded before Flop (didn't bet)


PokerStars Game #102597662983:  Hold'em No Limit ($3/$6 USD) - 2013/08/11 5:44:52 ET
Table 'Lorcia IV 40-100 bb' 6-max Seat #3 is the button
Seat 1: ZarubaNT ($600 in chips) 
Seat 3: QB0970016888 ($316.30 in chips) 
Seat 4: vjxbkf ($645.20 in chips) 
Seat 5: Blazterr ($253.38 in chips) 
Seat 6: d`svictoriae ($405 in chips) 
vjxbkf: posts small blind $3
Blazterr: posts big blind $6
*** HOLE CARDS ***
d`svictoriae: folds 
ZarubaNT: folds 
QB0970016888: raises $9 to $15
vjxbkf: raises $24 to $39
Blazterr: folds 
QB0970016888: calls $24
*** FLOP *** [Qs 6s 7c]
floriiiiider joins the table at seat #2 
vjxbkf: bets $60
QB0970016888: calls $60
*** TURN *** [Qs 6s 7c] [8d]
vjxbkf: bets $546.20 and is all-in
QB0970016888: calls $217.30 and is all-in
Uncalled bet ($328.90) returned to vjxbkf
*** RIVER *** [Qs 6s 7c 8d] [3d]
*** SHOW DOWN ***
vjxbkf: shows [8s Js] (a pair of Eights)
QB0970016888: shows [Qd Td] (a pair of Queens)
QB0970016888 collected $635.80 from pot
*** SUMMARY ***
Total pot $638.60 | Rake $2.80 
Board [Qs 6s 7c 8d 3d]
Seat 1: ZarubaNT folded before Flop (didn't bet)
Seat 3: QB0970016888 (button) showed [Qd Td] and won ($635.80) with a pair of Queens
Seat 4: vjxbkf (small blind) showed [8s Js] and lost with a pair of Eights
Seat 5: Blazterr (big blind) folded before Flop
Seat 6: d`svictoriae folded before Flop (didn't bet)


PokerStars Game #102597440848:  Hold'em No Limit ($3/$6 USD) - 2013/08/11 5:35:41 ET
Table 'Lorcia IV 40-100 bb' 6-max Seat #6 is the button
Seat 1: ZarubaNT ($603 in chips) 
Seat 2: HoldenUte03 ($276.04 in chips) 
Seat 3: QB0970016888 ($313.10 in chips) 
Seat 4: vjxbkf ($600 in chips) 
Seat 5: Blazterr ($231 in chips) 
Seat 6: d`svictoriae ($465 in chips) 
ZarubaNT: posts small blind $3
HoldenUte03: posts big blind $6
*** HOLE CARDS ***
QB0970016888: folds 
vjxbkf: raises $12 to $18
Blazterr: folds 
d`svictoriae: folds 
ZarubaNT: calls $15
HoldenUte03: folds 
*** FLOP *** [6d 7s Kh]
ZarubaNT: checks 
vjxbkf: bets $24
ZarubaNT: calls $24
*** TURN *** [6d 7s Kh] [8c]
ZarubaNT: checks 
vjxbkf: checks 
*** RIVER *** [6d 7s Kh 8c] [8d]
ZarubaNT: checks 
vjxbkf: checks 
*** SHOW DOWN ***
ZarubaNT: shows [Jh Ah] (a pair of Eights)
vjxbkf: shows [9h 9s] (two pair, Nines and Eights)
vjxbkf collected $87.20 from pot
*** SUMMARY ***
Total pot $90 | Rake $2.80 
Board [6d 7s Kh 8c 8d]
Seat 1: ZarubaNT (small blind) showed [Jh Ah] and lost with a pair of Eights
Seat 2: HoldenUte03 (big blind) folded before Flop
Seat 3: QB0970016888 folded before Flop (didn't bet)
Seat 4: vjxbkf showed [9h 9s] and won ($87.20) with two pair, Nines and Eights
Seat 5: Blazterr folded before Flop (didn't bet)
Seat 6: d`svictoriae (button) folded before Flop (didn't bet)


PokerStars Game #102597488025:  Hold'em No Limit ($3/$6 USD) - 2013/08/11 5:37:39 ET
Table 'Lorcia IV 40-100 bb' 6-max Seat #1 is the button
Seat 1: ZarubaNT ($600 in chips) 
Seat 2: HoldenUte03 ($270.04 in chips) 
Seat 3: QB0970016888 ($313.10 in chips) 
Seat 4: vjxbkf ($645.20 in chips) 
Seat 5: Blazterr ($231 in chips) 
Seat 6: d`svictoriae ($465 in chips) 
HoldenUte03: posts small blind $3
QB0970016888: posts big blind $6
*** HOLE CARDS ***
vjxbkf: folds 
Blazterr: folds 
d`svictoriae: folds 
ZarubaNT: raises $6 to $12
HoldenUte03: folds 
QB0970016888: folds 
Uncalled bet ($6) returned to ZarubaNT
ZarubaNT collected $15 from pot
ZarubaNT: doesn't show hand 
*** SUMMARY ***
Total pot $15 | Rake $0 
Seat 1: ZarubaNT (button) collected ($15)
Seat 2: HoldenUte03 (small blind) folded before Flop
Seat 3: QB0970016888 (big blind) folded before Flop
Seat 4: vjxbkf folded before Flop (didn't bet)
Seat 5: Blazterr folded before Flop (didn't bet)
Seat 6: d`svictoriae folded before Flop (didn't bet)


PokerStars Game #102597504889:  Hold'em No Limit ($3/$6 USD) - 2013/08/11 5:38:21 ET
Table 'Lorcia IV 40-100 bb' 6-max Seat #2 is the button
Seat 1: ZarubaNT ($609 in chips) 
Seat 2: HoldenUte03 ($267.04 in chips) 
Seat 3: QB0970016888 ($307.10 in chips) 
Seat 4: vjxbkf ($645.20 in chips) 
Seat 5: Blazterr ($231 in chips) 
Seat 6: d`svictoriae ($465 in chips) 
QB0970016888: posts small blind $3
vjxbkf: posts big blind $6
*** HOLE CARDS ***
Blazterr: folds 
d`svictoriae: folds 
ZarubaNT: folds 
HoldenUte03: folds 
QB0970016888: folds 
Uncalled bet ($3) returned to vjxbkf
vjxbkf collected $6 from pot
vjxbkf: doesn't show hand 
*** SUMMARY ***
Total pot $6 | Rake $0 
Seat 1: ZarubaNT folded before Flop (didn't bet)
Seat 2: HoldenUte03 (button) folded before Flop (didn't bet)
Seat 3: QB0970016888 (small blind) folded before Flop
Seat 4: vjxbkf (big blind) collected ($6)
Seat 5: Blazterr folded before Flop (didn't bet)
Seat 6: d`svictoriae folded before Flop (didn't bet)


PokerStars Game #102597514182:  Hold'em No Limit ($3/$6 USD) - 2013/08/11 5:38:45 ET
Table 'Lorcia IV 40-100 bb' 6-max Seat #3 is the button
Seat 1: ZarubaNT ($609 in chips) 
Seat 2: HoldenUte03 ($267.04 in chips) 
Seat 3: QB0970016888 ($304.10 in chips) 
Seat 4: vjxbkf ($648.20 in chips) 
Seat 5: Blazterr ($231 in chips) 
Seat 6: d`svictoriae ($465 in chips) 
vjxbkf: posts small blind $3
Blazterr: posts big blind $6
*** HOLE CARDS ***
d`svictoriae: folds 
ZarubaNT: folds 
HoldenUte03: raises $6 to $12
QB0970016888: calls $12
vjxbkf: folds 
Blazterr: folds 
*** FLOP *** [3h Qs Ad]
HoldenUte03: bets $24
QB0970016888: calls $24
*** TURN *** [3h Qs Ad] [7s]
HoldenUte03: bets $231.04 and is all-in
QB0970016888: folds 
Uncalled bet ($231.04) returned to HoldenUte03
HoldenUte03 collected $78.20 from pot
*** SUMMARY ***
Total pot $81 | Rake $2.80 
Board [3h Qs Ad 7s]
Seat 1: ZarubaNT folded before Flop (didn't bet)
Seat 2: HoldenUte03 collected ($78.20)
Seat 3: QB0970016888 (button) folded on the Turn
Seat 4: vjxbkf (small blind) folded before Flop
Seat 5: Blazterr (big blind) folded before Flop
Seat 6: d`svictoriae folded before Flop (didn't bet)


PokerStars Game #102597321878:  Hold'em No Limit ($3/$6 USD) - 2013/08/11 5:30:42 ET
Table 'Lorcia IV 40-100 bb' 6-max Seat #3 is the button
Seat 1: ZarubaNT ($609 in chips) 
Seat 2: HoldenUte03 ($237 in chips) 
Seat 3: QB0970016888 ($267.90 in chips) 
Seat 4: vjxbkf ($631.50 in chips) 
Seat 5: Blazterr ($240 in chips) 
Seat 6: d`svictoriae ($480 in chips) 
vjxbkf: posts small blind $3
Blazterr: posts big blind $6
d`svictoriae: posts big blind $6
*** HOLE CARDS ***
d`svictoriae: checks 
ZarubaNT: folds 
HoldenUte03: calls $6
QB0970016888: folds 
vjxbkf: folds 
Blazterr: checks 
*** FLOP *** [Js 7d 2s]
Blazterr: checks 
d`svictoriae: checks 
HoldenUte03: checks 
*** TURN *** [Js 7d 2s] [Qs]
Blazterr: checks 
d`svictoriae: checks 
HoldenUte03: checks 
*** RIVER *** [Js 7d 2s Qs] [Kd]
Blazterr: checks 
d`svictoriae: checks 
HoldenUte03: checks 
*** SHOW DOWN ***
Blazterr: shows [Ad 6c] (high card Ace)
d`svictoriae: mucks hand 
HoldenUte03: shows [Qh 9d] (a pair of Queens)
HoldenUte03 collected $20.06 from pot
*** SUMMARY ***
Total pot $21 | Rake $0.94 
Board [Js 7d 2s Qs Kd]
Seat 1: ZarubaNT folded before Flop (didn't bet)
Seat 2: HoldenUte03 showed [Qh 9d] and won ($20.06) with a pair of Queens
Seat 3: QB0970016888 (button) folded before Flop (didn't bet)
Seat 4: vjxbkf (small blind) folded before Flop
Seat 5: Blazterr (big blind) showed [Ad 6c] and lost with high card Ace
Seat 6: d`svictoriae mucked


PokerStars Game #102597350454:  Hold'em No Limit ($3/$6 USD) - 2013/08/11 5:31:54 ET
Table 'Lorcia IV 40-100 bb' 6-max Seat #4 is the button
Seat 1: ZarubaNT ($609 in chips) 
Seat 2: HoldenUte03 ($251.06 in chips) 
Seat 3: QB0970016888 ($267.90 in chips) 
Seat 4: vjxbkf ($628.50 in chips) 
Seat 5: Blazterr ($234 in chips) 
Seat 6: d`svictoriae ($474 in chips) 
Blazterr: posts small blind $3
d`svictoriae: posts big blind $6
*** HOLE CARDS ***
ZarubaNT: folds 
HoldenUte03: calls $6
QB0970016888: folds 
vjxbkf: calls $6
Blazterr: folds 
d`svictoriae: checks 
*** FLOP *** [Jc 9d 3h]
d`svictoriae: checks 
HoldenUte03: checks 
vjxbkf: checks 
*** TURN *** [Jc 9d 3h] [Td]
d`svictoriae: checks 
HoldenUte03: bets $12
vjxbkf: calls $12
d`svictoriae: folds 
*** RIVER *** [Jc 9d 3h Td] [6c]
HoldenUte03: bets $24
vjxbkf: folds 
Uncalled bet ($24) returned to HoldenUte03
HoldenUte03 collected $42.98 from pot
*** SUMMARY ***
Total pot $45 | Rake $2.02 
Board [Jc 9d 3h Td 6c]
Seat 1: ZarubaNT folded before Flop (didn't bet)
Seat 2: HoldenUte03 collected ($42.98)
Seat 3: QB0970016888 folded before Flop (didn't bet)
Seat 4: vjxbkf (button) folded on the River
Seat 5: Blazterr (small blind) folded before Flop
Seat 6: d`svictoriae (big blind) folded on the Turn


PokerStars Game #102597387651:  Hold'em No Limit ($3/$6 USD) - 2013/08/11 5:33:29 ET
Table 'Lorcia IV 40-100 bb' 6-max Seat #5 is the button
Seat 1: ZarubaNT ($609 in chips) 
Seat 2: HoldenUte03 ($276.04 in chips) 
Seat 3: QB0970016888 ($267.90 in chips) 
Seat 4: vjxbkf ($610.50 in chips) 
Seat 5: Blazterr ($231 in chips) 
Seat 6: d`svictoriae ($468 in chips) 
d`svictoriae: posts small blind $3
ZarubaNT: posts big blind $6
*** HOLE CARDS ***
HoldenUte03: folds 
QB0970016888: raises $9 to $15
vjxbkf: calls $15
Blazterr: folds 
d`svictoriae: folds 
ZarubaNT: folds 
*** FLOP *** [8d Jc 7d]
QB0970016888: bets $24
vjxbkf: calls $24
*** TURN *** [8d Jc 7d] [6h]
QB0970016888: bets $45
vjxbkf: folds 
Uncalled bet ($45) returned to QB0970016888
QB0970016888 collected $84.20 from pot
QB0970016888: doesn't show hand 
*** SUMMARY ***
Total pot $87 | Rake $2.80 
Board [8d Jc 7d 6h]
Seat 1: ZarubaNT (big blind) folded before Flop
Seat 2: HoldenUte03 folded before Flop (didn't bet)
Seat 3: QB0970016888 collected ($84.20)
Seat 4: vjxbkf folded on the Turn
Seat 5: Blazterr (button) folded before Flop (didn't bet)
Seat 6: d`svictoriae (small blind) folded before Flop


PokerStars Game #102597796607:  Hold'em No Limit ($3/$6 USD) - 2013/08/11 5:50:21 ET
Table 'Lorcia IV 40-100 bb' 6-max Seat #2 is the button
Seat 1: ZarubaNT ($882.20 in chips) 
Seat 2: floriiiiider ($600 in chips) 
Seat 4: vjxbkf ($600 in chips) 
Seat 6: d`svictoriae ($139.92 in chips) 
khlaus will be allowed to play after the button
vjxbkf: posts small blind $3
Blazterr: is sitting out 
d`svictoriae: posts big blind $6
*** HOLE CARDS ***
ZarubaNT: raises $9 to $15
floriiiiider: folds 
Blazterr leaves the table
vjxbkf: folds 
d`svictoriae: folds 
Uncalled bet ($9) returned to ZarubaNT
ZarubaNT collected $15 from pot
ZarubaNT: doesn't show hand 
*** SUMMARY ***
Total pot $15 | Rake $0 
Seat 1: ZarubaNT collected ($15)
Seat 2: floriiiiider (button) folded before Flop (didn't bet)
Seat 4: vjxbkf (small blind) folded before Flop
Seat 6: d`svictoriae (big blind) folded before Flop


PokerStars Game #102597800648:  Hold'em No Limit ($3/$6 USD) - 2013/08/11 5:50:31 ET
Table 'Lorcia IV 40-100 bb' 6-max Seat #4 is the button
Seat 1: ZarubaNT ($891.20 in chips) 
Seat 2: floriiiiider ($600 in chips) 
Seat 4: vjxbkf ($600 in chips) 
Seat 6: d`svictoriae ($133.92 in chips) 
d`svictoriae: posts small blind $3
ZarubaNT: posts big blind $6
khlaus: sits out 
*** HOLE CARDS ***
floriiiiider: folds 
DuckinF0nk joins the table at seat #5 
vjxbkf: raises $6 to $12
d`svictoriae: calls $9
ZarubaNT: raises $42 to $54
vjxbkf: folds 
d`svictoriae: folds 
Uncalled bet ($42) returned to ZarubaNT
ZarubaNT collected $36 from pot
ZarubaNT: doesn't show hand 
*** SUMMARY ***
Total pot $36 | Rake $0 
Seat 1: ZarubaNT (big blind) collected ($36)
Seat 2: floriiiiider folded before Flop (didn't bet)
Seat 4: vjxbkf (button) folded before Flop
Seat 6: d`svictoriae (small blind) folded before Flop


PokerStars Game #102597819589:  Hold'em No Limit ($3/$6 USD) - 2013/08/11 5:51:18 ET
Table 'Lorcia IV 40-100 bb' 6-max Seat #6 is the button
Seat 1: ZarubaNT ($915.20 in chips) 
Seat 3: khlaus ($600 in chips) 
Seat 4: vjxbkf ($600 in chips) 
Seat 6: d`svictoriae ($121.92 in chips) 
ZarubaNT: posts small blind $3
floriiiiider: is sitting out 
khlaus: posts big blind $6
DuckinF0nk: sits out 
*** HOLE CARDS ***
vjxbkf: raises $9 to $15
floriiiiider leaves the table
d`svictoriae: folds 
ZarubaNT: folds 
khlaus: folds 
Uncalled bet ($9) returned to vjxbkf
vjxbkf collected $15 from pot
vjxbkf: doesn't show hand 
*** SUMMARY ***
Total pot $15 | Rake $0 
Seat 1: ZarubaNT (small blind) folded before Flop
Seat 3: khlaus (big blind) folded before Flop
Seat 4: vjxbkf collected ($15)
Seat 6: d`svictoriae (button) folded before Flop (didn't bet)


PokerStars Game #102597827272:  Hold'em No Limit ($3/$6 USD) - 2013/08/11 5:51:37 ET
Table 'Lorcia IV 40-100 bb' 6-max Seat #1 is the button
Seat 1: ZarubaNT ($912.20 in chips) 
Seat 3: khlaus ($600 in chips) 
Seat 4: vjxbkf ($609 in chips) 
Seat 6: d`svictoriae ($121.92 in chips) 
khlaus: posts small blind $3
vjxbkf: posts big blind $6
DuckinF0nk: sits out 
*** HOLE CARDS ***
d`svictoriae: folds 
maxxmeister joins the table at seat #2 
ZarubaNT: raises $6 to $12
khlaus: folds 
vjxbkf: raises $33 to $45
ZarubaNT: folds 
Uncalled bet ($33) returned to vjxbkf
vjxbkf collected $27 from pot
*** SUMMARY ***
Total pot $27 | Rake $0 
Seat 1: ZarubaNT (button) folded before Flop
Seat 3: khlaus (small blind) folded before Flop
Seat 4: vjxbkf (big blind) collected ($27)
Seat 6: d`svictoriae folded before Flop (didn't bet)


PokerStars Game #102597836384:  Hold'em No Limit ($3/$6 USD) - 2013/08/11 5:52:00 ET
Table 'Lorcia IV 40-100 bb' 6-max Seat #3 is the button
Seat 1: ZarubaNT ($900.20 in chips) 
Seat 3: khlaus ($600 in chips) 
Seat 4: vjxbkf ($624 in chips) 
Seat 5: DuckinF0nk ($600 in chips) 
Seat 6: d`svictoriae ($121.92 in chips) 
vjxbkf: posts small blind $3
DuckinF0nk: posts big blind $6
maxxmeister: sits out 
*** HOLE CARDS ***
d`svictoriae: folds 
ZarubaNT: folds 
khlaus: raises $6 to $12
vjxbkf: folds 
DuckinF0nk: folds 
Uncalled bet ($6) returned to khlaus
khlaus collected $15 from pot
khlaus: doesn't show hand 
*** SUMMARY ***
Total pot $15 | Rake $0 
Seat 1: ZarubaNT folded before Flop (didn't bet)
Seat 3: khlaus (button) collected ($15)
Seat 4: vjxbkf (small blind) folded before Flop
Seat 5: DuckinF0nk (big blind) folded before Flop
Seat 6: d`svictoriae folded before Flop (didn't bet)


PokerStars Game #102597844015:  Hold'em No Limit ($3/$6 USD) - 2013/08/11 5:52:20 ET
Table 'Lorcia IV 40-100 bb' 6-max Seat #4 is the button
Seat 1: ZarubaNT ($900.20 in chips) 
Seat 3: khlaus ($609 in chips) 
Seat 4: vjxbkf ($621 in chips) 
Seat 5: DuckinF0nk ($600 in chips) 
Seat 6: d`svictoriae ($121.92 in chips) 
DuckinF0nk: posts small blind $3
d`svictoriae: posts big blind $6
maxxmeister: is sitting out 
maxxmeister leaves the table
*** HOLE CARDS ***
ZarubaNT: folds 
khlaus: folds 
GERAKLmeat joins the table at seat #2 
vjxbkf: raises $6 to $12
DuckinF0nk: folds 
d`svictoriae: raises $109.92 to $121.92 and is all-in
vjxbkf: folds 
Uncalled bet ($109.92) returned to d`svictoriae
d`svictoriae collected $27 from pot
d`svictoriae: doesn't show hand 
*** SUMMARY ***
Total pot $27 | Rake $0 
Seat 1: ZarubaNT folded before Flop (didn't bet)
Seat 3: khlaus folded before Flop (didn't bet)
Seat 4: vjxbkf (button) folded before Flop
Seat 5: DuckinF0nk (small blind) folded before Flop
Seat 6: d`svictoriae (big blind) collected ($27)


PokerStars Game #102597853847:  Hold'em No Limit ($3/$6 USD) - 2013/08/11 5:52:44 ET
Table 'Lorcia IV 40-100 bb' 6-max Seat #5 is the button
Seat 1: ZarubaNT ($900.20 in chips) 
Seat 3: khlaus ($609 in chips) 
Seat 4: vjxbkf ($609 in chips) 
Seat 5: DuckinF0nk ($600 in chips) 
Seat 6: d`svictoriae ($136.92 in chips) 
d`svictoriae: posts small blind $3
ZarubaNT: posts big blind $6
GERAKLmeat: sits out 
*** HOLE CARDS ***
khlaus: folds 
vjxbkf: folds 
DuckinF0nk: raises $6 to $12
d`svictoriae: calls $9
ZarubaNT: calls $6
*** FLOP *** [Ks 7s 3c]
d`svictoriae: checks 
ZarubaNT: checks 
DuckinF0nk: bets $24
d`svictoriae: calls $24
ZarubaNT: folds 
*** TURN *** [Ks 7s 3c] [9s]
d`svictoriae: checks 
DuckinF0nk: bets $42
d`svictoriae: calls $42
*** RIVER *** [Ks 7s 3c 9s] [8h]
d`svictoriae: checks 
DuckinF0nk: bets $78
d`svictoriae: calls $58.92 and is all-in
Uncalled bet ($19.08) returned to DuckinF0nk
*** SHOW DOWN ***
DuckinF0nk: shows [8s 4s] (a flush, King high)
d`svictoriae: mucks hand 
DuckinF0nk collected $283.04 from pot
*** SUMMARY ***
Total pot $285.84 | Rake $2.80 
Board [Ks 7s 3c 9s 8h]
Seat 1: ZarubaNT (big blind) folded on the Flop
Seat 3: khlaus folded before Flop (didn't bet)
Seat 4: vjxbkf folded before Flop (didn't bet)
Seat 5: DuckinF0nk (button) showed [8s 4s] and won ($283.04) with a flush, King high
Seat 6: d`svictoriae (small blind) mucked


PokerStars Game #102597899801:  Hold'em No Limit ($3/$6 USD) - 2013/08/11 5:54:38 ET
Table 'Lorcia IV 40-100 bb' 6-max Seat #1 is the button
Seat 1: ZarubaNT ($888.20 in chips) 
Seat 3: khlaus ($609 in chips) 
Seat 4: vjxbkf ($609 in chips) 
Seat 5: DuckinF0nk ($746.12 in chips) 
GERAKLmeat will be allowed to play after the button
khlaus: posts small blind $3
vjxbkf: posts big blind $6
*** HOLE CARDS ***
DuckinF0nk: folds 
ZarubaNT: folds 
khlaus: raises $12 to $18
vjxbkf: calls $12
*** FLOP *** [5h Ad 2d]
khlaus: bets $24
vjxbkf: calls $24
*** TURN *** [5h Ad 2d] [5s]
khlaus: checks 
vjxbkf: checks 
*** RIVER *** [5h Ad 2d 5s] [Js]
khlaus: checks 
vjxbkf: checks 
*** SHOW DOWN ***
khlaus: shows [3h Ah] (two pair, Aces and Fives)
vjxbkf: mucks hand 
khlaus collected $82.50 from pot
*** SUMMARY ***
Total pot $84 | Rake $1.50 
Board [5h Ad 2d 5s Js]
Seat 1: ZarubaNT (button) folded before Flop (didn't bet)
Seat 3: khlaus (small blind) showed [3h Ah] and won ($82.50) with two pair, Aces and Fives
Seat 4: vjxbkf (big blind) mucked
Seat 5: DuckinF0nk folded before Flop (didn't bet)


PokerStars Game #102597701833:  Hold'em No Limit ($3/$6 USD) - 2013/08/11 5:46:27 ET
Table 'Lorcia IV 40-100 bb' 6-max Seat #4 is the button
Seat 1: ZarubaNT ($600 in chips) 
Seat 3: QB0970016888 ($635.80 in chips) 
Seat 4: vjxbkf ($600 in chips) 
Seat 5: Blazterr ($247.38 in chips) 
Seat 6: d`svictoriae ($405 in chips) 
Blazterr: posts small blind $3
d`svictoriae: posts big blind $6
floriiiiider: sits out 
*** HOLE CARDS ***
ZarubaNT: folds 
QB0970016888: folds 
vjxbkf: raises $6 to $12
Blazterr: folds 
d`svictoriae: folds 
Uncalled bet ($6) returned to vjxbkf
vjxbkf collected $15 from pot
vjxbkf: doesn't show hand 
*** SUMMARY ***
Total pot $15 | Rake $0 
Seat 1: ZarubaNT folded before Flop (didn't bet)
Seat 3: QB0970016888 folded before Flop (didn't bet)
Seat 4: vjxbkf (button) collected ($15)
Seat 5: Blazterr (small blind) folded before Flop
Seat 6: d`svictoriae (big blind) folded before Flop


PokerStars Game #102597710204:  Hold'em No Limit ($3/$6 USD) - 2013/08/11 5:46:47 ET
Table 'Lorcia IV 40-100 bb' 6-max Seat #5 is the button
Seat 1: ZarubaNT ($600 in chips) 
Seat 3: QB0970016888 ($635.80 in chips) 
Seat 4: vjxbkf ($609 in chips) 
Seat 5: Blazterr ($244.38 in chips) 
Seat 6: d`svictoriae ($399 in chips) 
d`svictoriae: posts small blind $3
ZarubaNT: posts big blind $6
floriiiiider: sits out 
*** HOLE CARDS ***
QB0970016888: folds 
vjxbkf: folds 
Blazterr: folds 
d`svictoriae: raises $6 to $12
ZarubaNT: calls $6
*** FLOP *** [Th 9h Qs]
d`svictoriae: bets $12
ZarubaNT: folds 
Uncalled bet ($12) returned to d`svictoriae
d`svictoriae collected $22.92 from pot
d`svictoriae: doesn't show hand 
*** SUMMARY ***
Total pot $24 | Rake $1.08 
Board [Th 9h Qs]
Seat 1: ZarubaNT (big blind) folded on the Flop
Seat 3: QB0970016888 folded before Flop (didn't bet)
Seat 4: vjxbkf folded before Flop (didn't bet)
Seat 5: Blazterr (button) folded before Flop (didn't bet)
Seat 6: d`svictoriae (small blind) collected ($22.92)


PokerStars Game #102597724732:  Hold'em No Limit ($3/$6 USD) - 2013/08/11 5:47:23 ET
Table 'Lorcia IV 40-100 bb' 6-max Seat #6 is the button
Seat 1: ZarubaNT ($600 in chips) 
Seat 2: floriiiiider ($600 in chips) 
Seat 3: QB0970016888 ($635.80 in chips) 
Seat 4: vjxbkf ($609 in chips) 
Seat 5: Blazterr ($244.38 in chips) 
Seat 6: d`svictoriae ($409.92 in chips) 
ZarubaNT: posts small blind $3
floriiiiider: posts big blind $6
*** HOLE CARDS ***
QB0970016888: raises $9 to $15
vjxbkf: folds 
Blazterr: folds 
d`svictoriae: folds 
ZarubaNT: folds 
floriiiiider: calls $9
*** FLOP *** [Jd Qd 9d]
floriiiiider: checks 
QB0970016888: bets $15
floriiiiider: folds 
Uncalled bet ($15) returned to QB0970016888
QB0970016888 collected $31.52 from pot
*** SUMMARY ***
Total pot $33 | Rake $1.48 
Board [Jd Qd 9d]
Seat 1: ZarubaNT (small blind) folded before Flop
Seat 2: floriiiiider (big blind) folded on the Flop
Seat 3: QB0970016888 collected ($31.52)
Seat 4: vjxbkf folded before Flop (didn't bet)
Seat 5: Blazterr folded before Flop (didn't bet)
Seat 6: d`svictoriae (button) folded before Flop (didn't bet)


PokerStars Game #102597746254:  Hold'em No Limit ($3/$6 USD) - 2013/08/11 5:48:16 ET
Table 'Lorcia IV 40-100 bb' 6-max Seat #1 is the button
Seat 1: ZarubaNT ($600 in chips) 
Seat 2: floriiiiider ($600 in chips) 
Seat 4: vjxbkf ($609 in chips) 
Seat 5: Blazterr ($244.38 in chips) 
Seat 6: d`svictoriae ($409.92 in chips) 
floriiiiider: posts small blind $3
QB0970016888: is sitting out 
vjxbkf: posts big blind $6
*** HOLE CARDS ***
Blazterr: folds 
d`svictoriae: raises $6 to $12
QB0970016888 leaves the table
ZarubaNT: calls $12
floriiiiider: folds 
khlaus joins the table at seat #3 
vjxbkf: calls $6
*** FLOP *** [8d Qc 4c]
vjxbkf: checks 
d`svictoriae: bets $18
ZarubaNT: raises $36 to $54
vjxbkf: folds 
d`svictoriae: calls $36
*** TURN *** [8d Qc 4c] [3h]
d`svictoriae: checks 
ZarubaNT: bets $90
d`svictoriae: calls $90
*** RIVER *** [8d Qc 4c 3h] [Ad]
d`svictoriae: bets $114
ZarubaNT: calls $114
*** SHOW DOWN ***
d`svictoriae: shows [6c Kc] (high card Ace)
ZarubaNT: shows [8s 8c] (three of a kind, Eights)
ZarubaNT collected $552.20 from pot
*** SUMMARY ***
Total pot $555 | Rake $2.80 
Board [8d Qc 4c 3h Ad]
Seat 1: ZarubaNT (button) showed [8s 8c] and won ($552.20) with three of a kind, Eights
Seat 2: floriiiiider (small blind) folded before Flop
Seat 4: vjxbkf (big blind) folded on the Flop
Seat 5: Blazterr folded before Flop (didn't bet)
Seat 6: d`svictoriae showed [6c Kc] and lost with high card Ace


PokerStars Game #102598252835:  Hold'em No Limit ($3/$6 USD) - 2013/08/11 6:10:00 ET
Table 'Lorcia IV 40-100 bb' 6-max Seat #2 is the button
Seat 1: ZarubaNT ($1067.32 in chips) 
Seat 2: GERAKLmeat ($240 in chips) 
Seat 3: khlaus ($603 in chips) 
Seat 4: vjxbkf ($621 in chips) 
Seat 5: DuckinF0nk ($938.32 in chips) 
Seat 6: d`svictoriae ($508.44 in chips) 
khlaus: posts small blind $3
vjxbkf: posts big blind $6
*** HOLE CARDS ***
DuckinF0nk: folds 
d`svictoriae: folds 
ZarubaNT: raises $9 to $15
GERAKLmeat: folds 
khlaus: folds 
vjxbkf: folds 
Uncalled bet ($9) returned to ZarubaNT
ZarubaNT collected $15 from pot
ZarubaNT: doesn't show hand 
*** SUMMARY ***
Total pot $15 | Rake $0 
Seat 1: ZarubaNT collected ($15)
Seat 2: GERAKLmeat (button) folded before Flop (didn't bet)
Seat 3: khlaus (small blind) folded before Flop
Seat 4: vjxbkf (big blind) folded before Flop
Seat 5: DuckinF0nk folded before Flop (didn't bet)
Seat 6: d`svictoriae folded before Flop (didn't bet)


PokerStars Game #102598259242:  Hold'em No Limit ($3/$6 USD) - 2013/08/11 6:10:15 ET
Table 'Lorcia IV 40-100 bb' 6-max Seat #3 is the button
Seat 1: ZarubaNT ($1076.32 in chips) 
Seat 2: GERAKLmeat ($240 in chips) 
Seat 3: khlaus ($600 in chips) 
Seat 4: vjxbkf ($615 in chips) 
Seat 5: DuckinF0nk ($938.32 in chips) 
Seat 6: d`svictoriae ($508.44 in chips) 
vjxbkf: posts small blind $3
DuckinF0nk: posts big blind $6
*** HOLE CARDS ***
d`svictoriae: folds 
ZarubaNT: folds 
GERAKLmeat: raises $6 to $12
khlaus: folds 
vjxbkf: folds 
DuckinF0nk: calls $6
*** FLOP *** [7d Ad Ks]
DuckinF0nk: checks 
GERAKLmeat: bets $13.14
DuckinF0nk: folds 
Uncalled bet ($13.14) returned to GERAKLmeat
GERAKLmeat collected $25.78 from pot
GERAKLmeat: doesn't show hand 
*** SUMMARY ***
Total pot $27 | Rake $1.22 
Board [7d Ad Ks]
Seat 1: ZarubaNT folded before Flop (didn't bet)
Seat 2: GERAKLmeat collected ($25.78)
Seat 3: khlaus (button) folded before Flop (didn't bet)
Seat 4: vjxbkf (small blind) folded before Flop
Seat 5: DuckinF0nk (big blind) folded on the Flop
Seat 6: d`svictoriae folded before Flop (didn't bet)


PokerStars Game #102598276092:  Hold'em No Limit ($3/$6 USD) - 2013/08/11 6:10:55 ET
Table 'Lorcia IV 40-100 bb' 6-max Seat #4 is the button
Seat 1: ZarubaNT ($1076.32 in chips) 
Seat 2: GERAKLmeat ($253.78 in chips) 
Seat 3: khlaus ($600 in chips) 
Seat 4: vjxbkf ($612 in chips) 
Seat 5: DuckinF0nk ($926.32 in chips) 
Seat 6: d`svictoriae ($508.44 in chips) 
DuckinF0nk: posts small blind $3
d`svictoriae: posts big blind $6
*** HOLE CARDS ***
ZarubaNT: raises $12 to $18
GERAKLmeat: folds 
khlaus: folds 
vjxbkf: folds 
DuckinF0nk: calls $15
d`svictoriae: folds 
*** FLOP *** [Js 4d Jd]
DuckinF0nk: checks 
ZarubaNT: bets $27
DuckinF0nk: calls $27
*** TURN *** [Js 4d Jd] [8d]
DuckinF0nk: checks 
ZarubaNT: bets $69
DuckinF0nk: folds 
Uncalled bet ($69) returned to ZarubaNT
ZarubaNT collected $93.20 from pot
ZarubaNT: doesn't show hand 
*** SUMMARY ***
Total pot $96 | Rake $2.80 
Board [Js 4d Jd 8d]
Seat 1: ZarubaNT collected ($93.20)
Seat 2: GERAKLmeat folded before Flop (didn't bet)
Seat 3: khlaus folded before Flop (didn't bet)
Seat 4: vjxbkf (button) folded before Flop (didn't bet)
Seat 5: DuckinF0nk (small blind) folded on the Turn
Seat 6: d`svictoriae (big blind) folded before Flop


PokerStars Game #102598306695:  Hold'em No Limit ($3/$6 USD) - 2013/08/11 6:12:07 ET
Table 'Lorcia IV 40-100 bb' 6-max Seat #5 is the button
Seat 1: ZarubaNT ($1124.52 in chips) 
Seat 2: GERAKLmeat ($253.78 in chips) 
Seat 3: khlaus ($600 in chips) 
Seat 4: vjxbkf ($612 in chips) 
Seat 5: DuckinF0nk ($881.32 in chips) 
Seat 6: d`svictoriae ($502.44 in chips) 
d`svictoriae: posts small blind $3
ZarubaNT: posts big blind $6
*** HOLE CARDS ***
GERAKLmeat: folds 
khlaus: folds 
vjxbkf: folds 
DuckinF0nk: folds 
d`svictoriae: folds 
Uncalled bet ($3) returned to ZarubaNT
ZarubaNT collected $6 from pot
ZarubaNT: doesn't show hand 
*** SUMMARY ***
Total pot $6 | Rake $0 
Seat 1: ZarubaNT (big blind) collected ($6)
Seat 2: GERAKLmeat folded before Flop (didn't bet)
Seat 3: khlaus folded before Flop (didn't bet)
Seat 4: vjxbkf folded before Flop (didn't bet)
Seat 5: DuckinF0nk (button) folded before Flop (didn't bet)
Seat 6: d`svictoriae (small blind) folded before Flop


PokerStars Game #102598313348:  Hold'em No Limit ($3/$6 USD) - 2013/08/11 6:12:22 ET
Table 'Lorcia IV 40-100 bb' 6-max Seat #6 is the button
Seat 1: ZarubaNT ($1127.52 in chips) 
Seat 2: GERAKLmeat ($253.78 in chips) 
Seat 3: khlaus ($600 in chips) 
Seat 4: vjxbkf ($612 in chips) 
Seat 5: DuckinF0nk ($881.32 in chips) 
Seat 6: d`svictoriae ($499.44 in chips) 
ZarubaNT: posts small blind $3
GERAKLmeat: posts big blind $6
*** HOLE CARDS ***
khlaus: folds 
vjxbkf: folds 
DuckinF0nk: raises $12 to $18
d`svictoriae: calls $18
ZarubaNT: folds 
GERAKLmeat: folds 
*** FLOP *** [4s 8h 4h]
DuckinF0nk: bets $33
d`svictoriae: raises $33 to $66
DuckinF0nk: folds 
Uncalled bet ($33) returned to d`svictoriae
d`svictoriae collected $108.20 from pot
d`svictoriae: doesn't show hand 
*** SUMMARY ***
Total pot $111 | Rake $2.80 
Board [4s 8h 4h]
Seat 1: ZarubaNT (small blind) folded before Flop
Seat 2: GERAKLmeat (big blind) folded before Flop
Seat 3: khlaus folded before Flop (didn't bet)
Seat 4: vjxbkf folded before Flop (didn't bet)
Seat 5: DuckinF0nk folded on the Flop
Seat 6: d`svictoriae (button) collected ($108.20)


PokerStars Game #102598330821:  Hold'em No Limit ($3/$6 USD) - 2013/08/11 6:13:04 ET
Table 'Lorcia IV 40-100 bb' 6-max Seat #1 is the button
Seat 1: ZarubaNT ($1124.52 in chips) 
Seat 2: GERAKLmeat ($247.78 in chips) 
Seat 3: khlaus ($600 in chips) 
Seat 4: vjxbkf ($612 in chips) 
Seat 5: DuckinF0nk ($830.32 in chips) 
Seat 6: d`svictoriae ($556.64 in chips) 
GERAKLmeat: posts small blind $3
khlaus: posts big blind $6
*** HOLE CARDS ***
vjxbkf: folds 
DuckinF0nk: folds 
d`svictoriae: folds 
ZarubaNT: raises $6 to $12
GERAKLmeat: folds 
khlaus: folds 
Uncalled bet ($6) returned to ZarubaNT
ZarubaNT collected $15 from pot
ZarubaNT: doesn't show hand 
*** SUMMARY ***
Total pot $15 | Rake $0 
Seat 1: ZarubaNT (button) collected ($15)
Seat 2: GERAKLmeat (small blind) folded before Flop
Seat 3: khlaus (big blind) folded before Flop
Seat 4: vjxbkf folded before Flop (didn't bet)
Seat 5: DuckinF0nk folded before Flop (didn't bet)
Seat 6: d`svictoriae folded before Flop (didn't bet)


PokerStars Game #102598341853:  Hold'em No Limit ($3/$6 USD) - 2013/08/11 6:13:30 ET
Table 'Lorcia IV 40-100 bb' 6-max Seat #2 is the button
Seat 1: ZarubaNT ($1133.52 in chips) 
Seat 2: GERAKLmeat ($244.78 in chips) 
Seat 3: khlaus ($600 in chips) 
Seat 4: vjxbkf ($612 in chips) 
Seat 5: DuckinF0nk ($830.32 in chips) 
Seat 6: d`svictoriae ($556.64 in chips) 
khlaus: posts small blind $3
vjxbkf: posts big blind $6
*** HOLE CARDS ***
DuckinF0nk: folds 
d`svictoriae: raises $6 to $12
ZarubaNT: folds 
GERAKLmeat: folds 
khlaus: folds 
vjxbkf: folds 
Uncalled bet ($6) returned to d`svictoriae
d`svictoriae collected $15 from pot
d`svictoriae: doesn't show hand 
*** SUMMARY ***
Total pot $15 | Rake $0 
Seat 1: ZarubaNT folded before Flop (didn't bet)
Seat 2: GERAKLmeat (button) folded before Flop (didn't bet)
Seat 3: khlaus (small blind) folded before Flop
Seat 4: vjxbkf (big blind) folded before Flop
Seat 5: DuckinF0nk folded before Flop (didn't bet)
Seat 6: d`svictoriae collected ($15)


PokerStars Game #102598357057:  Hold'em No Limit ($3/$6 USD) - 2013/08/11 6:14:06 ET
Table 'Lorcia IV 40-100 bb' 6-max Seat #3 is the button
Seat 1: ZarubaNT ($1133.52 in chips) 
Seat 2: GERAKLmeat ($244.78 in chips) 
Seat 3: khlaus ($600 in chips) 
Seat 4: vjxbkf ($606 in chips) 
Seat 5: DuckinF0nk ($830.32 in chips) 
Seat 6: d`svictoriae ($565.64 in chips) 
vjxbkf: posts small blind $3
DuckinF0nk: posts big blind $6
*** HOLE CARDS ***
d`svictoriae: folds 
ZarubaNT: folds 
GERAKLmeat: folds 
khlaus: folds 
vjxbkf: raises $18 to $24
DuckinF0nk: folds 
Uncalled bet ($18) returned to vjxbkf
vjxbkf collected $12 from pot
vjxbkf: doesn't show hand 
*** SUMMARY ***
Total pot $12 | Rake $0 
Seat 1: ZarubaNT folded before Flop (didn't bet)
Seat 2: GERAKLmeat folded before Flop (didn't bet)
Seat 3: khlaus (button) folded before Flop (didn't bet)
Seat 4: vjxbkf (small blind) collected ($12)
Seat 5: DuckinF0nk (big blind) folded before Flop
Seat 6: d`svictoriae folded before Flop (didn't bet)


PokerStars Game #102598369304:  Hold'em No Limit ($3/$6 USD) - 2013/08/11 6:14:35 ET
Table 'Lorcia IV 40-100 bb' 6-max Seat #4 is the button
Seat 1: ZarubaNT ($1133.52 in chips) 
Seat 2: GERAKLmeat ($244.78 in chips) 
Seat 3: khlaus ($600 in chips) 
Seat 4: vjxbkf ($612 in chips) 
Seat 5: DuckinF0nk ($824.32 in chips) 
Seat 6: d`svictoriae ($565.64 in chips) 
DuckinF0nk: posts small blind $3
d`svictoriae: posts big blind $6
*** HOLE CARDS ***
ZarubaNT: folds 
GERAKLmeat: folds 
khlaus: raises $12 to $18
vjxbkf: folds 
DuckinF0nk: folds 
d`svictoriae: folds 
Uncalled bet ($12) returned to khlaus
khlaus collected $15 from pot
khlaus: doesn't show hand 
*** SUMMARY ***
Total pot $15 | Rake $0 
Seat 1: ZarubaNT folded before Flop (didn't bet)
Seat 2: GERAKLmeat folded before Flop (didn't bet)
Seat 3: khlaus collected ($15)
Seat 4: vjxbkf (button) folded before Flop (didn't bet)
Seat 5: DuckinF0nk (small blind) folded before Flop
Seat 6: d`svictoriae (big blind) folded before Flop


PokerStars Game #102598376265:  Hold'em No Limit ($3/$6 USD) - 2013/08/11 6:14:51 ET
Table 'Lorcia IV 40-100 bb' 6-max Seat #5 is the button
Seat 1: ZarubaNT ($1133.52 in chips) 
Seat 2: GERAKLmeat ($244.78 in chips) 
Seat 3: khlaus ($609 in chips) 
Seat 4: vjxbkf ($612 in chips) 
Seat 5: DuckinF0nk ($821.32 in chips) 
Seat 6: d`svictoriae ($559.64 in chips) 
d`svictoriae: posts small blind $3
ZarubaNT: posts big blind $6
*** HOLE CARDS ***
GERAKLmeat: folds 
khlaus: folds 
vjxbkf: folds 
DuckinF0nk: folds 
d`svictoriae: raises $6 to $12
ZarubaNT: calls $6
*** FLOP *** [4d Jc 7s]
d`svictoriae: checks 
ZarubaNT: bets $15
d`svictoriae: calls $15
*** TURN *** [4d Jc 7s] [3d]
d`svictoriae: checks 
ZarubaNT: bets $39
d`svictoriae: folds 
Uncalled bet ($39) returned to ZarubaNT
ZarubaNT collected $51.57 from pot
ZarubaNT: doesn't show hand 
*** SUMMARY ***
Total pot $54 | Rake $2.43 
Board [4d Jc 7s 3d]
Seat 1: ZarubaNT (big blind) collected ($51.57)
Seat 2: GERAKLmeat folded before Flop (didn't bet)
Seat 3: khlaus folded before Flop (didn't bet)
Seat 4: vjxbkf folded before Flop (didn't bet)
Seat 5: DuckinF0nk (button) folded before Flop (didn't bet)
Seat 6: d`svictoriae (small blind) folded on the Turn


PokerStars Game #102598129547:  Hold'em No Limit ($3/$6 USD) - 2013/08/11 6:05:11 ET
Table 'Lorcia IV 40-100 bb' 6-max Seat #6 is the button
Seat 2: GERAKLmeat ($240 in chips) 
Seat 3: khlaus ($634.50 in chips) 
Seat 4: vjxbkf ($609 in chips) 
Seat 5: DuckinF0nk ($743.12 in chips) 
Seat 6: d`svictoriae ($481.44 in chips) 
GERAKLmeat: posts small blind $3
khlaus: posts big blind $6
*** HOLE CARDS ***
vjxbkf: folds 
DuckinF0nk: folds 
d`svictoriae: raises $6 to $12
GERAKLmeat: raises $18 to $30
khlaus: folds 
d`svictoriae: raises $78 to $108
GERAKLmeat: folds 
Uncalled bet ($78) returned to d`svictoriae
d`svictoriae collected $66 from pot
d`svictoriae: doesn't show hand 
*** SUMMARY ***
Total pot $66 | Rake $0 
Seat 2: GERAKLmeat (small blind) folded before Flop
Seat 3: khlaus (big blind) folded before Flop
Seat 4: vjxbkf folded before Flop (didn't bet)
Seat 5: DuckinF0nk folded before Flop (didn't bet)
Seat 6: d`svictoriae (button) collected ($66)


PokerStars Game #102598140445:  Hold'em No Limit ($3/$6 USD) - 2013/08/11 6:05:37 ET
Table 'Lorcia IV 40-100 bb' 6-max Seat #2 is the button
Seat 2: GERAKLmeat ($240 in chips) 
Seat 3: khlaus ($628.50 in chips) 
Seat 4: vjxbkf ($609 in chips) 
Seat 5: DuckinF0nk ($743.12 in chips) 
Seat 6: d`svictoriae ($517.44 in chips) 
khlaus: posts small blind $3
vjxbkf: posts big blind $6
ZarubaNT: sits out 
*** HOLE CARDS ***
DuckinF0nk: folds 
d`svictoriae: folds 
GERAKLmeat: raises $6 to $12
khlaus: folds 
vjxbkf: folds 
Uncalled bet ($6) returned to GERAKLmeat
GERAKLmeat collected $15 from pot
GERAKLmeat: doesn't show hand 
*** SUMMARY ***
Total pot $15 | Rake $0 
Seat 2: GERAKLmeat (button) collected ($15)
Seat 3: khlaus (small blind) folded before Flop
Seat 4: vjxbkf (big blind) folded before Flop
Seat 5: DuckinF0nk folded before Flop (didn't bet)
Seat 6: d`svictoriae folded before Flop (didn't bet)


PokerStars Game #102598148981:  Hold'em No Limit ($3/$6 USD) - 2013/08/11 6:05:56 ET
Table 'Lorcia IV 40-100 bb' 6-max Seat #3 is the button
Seat 2: GERAKLmeat ($249 in chips) 
Seat 3: khlaus ($625.50 in chips) 
Seat 4: vjxbkf ($603 in chips) 
Seat 5: DuckinF0nk ($743.12 in chips) 
Seat 6: d`svictoriae ($517.44 in chips) 
vjxbkf: posts small blind $3
DuckinF0nk: posts big blind $6
ZarubaNT: sits out 
*** HOLE CARDS ***
d`svictoriae: folds 
GERAKLmeat: raises $6 to $12
khlaus: folds 
vjxbkf: raises $21 to $33
DuckinF0nk: folds 
GERAKLmeat: folds 
Uncalled bet ($21) returned to vjxbkf
vjxbkf collected $30 from pot
vjxbkf: doesn't show hand 
*** SUMMARY ***
Total pot $30 | Rake $0 
Seat 2: GERAKLmeat folded before Flop
Seat 3: khlaus (button) folded before Flop (didn't bet)
Seat 4: vjxbkf (small blind) collected ($30)
Seat 5: DuckinF0nk (big blind) folded before Flop
Seat 6: d`svictoriae folded before Flop (didn't bet)


PokerStars Game #102598167695:  Hold'em No Limit ($3/$6 USD) - 2013/08/11 6:06:40 ET
Table 'Lorcia IV 40-100 bb' 6-max Seat #4 is the button
Seat 2: GERAKLmeat ($240 in chips) 
Seat 3: khlaus ($625.50 in chips) 
Seat 4: vjxbkf ($621 in chips) 
Seat 5: DuckinF0nk ($737.12 in chips) 
Seat 6: d`svictoriae ($517.44 in chips) 
DuckinF0nk: posts small blind $3
d`svictoriae: posts big blind $6
ZarubaNT: sits out 
*** HOLE CARDS ***
GERAKLmeat: folds 
khlaus: raises $12 to $18
vjxbkf: folds 
DuckinF0nk: calls $15
d`svictoriae: folds 
*** FLOP *** [Th Qd 9s]
DuckinF0nk: bets $30
khlaus: calls $30
*** TURN *** [Th Qd 9s] [9h]
DuckinF0nk: checks 
khlaus: checks 
*** RIVER *** [Th Qd 9s 9h] [3c]
DuckinF0nk: bets $132
khlaus: calls $132
*** SHOW DOWN ***
DuckinF0nk: shows [Jc Kd] (a straight, Nine to King)
khlaus: mucks hand 
DuckinF0nk collected $363.20 from pot
*** SUMMARY ***
Total pot $366 | Rake $2.80 
Board [Th Qd 9s 9h 3c]
Seat 2: GERAKLmeat folded before Flop (didn't bet)
Seat 3: khlaus mucked
Seat 4: vjxbkf (button) folded before Flop (didn't bet)
Seat 5: DuckinF0nk (small blind) showed [Jc Kd] and won ($363.20) with a straight, Nine to King
Seat 6: d`svictoriae (big blind) folded before Flop


PokerStars Game #102598221454:  Hold'em No Limit ($3/$6 USD) - 2013/08/11 6:08:47 ET
Table 'Lorcia IV 40-100 bb' 6-max Seat #5 is the button
Seat 1: ZarubaNT ($1076.32 in chips) 
Seat 2: GERAKLmeat ($240 in chips) 
Seat 3: khlaus ($600 in chips) 
Seat 4: vjxbkf ($621 in chips) 
Seat 5: DuckinF0nk ($920.32 in chips) 
Seat 6: d`svictoriae ($511.44 in chips) 
d`svictoriae: posts small blind $3
ZarubaNT: posts big blind $6
*** HOLE CARDS ***
GERAKLmeat: folds 
khlaus: folds 
vjxbkf: folds 
DuckinF0nk: raises $9 to $15
d`svictoriae: folds 
ZarubaNT: folds 
Uncalled bet ($9) returned to DuckinF0nk
DuckinF0nk collected $15 from pot
DuckinF0nk: doesn't show hand 
*** SUMMARY ***
Total pot $15 | Rake $0 
Seat 1: ZarubaNT (big blind) folded before Flop
Seat 2: GERAKLmeat folded before Flop (didn't bet)
Seat 3: khlaus folded before Flop (didn't bet)
Seat 4: vjxbkf folded before Flop (didn't bet)
Seat 5: DuckinF0nk (button) collected ($15)
Seat 6: d`svictoriae (small blind) folded before Flop


PokerStars Game #102598238347:  Hold'em No Limit ($3/$6 USD) - 2013/08/11 6:09:26 ET
Table 'Lorcia IV 40-100 bb' 6-max Seat #6 is the button
Seat 1: ZarubaNT ($1070.32 in chips) 
Seat 2: GERAKLmeat ($240 in chips) 
Seat 3: khlaus ($600 in chips) 
Seat 4: vjxbkf ($621 in chips) 
Seat 5: DuckinF0nk ($929.32 in chips) 
Seat 6: d`svictoriae ($508.44 in chips) 
ZarubaNT: posts small blind $3
GERAKLmeat: posts big blind $6
*** HOLE CARDS ***
khlaus: raises $12 to $18
vjxbkf: folds 
DuckinF0nk: folds 
d`svictoriae: folds 
ZarubaNT: folds 
GERAKLmeat: folds 
Uncalled bet ($12) returned to khlaus
khlaus collected $15 from pot
khlaus: doesn't show hand 
*** SUMMARY ***
Total pot $15 | Rake $0 
Seat 1: ZarubaNT (small blind) folded before Flop
Seat 2: GERAKLmeat (big blind) folded before Flop
Seat 3: khlaus collected ($15)
Seat 4: vjxbkf folded before Flop (didn't bet)
Seat 5: DuckinF0nk folded before Flop (didn't bet)
Seat 6: d`svictoriae (button) folded before Flop (didn't bet)


PokerStars Game #102598246531:  Hold'em No Limit ($3/$6 USD) - 2013/08/11 6:09:46 ET
Table 'Lorcia IV 40-100 bb' 6-max Seat #1 is the button
Seat 1: ZarubaNT ($1067.32 in chips) 
Seat 2: GERAKLmeat ($240 in chips) 
Seat 3: khlaus ($609 in chips) 
Seat 4: vjxbkf ($621 in chips) 
Seat 5: DuckinF0nk ($929.32 in chips) 
Seat 6: d`svictoriae ($508.44 in chips) 
GERAKLmeat: posts small blind $3
khlaus: posts big blind $6
*** HOLE CARDS ***
vjxbkf: folds 
DuckinF0nk: raises $12 to $18
d`svictoriae: folds 
ZarubaNT: folds 
GERAKLmeat: folds 
khlaus: folds 
Uncalled bet ($12) returned to DuckinF0nk
DuckinF0nk collected $15 from pot
DuckinF0nk: doesn't show hand 
*** SUMMARY ***
Total pot $15 | Rake $0 
Seat 1: ZarubaNT (button) folded before Flop (didn't bet)
Seat 2: GERAKLmeat (small blind) folded before Flop
Seat 3: khlaus (big blind) folded before Flop
Seat 4: vjxbkf folded before Flop (didn't bet)
Seat 5: DuckinF0nk collected ($15)
Seat 6: d`svictoriae folded before Flop (didn't bet)


PokerStars Game #102597937188:  Hold'em No Limit ($3/$6 USD) - 2013/08/11 5:56:25 ET
Table 'Lorcia IV 40-100 bb' 6-max Seat #3 is the button
Seat 1: ZarubaNT ($888.20 in chips) 
Seat 3: khlaus ($649.50 in chips) 
Seat 4: vjxbkf ($600 in chips) 
Seat 5: DuckinF0nk ($746.12 in chips) 
Seat 6: d`svictoriae ($600 in chips) 
vjxbkf: posts small blind $3
DuckinF0nk: posts big blind $6
GERAKLmeat: sits out 
*** HOLE CARDS ***
d`svictoriae: folds 
ZarubaNT: raises $9 to $15
khlaus: folds 
vjxbkf: folds 
DuckinF0nk: folds 
Uncalled bet ($9) returned to ZarubaNT
ZarubaNT collected $15 from pot
ZarubaNT: doesn't show hand 
*** SUMMARY ***
Total pot $15 | Rake $0 
Seat 1: ZarubaNT collected ($15)
Seat 3: khlaus (button) folded before Flop (didn't bet)
Seat 4: vjxbkf (small blind) folded before Flop
Seat 5: DuckinF0nk (big blind) folded before Flop
Seat 6: d`svictoriae folded before Flop (didn't bet)


PokerStars Game #102597943775:  Hold'em No Limit ($3/$6 USD) - 2013/08/11 5:56:46 ET
Table 'Lorcia IV 40-100 bb' 6-max Seat #4 is the button
Seat 1: ZarubaNT ($897.20 in chips) 
Seat 3: khlaus ($649.50 in chips) 
Seat 4: vjxbkf ($600 in chips) 
Seat 5: DuckinF0nk ($740.12 in chips) 
Seat 6: d`svictoriae ($600 in chips) 
DuckinF0nk: posts small blind $3
d`svictoriae: posts big blind $6
GERAKLmeat: sits out 
*** HOLE CARDS ***
ZarubaNT: raises $12 to $18
khlaus: folds 
vjxbkf: folds 
DuckinF0nk: folds 
d`svictoriae: calls $12
*** FLOP *** [3d 4c 7c]
d`svictoriae: bets $18
ZarubaNT: calls $18
*** TURN *** [3d 4c 7c] [2d]
d`svictoriae: checks 
ZarubaNT: bets $54
d`svictoriae: calls $54
*** RIVER *** [3d 4c 7c 2d] [Tc]
d`svictoriae: bets $90
ZarubaNT: calls $90
*** SHOW DOWN ***
d`svictoriae: shows [Ah 6h] (high card Ace)
ZarubaNT: shows [Kc Ks] (a pair of Kings)
ZarubaNT collected $360.20 from pot
*** SUMMARY ***
Total pot $363 | Rake $2.80 
Board [3d 4c 7c 2d Tc]
Seat 1: ZarubaNT showed [Kc Ks] and won ($360.20) with a pair of Kings
Seat 3: khlaus folded before Flop (didn't bet)
Seat 4: vjxbkf (button) folded before Flop (didn't bet)
Seat 5: DuckinF0nk (small blind) folded before Flop
Seat 6: d`svictoriae (big blind) showed [Ah 6h] and lost with high card Ace


PokerStars Game #102597960716:  Hold'em No Limit ($3/$6 USD) - 2013/08/11 5:57:39 ET
Table 'Lorcia IV 40-100 bb' 6-max Seat #5 is the button
Seat 1: ZarubaNT ($1077.40 in chips) 
Seat 3: khlaus ($649.50 in chips) 
Seat 4: vjxbkf ($600 in chips) 
Seat 5: DuckinF0nk ($737.12 in chips) 
Seat 6: d`svictoriae ($420 in chips) 
d`svictoriae: posts small blind $3
ZarubaNT: posts big blind $6
GERAKLmeat: sits out 
*** HOLE CARDS ***
khlaus: folds 
vjxbkf: folds 
DuckinF0nk: folds 
d`svictoriae: raises $6 to $12
ZarubaNT: calls $6
*** FLOP *** [9c Ks 4d]
d`svictoriae: checks 
ZarubaNT: checks 
*** TURN *** [9c Ks 4d] [9h]
d`svictoriae: checks 
ZarubaNT: checks 
*** RIVER *** [9c Ks 4d 9h] [4h]
d`svictoriae: checks 
ZarubaNT: checks 
*** SHOW DOWN ***
d`svictoriae: shows [2c 6s] (two pair, Nines and Fours)
ZarubaNT: shows [Th Ah] (two pair, Nines and Fours - Ace kicker)
ZarubaNT collected $22.92 from pot
*** SUMMARY ***
Total pot $24 | Rake $1.08 
Board [9c Ks 4d 9h 4h]
Seat 1: ZarubaNT (big blind) showed [Th Ah] and won ($22.92) with two pair, Nines and Fours
Seat 3: khlaus folded before Flop (didn't bet)
Seat 4: vjxbkf folded before Flop (didn't bet)
Seat 5: DuckinF0nk (button) folded before Flop (didn't bet)
Seat 6: d`svictoriae (small blind) showed [2c 6s] and lost with two pair, Nines and Fours


PokerStars Game #102597973380:  Hold'em No Limit ($3/$6 USD) - 2013/08/11 5:58:19 ET
Table 'Lorcia IV 40-100 bb' 6-max Seat #6 is the button
Seat 1: ZarubaNT ($1088.32 in chips) 
Seat 2: GERAKLmeat ($240 in chips) 
Seat 3: khlaus ($649.50 in chips) 
Seat 4: vjxbkf ($600 in chips) 
Seat 5: DuckinF0nk ($737.12 in chips) 
Seat 6: d`svictoriae ($408 in chips) 
ZarubaNT: posts small blind $3
GERAKLmeat: posts big blind $6
*** HOLE CARDS ***
khlaus: raises $12 to $18
vjxbkf: folds 
DuckinF0nk: folds 
d`svictoriae: folds 
ZarubaNT: folds 
GERAKLmeat: folds 
Uncalled bet ($12) returned to khlaus
khlaus collected $15 from pot
khlaus: doesn't show hand 
*** SUMMARY ***
Total pot $15 | Rake $0 
Seat 1: ZarubaNT (small blind) folded before Flop
Seat 2: GERAKLmeat (big blind) folded before Flop
Seat 3: khlaus collected ($15)
Seat 4: vjxbkf folded before Flop (didn't bet)
Seat 5: DuckinF0nk folded before Flop (didn't bet)
Seat 6: d`svictoriae (button) folded before Flop (didn't bet)


PokerStars Game #102597978482:  Hold'em No Limit ($3/$6 USD) - 2013/08/11 5:58:35 ET
Table 'Lorcia IV 40-100 bb' 6-max Seat #1 is the button
Seat 1: ZarubaNT ($1085.32 in chips) 
Seat 2: GERAKLmeat ($240 in chips) 
Seat 3: khlaus ($658.50 in chips) 
Seat 4: vjxbkf ($600 in chips) 
Seat 5: DuckinF0nk ($737.12 in chips) 
Seat 6: d`svictoriae ($408 in chips) 
GERAKLmeat: posts small blind $3
khlaus: posts big blind $6
*** HOLE CARDS ***
vjxbkf: folds 
DuckinF0nk: folds 
d`svictoriae: raises $6 to $12
ZarubaNT: folds 
GERAKLmeat: folds 
khlaus: folds 
Uncalled bet ($6) returned to d`svictoriae
d`svictoriae collected $15 from pot
d`svictoriae: doesn't show hand 
*** SUMMARY ***
Total pot $15 | Rake $0 
Seat 1: ZarubaNT (button) folded before Flop (didn't bet)
Seat 2: GERAKLmeat (small blind) folded before Flop
Seat 3: khlaus (big blind) folded before Flop
Seat 4: vjxbkf folded before Flop (didn't bet)
Seat 5: DuckinF0nk folded before Flop (didn't bet)
Seat 6: d`svictoriae collected ($15)


PokerStars Game #102597988054:  Hold'em No Limit ($3/$6 USD) - 2013/08/11 5:59:05 ET
Table 'Lorcia IV 40-100 bb' 6-max Seat #2 is the button
Seat 1: ZarubaNT ($1085.32 in chips) 
Seat 2: GERAKLmeat ($240 in chips) 
Seat 3: khlaus ($652.50 in chips) 
Seat 4: vjxbkf ($600 in chips) 
Seat 5: DuckinF0nk ($737.12 in chips) 
Seat 6: d`svictoriae ($417 in chips) 
khlaus: posts small blind $3
vjxbkf: posts big blind $6
*** HOLE CARDS ***
DuckinF0nk: folds 
d`svictoriae: folds 
ZarubaNT: folds 
GERAKLmeat: raises $6 to $12
khlaus: folds 
vjxbkf: folds 
Uncalled bet ($6) returned to GERAKLmeat
GERAKLmeat collected $15 from pot
GERAKLmeat: doesn't show hand 
*** SUMMARY ***
Total pot $15 | Rake $0 
Seat 1: ZarubaNT folded before Flop (didn't bet)
Seat 2: GERAKLmeat (button) collected ($15)
Seat 3: khlaus (small blind) folded before Flop
Seat 4: vjxbkf (big blind) folded before Flop
Seat 5: DuckinF0nk folded before Flop (didn't bet)
Seat 6: d`svictoriae folded before Flop (didn't bet)


PokerStars Game #102597991585:  Hold'em No Limit ($3/$6 USD) - 2013/08/11 5:59:16 ET
Table 'Lorcia IV 40-100 bb' 6-max Seat #3 is the button
Seat 1: ZarubaNT ($1085.32 in chips) 
Seat 2: GERAKLmeat ($249 in chips) 
Seat 3: khlaus ($649.50 in chips) 
Seat 4: vjxbkf ($600 in chips) 
Seat 5: DuckinF0nk ($737.12 in chips) 
Seat 6: d`svictoriae ($417 in chips) 
vjxbkf: posts small blind $3
DuckinF0nk: posts big blind $6
*** HOLE CARDS ***
d`svictoriae: folds 
ZarubaNT: folds 
GERAKLmeat: folds 
khlaus: raises $6 to $12
vjxbkf: folds 
DuckinF0nk: raises $30 to $42
khlaus: folds 
Uncalled bet ($30) returned to DuckinF0nk
DuckinF0nk collected $27 from pot
DuckinF0nk: doesn't show hand 
*** SUMMARY ***
Total pot $27 | Rake $0 
Seat 1: ZarubaNT folded before Flop (didn't bet)
Seat 2: GERAKLmeat folded before Flop (didn't bet)
Seat 3: khlaus (button) folded before Flop
Seat 4: vjxbkf (small blind) folded before Flop
Seat 5: DuckinF0nk (big blind) collected ($27)
Seat 6: d`svictoriae folded before Flop (didn't bet)


PokerStars Game #102598007559:  Hold'em No Limit ($3/$6 USD) - 2013/08/11 6:00:04 ET
Table 'Lorcia IV 40-100 bb' 6-max Seat #4 is the button
Seat 1: ZarubaNT ($1085.32 in chips) 
Seat 2: GERAKLmeat ($249 in chips) 
Seat 3: khlaus ($637.50 in chips) 
Seat 4: vjxbkf ($600 in chips) 
Seat 5: DuckinF0nk ($752.12 in chips) 
Seat 6: d`svictoriae ($417 in chips) 
DuckinF0nk: posts small blind $3
d`svictoriae: posts big blind $6
*** HOLE CARDS ***
ZarubaNT: folds 
GERAKLmeat: folds 
khlaus: folds 
vjxbkf: raises $6 to $12
DuckinF0nk: folds 
d`svictoriae: calls $6
*** FLOP *** [Th 4d 4h]
d`svictoriae: checks 
vjxbkf: bets $15
d`svictoriae: folds 
Uncalled bet ($15) returned to vjxbkf
vjxbkf collected $25.78 from pot
vjxbkf: doesn't show hand 
*** SUMMARY ***
Total pot $27 | Rake $1.22 
Board [Th 4d 4h]
Seat 1: ZarubaNT folded before Flop (didn't bet)
Seat 2: GERAKLmeat folded before Flop (didn't bet)
Seat 3: khlaus folded before Flop (didn't bet)
Seat 4: vjxbkf (button) collected ($25.78)
Seat 5: DuckinF0nk (small blind) folded before Flop
Seat 6: d`svictoriae (big blind) folded on the Flop


PokerStars Game #102598018892:  Hold'em No Limit ($3/$6 USD) - 2013/08/11 6:00:37 ET
Table 'Lorcia IV 40-100 bb' 6-max Seat #5 is the button
Seat 1: ZarubaNT ($1085.32 in chips) 
Seat 2: GERAKLmeat ($249 in chips) 
Seat 3: khlaus ($637.50 in chips) 
Seat 4: vjxbkf ($613.78 in chips) 
Seat 5: DuckinF0nk ($749.12 in chips) 
Seat 6: d`svictoriae ($405 in chips) 
d`svictoriae: posts small blind $3
ZarubaNT: posts big blind $6
*** HOLE CARDS ***
GERAKLmeat: raises $6 to $12
khlaus: folds 
vjxbkf: folds 
DuckinF0nk: folds 
d`svictoriae: folds 
ZarubaNT: folds 
Uncalled bet ($6) returned to GERAKLmeat
GERAKLmeat collected $15 from pot
GERAKLmeat: doesn't show hand 
*** SUMMARY ***
Total pot $15 | Rake $0 
Seat 1: ZarubaNT (big blind) folded before Flop
Seat 2: GERAKLmeat collected ($15)
Seat 3: khlaus folded before Flop (didn't bet)
Seat 4: vjxbkf folded before Flop (didn't bet)
Seat 5: DuckinF0nk (button) folded before Flop (didn't bet)
Seat 6: d`svictoriae (small blind) folded before Flop


PokerStars Game #102598025904:  Hold'em No Limit ($3/$6 USD) - 2013/08/11 6:00:58 ET
Table 'Lorcia IV 40-100 bb' 6-max Seat #6 is the button
Seat 1: ZarubaNT ($1079.32 in chips) 
Seat 2: GERAKLmeat ($258 in chips) 
Seat 3: khlaus ($637.50 in chips) 
Seat 4: vjxbkf ($613.78 in chips) 
Seat 5: DuckinF0nk ($749.12 in chips) 
Seat 6: d`svictoriae ($402 in chips) 
ZarubaNT: posts small blind $3
GERAKLmeat: posts big blind $6
*** HOLE CARDS ***
khlaus: folds 
vjxbkf: folds 
DuckinF0nk: raises $12 to $18
d`svictoriae: folds 
ZarubaNT: folds 
GERAKLmeat: folds 
Uncalled bet ($12) returned to DuckinF0nk
DuckinF0nk collected $15 from pot
DuckinF0nk: doesn't show hand 
*** SUMMARY ***
Total pot $15 | Rake $0 
Seat 1: ZarubaNT (small blind) folded before Flop
Seat 2: GERAKLmeat (big blind) folded before Flop
Seat 3: khlaus folded before Flop (didn't bet)
Seat 4: vjxbkf folded before Flop (didn't bet)
Seat 5: DuckinF0nk collected ($15)
Seat 6: d`svictoriae (button) folded before Flop (didn't bet)


PokerStars Game #102598036873:  Hold'em No Limit ($3/$6 USD) - 2013/08/11 6:01:27 ET
Table 'Lorcia IV 40-100 bb' 6-max Seat #1 is the button
Seat 1: ZarubaNT ($1076.32 in chips) 
Seat 2: GERAKLmeat ($252 in chips) 
Seat 3: khlaus ($637.50 in chips) 
Seat 4: vjxbkf ($613.78 in chips) 
Seat 5: DuckinF0nk ($758.12 in chips) 
Seat 6: d`svictoriae ($402 in chips) 
GERAKLmeat: posts small blind $3
khlaus: posts big blind $6
*** HOLE CARDS ***
vjxbkf: folds 
DuckinF0nk: folds 
d`svictoriae: folds 
ZarubaNT: folds 
GERAKLmeat: raises $6 to $12
khlaus: raises $18 to $30
GERAKLmeat: folds 
Uncalled bet ($18) returned to khlaus
khlaus collected $24 from pot
khlaus: doesn't show hand 
*** SUMMARY ***
Total pot $24 | Rake $0 
Seat 1: ZarubaNT (button) folded before Flop (didn't bet)
Seat 2: GERAKLmeat (small blind) folded before Flop
Seat 3: khlaus (big blind) collected ($24)
Seat 4: vjxbkf folded before Flop (didn't bet)
Seat 5: DuckinF0nk folded before Flop (didn't bet)
Seat 6: d`svictoriae folded before Flop (didn't bet)


PokerStars Game #102598045363:  Hold'em No Limit ($3/$6 USD) - 2013/08/11 6:01:51 ET
Table 'Lorcia IV 40-100 bb' 6-max Seat #2 is the button
Seat 1: ZarubaNT ($1076.32 in chips) 
Seat 2: GERAKLmeat ($240 in chips) 
Seat 3: khlaus ($649.50 in chips) 
Seat 4: vjxbkf ($613.78 in chips) 
Seat 5: DuckinF0nk ($758.12 in chips) 
Seat 6: d`svictoriae ($402 in chips) 
khlaus: posts small blind $3
vjxbkf: posts big blind $6
*** HOLE CARDS ***
DuckinF0nk: folds 
d`svictoriae: raises $6 to $12
ZarubaNT: folds 
GERAKLmeat: calls $12
khlaus: folds 
vjxbkf: calls $6
*** FLOP *** [Ac 8c 5c]
vjxbkf: bets $30
d`svictoriae: calls $30
GERAKLmeat: folds 
*** TURN *** [Ac 8c 5c] [9c]
vjxbkf: checks 
d`svictoriae: bets $54
vjxbkf: folds 
Uncalled bet ($54) returned to d`svictoriae
d`svictoriae collected $96.20 from pot
d`svictoriae: doesn't show hand 
*** SUMMARY ***
Total pot $99 | Rake $2.80 
Board [Ac 8c 5c 9c]
Seat 1: ZarubaNT folded before Flop (didn't bet)
Seat 2: GERAKLmeat (button) folded on the Flop
Seat 3: khlaus (small blind) folded before Flop
Seat 4: vjxbkf (big blind) folded on the Turn
Seat 5: DuckinF0nk folded before Flop (didn't bet)
Seat 6: d`svictoriae collected ($96.20)


PokerStars Game #102598084157:  Hold'em No Limit ($3/$6 USD) - 2013/08/11 6:03:24 ET
Table 'Lorcia IV 40-100 bb' 6-max Seat #3 is the button
Seat 1: ZarubaNT ($1076.32 in chips) 
Seat 2: GERAKLmeat ($240 in chips) 
Seat 3: khlaus ($646.50 in chips) 
Seat 4: vjxbkf ($600 in chips) 
Seat 5: DuckinF0nk ($758.12 in chips) 
Seat 6: d`svictoriae ($456.20 in chips) 
vjxbkf: posts small blind $3
DuckinF0nk: posts big blind $6
*** HOLE CARDS ***
d`svictoriae: raises $6 to $12
ZarubaNT: folds 
GERAKLmeat: folds 
khlaus: calls $12
vjxbkf: folds 
DuckinF0nk: calls $6
*** FLOP *** [Ad Ah 9c]
DuckinF0nk: checks 
d`svictoriae: bets $18
khlaus: folds 
DuckinF0nk: folds 
Uncalled bet ($18) returned to d`svictoriae
d`svictoriae collected $37.24 from pot
d`svictoriae: doesn't show hand 
*** SUMMARY ***
Total pot $39 | Rake $1.76 
Board [Ad Ah 9c]
Seat 1: ZarubaNT folded before Flop (didn't bet)
Seat 2: GERAKLmeat folded before Flop (didn't bet)
Seat 3: khlaus (button) folded on the Flop
Seat 4: vjxbkf (small blind) folded before Flop
Seat 5: DuckinF0nk (big blind) folded on the Flop
Seat 6: d`svictoriae collected ($37.24)


PokerStars Game #102598106467:  Hold'em No Limit ($3/$6 USD) - 2013/08/11 6:04:17 ET
Table 'Lorcia IV 40-100 bb' 6-max Seat #4 is the button
Seat 1: ZarubaNT ($1076.32 in chips) 
Seat 2: GERAKLmeat ($240 in chips) 
Seat 3: khlaus ($634.50 in chips) 
Seat 4: vjxbkf ($600 in chips) 
Seat 5: DuckinF0nk ($746.12 in chips) 
Seat 6: d`svictoriae ($481.44 in chips) 
DuckinF0nk: posts small blind $3
d`svictoriae: posts big blind $6
*** HOLE CARDS ***
ZarubaNT: folds 
GERAKLmeat: folds 
khlaus: folds 
vjxbkf: folds 
DuckinF0nk: folds 
Uncalled bet ($3) returned to d`svictoriae
d`svictoriae collected $6 from pot
d`svictoriae: doesn't show hand 
*** SUMMARY ***
Total pot $6 | Rake $0 
Seat 1: ZarubaNT folded before Flop (didn't bet)
Seat 2: GERAKLmeat folded before Flop (didn't bet)
Seat 3: khlaus folded before Flop (didn't bet)
Seat 4: vjxbkf (button) folded before Flop (didn't bet)
Seat 5: DuckinF0nk (small blind) folded before Flop
Seat 6: d`svictoriae (big blind) collected ($6)


PokerStars Game #102598119806:  Hold'em No Limit ($3/$6 USD) - 2013/08/11 6:04:49 ET
Table 'Lorcia IV 40-100 bb' 6-max Seat #5 is the button
Seat 2: GERAKLmeat ($240 in chips) 
Seat 3: khlaus ($634.50 in chips) 
Seat 4: vjxbkf ($600 in chips) 
Seat 5: DuckinF0nk ($743.12 in chips) 
Seat 6: d`svictoriae ($484.44 in chips) 
d`svictoriae: posts small blind $3
ZarubaNT: is sitting out 
GERAKLmeat: posts big blind $6
*** HOLE CARDS ***
khlaus: folds 
vjxbkf: raises $12 to $18
DuckinF0nk: folds 
d`svictoriae: folds 
GERAKLmeat: folds 
Uncalled bet ($12) returned to vjxbkf
vjxbkf collected $15 from pot
vjxbkf: doesn't show hand 
*** SUMMARY ***
Total pot $15 | Rake $0 
Seat 2: GERAKLmeat (big blind) folded before Flop
Seat 3: khlaus folded before Flop (didn't bet)
Seat 4: vjxbkf collected ($15)
Seat 5: DuckinF0nk (button) folded before Flop (didn't bet)
Seat 6: d`svictoriae (small blind) folded before Flop


PokerStars Game #102598641515:  Hold'em No Limit ($3/$6 USD) - 2013/08/11 6:25:08 ET
Table 'Lorcia IV 40-100 bb' 6-max Seat #1 is the button
Seat 1: ZarubaNT ($1020.09 in chips) 
Seat 2: GERAKLmeat ($276.98 in chips) 
Seat 3: khlaus ($624.98 in chips) 
Seat 4: vjxbkf ($600 in chips) 
Seat 5: DuckinF0nk ($935.52 in chips) 
Seat 6: d`svictoriae ($594.07 in chips) 
GERAKLmeat: posts small blind $3
khlaus: posts big blind $6
*** HOLE CARDS ***
vjxbkf: folds 
DuckinF0nk: raises $12 to $18
d`svictoriae: folds 
ZarubaNT: folds 
GERAKLmeat: folds 
khlaus: folds 
Uncalled bet ($12) returned to DuckinF0nk
DuckinF0nk collected $15 from pot
DuckinF0nk: doesn't show hand 
*** SUMMARY ***
Total pot $15 | Rake $0 
Seat 1: ZarubaNT (button) folded before Flop (didn't bet)
Seat 2: GERAKLmeat (small blind) folded before Flop
Seat 3: khlaus (big blind) folded before Flop
Seat 4: vjxbkf folded before Flop (didn't bet)
Seat 5: DuckinF0nk collected ($15)
Seat 6: d`svictoriae folded before Flop (didn't bet)


PokerStars Game #102598652261:  Hold'em No Limit ($3/$6 USD) - 2013/08/11 6:25:33 ET
Table 'Lorcia IV 40-100 bb' 6-max Seat #2 is the button
Seat 1: ZarubaNT ($1020.09 in chips) 
Seat 2: GERAKLmeat ($273.98 in chips) 
Seat 3: khlaus ($618.98 in chips) 
Seat 4: vjxbkf ($600 in chips) 
Seat 5: DuckinF0nk ($944.52 in chips) 
Seat 6: d`svictoriae ($594.07 in chips) 
khlaus: posts small blind $3
vjxbkf: posts big blind $6
*** HOLE CARDS ***
DuckinF0nk: folds 
d`svictoriae: folds 
ZarubaNT: folds 
GERAKLmeat: folds 
khlaus: folds 
Uncalled bet ($3) returned to vjxbkf
vjxbkf collected $6 from pot
vjxbkf: doesn't show hand 
*** SUMMARY ***
Total pot $6 | Rake $0 
Seat 1: ZarubaNT folded before Flop (didn't bet)
Seat 2: GERAKLmeat (button) folded before Flop (didn't bet)
Seat 3: khlaus (small blind) folded before Flop
Seat 4: vjxbkf (big blind) collected ($6)
Seat 5: DuckinF0nk folded before Flop (didn't bet)
Seat 6: d`svictoriae folded before Flop (didn't bet)


PokerStars Game #102598659555:  Hold'em No Limit ($3/$6 USD) - 2013/08/11 6:25:50 ET
Table 'Lorcia IV 40-100 bb' 6-max Seat #3 is the button
Seat 1: ZarubaNT ($1020.09 in chips) 
Seat 2: GERAKLmeat ($273.98 in chips) 
Seat 3: khlaus ($615.98 in chips) 
Seat 4: vjxbkf ($603 in chips) 
Seat 5: DuckinF0nk ($944.52 in chips) 
Seat 6: d`svictoriae ($594.07 in chips) 
vjxbkf: posts small blind $3
DuckinF0nk: posts big blind $6
*** HOLE CARDS ***
d`svictoriae: folds 
ZarubaNT has timed out
ZarubaNT: folds 
GERAKLmeat: raises $6 to $12
khlaus: folds 
vjxbkf: raises $24 to $36
DuckinF0nk: folds 
GERAKLmeat: raises $237.98 to $273.98 and is all-in
vjxbkf: folds 
Uncalled bet ($237.98) returned to GERAKLmeat
GERAKLmeat collected $78 from pot
GERAKLmeat: doesn't show hand 
*** SUMMARY ***
Total pot $78 | Rake $0 
Seat 1: ZarubaNT folded before Flop (didn't bet)
Seat 2: GERAKLmeat collected ($78)
Seat 3: khlaus (button) folded before Flop (didn't bet)
Seat 4: vjxbkf (small blind) folded before Flop
Seat 5: DuckinF0nk (big blind) folded before Flop
Seat 6: d`svictoriae folded before Flop (didn't bet)


PokerStars Game #102598690658:  Hold'em No Limit ($3/$6 USD) - 2013/08/11 6:27:03 ET
Table 'Lorcia IV 40-100 bb' 6-max Seat #4 is the button
Seat 1: ZarubaNT ($1020.09 in chips) 
Seat 2: GERAKLmeat ($315.98 in chips) 
Seat 3: khlaus ($615.98 in chips) 
Seat 4: vjxbkf ($600 in chips) 
Seat 5: DuckinF0nk ($938.52 in chips) 
DuckinF0nk: posts small blind $3
ZarubaNT: posts big blind $6
*** HOLE CARDS ***
GERAKLmeat: folds 
khlaus: folds 
vjxbkf: folds 
DuckinF0nk: folds 
Uncalled bet ($3) returned to ZarubaNT
ZarubaNT collected $6 from pot
ZarubaNT: doesn't show hand 
*** SUMMARY ***
Total pot $6 | Rake $0 
Seat 1: ZarubaNT (big blind) collected ($6)
Seat 2: GERAKLmeat folded before Flop (didn't bet)
Seat 3: khlaus folded before Flop (didn't bet)
Seat 4: vjxbkf (button) folded before Flop (didn't bet)
Seat 5: DuckinF0nk (small blind) folded before Flop


PokerStars Game #102598698674:  Hold'em No Limit ($3/$6 USD) - 2013/08/11 6:27:21 ET
Table 'Lorcia IV 40-100 bb' 6-max Seat #5 is the button
Seat 1: ZarubaNT ($1023.09 in chips) 
Seat 2: GERAKLmeat ($315.98 in chips) 
Seat 3: khlaus ($615.98 in chips) 
Seat 4: vjxbkf ($600 in chips) 
Seat 5: DuckinF0nk ($935.52 in chips) 
ZarubaNT: posts small blind $3
GERAKLmeat: posts big blind $6
*** HOLE CARDS ***
khlaus: folds 
vjxbkf: folds 
DuckinF0nk: raises $6 to $12
ZarubaNT: calls $9
GERAKLmeat: folds 
*** FLOP *** [9h 3s 7d]
ZarubaNT: checks 
DuckinF0nk: bets $21
ZarubaNT: folds 
Uncalled bet ($21) returned to DuckinF0nk
DuckinF0nk collected $28.65 from pot
DuckinF0nk: doesn't show hand 
*** SUMMARY ***
Total pot $30 | Rake $1.35 
Board [9h 3s 7d]
Seat 1: ZarubaNT (small blind) folded on the Flop
Seat 2: GERAKLmeat (big blind) folded before Flop
Seat 3: khlaus folded before Flop (didn't bet)
Seat 4: vjxbkf folded before Flop (didn't bet)
Seat 5: DuckinF0nk (button) collected ($28.65)


PokerStars Game #102598713604:  Hold'em No Limit ($3/$6 USD) - 2013/08/11 6:27:56 ET
Table 'Lorcia IV 40-100 bb' 6-max Seat #1 is the button
Seat 1: ZarubaNT ($1011.09 in chips) 
Seat 2: GERAKLmeat ($309.98 in chips) 
Seat 3: khlaus ($615.98 in chips) 
Seat 4: vjxbkf ($600 in chips) 
Seat 5: DuckinF0nk ($952.17 in chips) 
GERAKLmeat: posts small blind $3
khlaus: posts big blind $6
*** HOLE CARDS ***
vjxbkf: raises $15 to $21
DuckinF0nk: folds 
ZarubaNT: folds 
GERAKLmeat: folds 
khlaus: folds 
Uncalled bet ($15) returned to vjxbkf
vjxbkf collected $15 from pot
vjxbkf: doesn't show hand 
*** SUMMARY ***
Total pot $15 | Rake $0 
Seat 1: ZarubaNT (button) folded before Flop (didn't bet)
Seat 2: GERAKLmeat (small blind) folded before Flop
Seat 3: khlaus (big blind) folded before Flop
Seat 4: vjxbkf collected ($15)
Seat 5: DuckinF0nk folded before Flop (didn't bet)


PokerStars Game #102598722171:  Hold'em No Limit ($3/$6 USD) - 2013/08/11 6:28:16 ET
Table 'Lorcia IV 40-100 bb' 6-max Seat #2 is the button
Seat 1: ZarubaNT ($1011.09 in chips) 
Seat 2: GERAKLmeat ($306.98 in chips) 
Seat 3: khlaus ($609.98 in chips) 
Seat 4: vjxbkf ($609 in chips) 
Seat 5: DuckinF0nk ($952.17 in chips) 
khlaus: posts small blind $3
vjxbkf: posts big blind $6
*** HOLE CARDS ***
DuckinF0nk: folds 
ZarubaNT: folds 
GERAKLmeat: raises $6 to $12
khlaus: raises $18 to $30
vjxbkf: folds 
GERAKLmeat: folds 
Uncalled bet ($18) returned to khlaus
khlaus collected $30 from pot
khlaus: doesn't show hand 
*** SUMMARY ***
Total pot $30 | Rake $0 
Seat 1: ZarubaNT folded before Flop (didn't bet)
Seat 2: GERAKLmeat (button) folded before Flop
Seat 3: khlaus (small blind) collected ($30)
Seat 4: vjxbkf (big blind) folded before Flop
Seat 5: DuckinF0nk folded before Flop (didn't bet)


PokerStars Game #102598733222:  Hold'em No Limit ($3/$6 USD) - 2013/08/11 6:28:42 ET
Table 'Lorcia IV 40-100 bb' 6-max Seat #3 is the button
Seat 1: ZarubaNT ($1011.09 in chips) 
Seat 2: GERAKLmeat ($294.98 in chips) 
Seat 3: khlaus ($627.98 in chips) 
Seat 4: vjxbkf ($603 in chips) 
Seat 6: d`svictoriae ($594.07 in chips) 
vjxbkf: posts small blind $3
d`svictoriae: posts big blind $6
*** HOLE CARDS ***
ZarubaNT: raises $12 to $18
GERAKLmeat: raises $24 to $42
khlaus: folds 
vjxbkf: folds 
d`svictoriae: folds 
ZarubaNT: raises $36 to $78
GERAKLmeat: calls $36
*** FLOP *** [7h Ad 9c]
ZarubaNT: checks 
GERAKLmeat: bets $54
ZarubaNT: calls $54
*** TURN *** [7h Ad 9c] [4d]
ZarubaNT: checks 
GERAKLmeat: checks 
*** RIVER *** [7h Ad 9c 4d] [9d]
ZarubaNT: checks 
GERAKLmeat: bets $162.98 and is all-in
ZarubaNT: calls $162.98
*** SHOW DOWN ***
GERAKLmeat: shows [Qs As] (two pair, Aces and Nines)
ZarubaNT: shows [4h Ah] (two pair, Aces and Nines - lower kicker)
GERAKLmeat collected $596.16 from pot
*** SUMMARY ***
Total pot $598.96 | Rake $2.80 
Board [7h Ad 9c 4d 9d]
Seat 1: ZarubaNT showed [4h Ah] and lost with two pair, Aces and Nines
Seat 2: GERAKLmeat showed [Qs As] and won ($596.16) with two pair, Aces and Nines
Seat 3: khlaus (button) folded before Flop (didn't bet)
Seat 4: vjxbkf (small blind) folded before Flop
Seat 6: d`svictoriae (big blind) folded before Flop


PokerStars Game #102598400424:  Hold'em No Limit ($3/$6 USD) - 2013/08/11 6:15:47 ET
Table 'Lorcia IV 40-100 bb' 6-max Seat #6 is the button
Seat 1: ZarubaNT ($1158.09 in chips) 
Seat 2: GERAKLmeat ($244.78 in chips) 
Seat 3: khlaus ($609 in chips) 
Seat 4: vjxbkf ($612 in chips) 
Seat 5: DuckinF0nk ($821.32 in chips) 
Seat 6: d`svictoriae ($532.64 in chips) 
ZarubaNT: posts small blind $3
GERAKLmeat: posts big blind $6
*** HOLE CARDS ***
khlaus: folds 
vjxbkf: folds 
DuckinF0nk: folds 
d`svictoriae: raises $6 to $12
ZarubaNT: folds 
GERAKLmeat: raises $12 to $24
d`svictoriae: calls $12
*** FLOP *** [Ah 3h 5s]
GERAKLmeat: bets $24.83
d`svictoriae: calls $24.83
*** TURN *** [Ah 3h 5s] [3d]
GERAKLmeat: checks 
d`svictoriae: bets $48
GERAKLmeat: folds 
Uncalled bet ($48) returned to d`svictoriae
d`svictoriae collected $97.86 from pot
d`svictoriae: doesn't show hand 
*** SUMMARY ***
Total pot $100.66 | Rake $2.80 
Board [Ah 3h 5s 3d]
Seat 1: ZarubaNT (small blind) folded before Flop
Seat 2: GERAKLmeat (big blind) folded on the Turn
Seat 3: khlaus folded before Flop (didn't bet)
Seat 4: vjxbkf folded before Flop (didn't bet)
Seat 5: DuckinF0nk folded before Flop (didn't bet)
Seat 6: d`svictoriae (button) collected ($97.86)


PokerStars Game #102598422971:  Hold'em No Limit ($3/$6 USD) - 2013/08/11 6:16:39 ET
Table 'Lorcia IV 40-100 bb' 6-max Seat #1 is the button
Seat 1: ZarubaNT ($1155.09 in chips) 
Seat 2: GERAKLmeat ($240 in chips) 
Seat 3: khlaus ($609 in chips) 
Seat 4: vjxbkf ($612 in chips) 
Seat 5: DuckinF0nk ($821.32 in chips) 
Seat 6: d`svictoriae ($581.67 in chips) 
GERAKLmeat: posts small blind $3
khlaus: posts big blind $6
*** HOLE CARDS ***
vjxbkf: folds 
DuckinF0nk: raises $12 to $18
d`svictoriae: folds 
ZarubaNT: raises $36 to $54
GERAKLmeat: folds 
khlaus: folds 
DuckinF0nk: calls $36
*** FLOP *** [6d Ac Js]
DuckinF0nk: checks 
ZarubaNT: checks 
*** TURN *** [6d Ac Js] [Qs]
DuckinF0nk: bets $72
ZarubaNT: calls $72
*** RIVER *** [6d Ac Js Qs] [4h]
DuckinF0nk: bets $226
ZarubaNT: folds 
Uncalled bet ($226) returned to DuckinF0nk
DuckinF0nk collected $258.20 from pot
DuckinF0nk: doesn't show hand 
*** SUMMARY ***
Total pot $261 | Rake $2.80 
Board [6d Ac Js Qs 4h]
Seat 1: ZarubaNT (button) folded on the River
Seat 2: GERAKLmeat (small blind) folded before Flop
Seat 3: khlaus (big blind) folded before Flop
Seat 4: vjxbkf folded before Flop (didn't bet)
Seat 5: DuckinF0nk collected ($258.20)
Seat 6: d`svictoriae folded before Flop (didn't bet)


PokerStars Game #102598479878:  Hold'em No Limit ($3/$6 USD) - 2013/08/11 6:18:50 ET
Table 'Lorcia IV 40-100 bb' 6-max Seat #2 is the button
Seat 1: ZarubaNT ($1029.09 in chips) 
Seat 2: GERAKLmeat ($240 in chips) 
Seat 3: khlaus ($603 in chips) 
Seat 4: vjxbkf ($612 in chips) 
Seat 5: DuckinF0nk ($953.52 in chips) 
Seat 6: d`svictoriae ($581.67 in chips) 
khlaus: posts small blind $3
vjxbkf: posts big blind $6
*** HOLE CARDS ***
DuckinF0nk: raises $12 to $18
d`svictoriae: calls $18
ZarubaNT: folds 
GERAKLmeat: folds 
khlaus: folds 
vjxbkf: folds 
*** FLOP *** [Qd 4c Kd]
DuckinF0nk: checks 
d`svictoriae: bets $24
DuckinF0nk: folds 
Uncalled bet ($24) returned to d`svictoriae
d`svictoriae collected $42.98 from pot
d`svictoriae: doesn't show hand 
*** SUMMARY ***
Total pot $45 | Rake $2.02 
Board [Qd 4c Kd]
Seat 1: ZarubaNT folded before Flop (didn't bet)
Seat 2: GERAKLmeat (button) folded before Flop (didn't bet)
Seat 3: khlaus (small blind) folded before Flop
Seat 4: vjxbkf (big blind) folded before Flop
Seat 5: DuckinF0nk folded on the Flop
Seat 6: d`svictoriae collected ($42.98)


PokerStars Game #102598494895:  Hold'em No Limit ($3/$6 USD) - 2013/08/11 6:19:25 ET
Table 'Lorcia IV 40-100 bb' 6-max Seat #3 is the button
Seat 1: ZarubaNT ($1029.09 in chips) 
Seat 2: GERAKLmeat ($240 in chips) 
Seat 3: khlaus ($600 in chips) 
Seat 4: vjxbkf ($606 in chips) 
Seat 5: DuckinF0nk ($935.52 in chips) 
Seat 6: d`svictoriae ($606.65 in chips) 
vjxbkf: posts small blind $3
DuckinF0nk: posts big blind $6
*** HOLE CARDS ***
d`svictoriae: folds 
ZarubaNT: folds 
GERAKLmeat: raises $6 to $12
khlaus: raises $15 to $27
vjxbkf: folds 
DuckinF0nk: folds 
GERAKLmeat: raises $213 to $240 and is all-in
khlaus: folds 
Uncalled bet ($213) returned to GERAKLmeat
GERAKLmeat collected $63 from pot
GERAKLmeat: doesn't show hand 
*** SUMMARY ***
Total pot $63 | Rake $0 
Seat 1: ZarubaNT folded before Flop (didn't bet)
Seat 2: GERAKLmeat collected ($63)
Seat 3: khlaus (button) folded before Flop
Seat 4: vjxbkf (small blind) folded before Flop
Seat 5: DuckinF0nk (big blind) folded before Flop
Seat 6: d`svictoriae folded before Flop (didn't bet)


PokerStars Game #102599027926:  Hold'em No Limit ($3/$6 USD) - 2013/08/11 6:40:02 ET
Table 'Lorcia IV 40-100 bb' 6-max Seat #5 is the button
Seat 1: ZarubaNT ($701.11 in chips) 
Seat 2: GERAKLmeat ($670.54 in chips) 
Seat 3: khlaus ($610.24 in chips) 
Seat 4: vjxbkf ($600 in chips) 
Seat 5: DuckinF0nk ($943.17 in chips) 
Seat 6: d`svictoriae ($572.37 in chips) 
d`svictoriae: posts small blind $3
ZarubaNT: posts big blind $6
*** HOLE CARDS ***
GERAKLmeat: folds 
khlaus: folds 
vjxbkf: folds 
DuckinF0nk: raises $9 to $15
d`svictoriae: folds 
ZarubaNT: calls $9
*** FLOP *** [3c Qd Ks]
ZarubaNT: checks 
DuckinF0nk: bets $24
ZarubaNT: calls $24
*** TURN *** [3c Qd Ks] [3h]
ZarubaNT: checks 
DuckinF0nk: checks 
*** RIVER *** [3c Qd Ks 3h] [Js]
ZarubaNT: bets $66
DuckinF0nk: folds 
Uncalled bet ($66) returned to ZarubaNT
ZarubaNT collected $78.20 from pot
ZarubaNT: doesn't show hand 
*** SUMMARY ***
Total pot $81 | Rake $2.80 
Board [3c Qd Ks 3h Js]
Seat 1: ZarubaNT (big blind) collected ($78.20)
Seat 2: GERAKLmeat folded before Flop (didn't bet)
Seat 3: khlaus folded before Flop (didn't bet)
Seat 4: vjxbkf folded before Flop (didn't bet)
Seat 5: DuckinF0nk (button) folded on the River
Seat 6: d`svictoriae (small blind) folded before Flop


PokerStars Game #102599058255:  Hold'em No Limit ($3/$6 USD) - 2013/08/11 6:41:12 ET
Table 'Lorcia IV 40-100 bb' 6-max Seat #6 is the button
Seat 1: ZarubaNT ($740.31 in chips) 
Seat 2: GERAKLmeat ($670.54 in chips) 
Seat 3: khlaus ($610.24 in chips) 
Seat 4: vjxbkf ($600 in chips) 
Seat 5: DuckinF0nk ($904.17 in chips) 
Seat 6: d`svictoriae ($569.37 in chips) 
ZarubaNT: posts small blind $3
GERAKLmeat: posts big blind $6
*** HOLE CARDS ***
khlaus: folds 
vjxbkf: folds 
DuckinF0nk: folds 
d`svictoriae: folds 
ZarubaNT: raises $12 to $18
GERAKLmeat: folds 
Uncalled bet ($12) returned to ZarubaNT
ZarubaNT collected $12 from pot
ZarubaNT: doesn't show hand 
*** SUMMARY ***
Total pot $12 | Rake $0 
Seat 1: ZarubaNT (small blind) collected ($12)
Seat 2: GERAKLmeat (big blind) folded before Flop
Seat 3: khlaus folded before Flop (didn't bet)
Seat 4: vjxbkf folded before Flop (didn't bet)
Seat 5: DuckinF0nk folded before Flop (didn't bet)
Seat 6: d`svictoriae (button) folded before Flop (didn't bet)


PokerStars Game #102599067160:  Hold'em No Limit ($3/$6 USD) - 2013/08/11 6:41:33 ET
Table 'Lorcia IV 40-100 bb' 6-max Seat #1 is the button
Seat 1: ZarubaNT ($746.31 in chips) 
Seat 2: GERAKLmeat ($664.54 in chips) 
Seat 3: khlaus ($610.24 in chips) 
Seat 4: vjxbkf ($600 in chips) 
Seat 5: DuckinF0nk ($904.17 in chips) 
Seat 6: d`svictoriae ($569.37 in chips) 
GERAKLmeat: posts small blind $3
khlaus: posts big blind $6
*** HOLE CARDS ***
vjxbkf: folds 
DuckinF0nk: folds 
d`svictoriae: folds 
ZarubaNT: folds 
GERAKLmeat: raises $6 to $12
khlaus: calls $6
*** FLOP *** [Ts Qs 7s]
GERAKLmeat: bets $11.68
khlaus: raises $26.32 to $38
GERAKLmeat: folds 
Uncalled bet ($26.32) returned to khlaus
khlaus collected $45.23 from pot
khlaus: doesn't show hand 
*** SUMMARY ***
Total pot $47.36 | Rake $2.13 
Board [Ts Qs 7s]
Seat 1: ZarubaNT (button) folded before Flop (didn't bet)
Seat 2: GERAKLmeat (small blind) folded on the Flop
Seat 3: khlaus (big blind) collected ($45.23)
Seat 4: vjxbkf folded before Flop (didn't bet)
Seat 5: DuckinF0nk folded before Flop (didn't bet)
Seat 6: d`svictoriae folded before Flop (didn't bet)


PokerStars Game #102599091914:  Hold'em No Limit ($3/$6 USD) - 2013/08/11 6:42:26 ET
Table 'Lorcia IV 40-100 bb' 6-max Seat #2 is the button
Seat 1: ZarubaNT ($746.31 in chips) 
Seat 2: GERAKLmeat ($640.86 in chips) 
Seat 3: khlaus ($631.79 in chips) 
Seat 4: vjxbkf ($600 in chips) 
Seat 5: DuckinF0nk ($904.17 in chips) 
Seat 6: d`svictoriae ($569.37 in chips) 
khlaus: posts small blind $3
vjxbkf: posts big blind $6
*** HOLE CARDS ***
DuckinF0nk: folds 
d`svictoriae: folds 
ZarubaNT: raises $9 to $15
GERAKLmeat: folds 
khlaus: folds 
vjxbkf: calls $9
*** FLOP *** [8s As 4s]
vjxbkf: checks 
ZarubaNT: bets $21
vjxbkf: folds 
Uncalled bet ($21) returned to ZarubaNT
ZarubaNT collected $31.52 from pot
ZarubaNT: doesn't show hand 
*** SUMMARY ***
Total pot $33 | Rake $1.48 
Board [8s As 4s]
Seat 1: ZarubaNT collected ($31.52)
Seat 2: GERAKLmeat (button) folded before Flop (didn't bet)
Seat 3: khlaus (small blind) folded before Flop
Seat 4: vjxbkf (big blind) folded on the Flop
Seat 5: DuckinF0nk folded before Flop (didn't bet)
Seat 6: d`svictoriae folded before Flop (didn't bet)


PokerStars Game #102599126450:  Hold'em No Limit ($3/$6 USD) - 2013/08/11 6:43:42 ET
Table 'Lorcia IV 40-100 bb' 6-max Seat #3 is the button
Seat 1: ZarubaNT ($762.83 in chips) 
Seat 2: GERAKLmeat ($640.86 in chips) 
Seat 3: khlaus ($628.79 in chips) 
Seat 4: vjxbkf ($600 in chips) 
Seat 5: DuckinF0nk ($904.17 in chips) 
Seat 6: d`svictoriae ($569.37 in chips) 
vjxbkf: posts small blind $3
DuckinF0nk: posts big blind $6
*** HOLE CARDS ***
d`svictoriae: folds 
ZarubaNT: folds 
GERAKLmeat: raises $6 to $12
khlaus: folds 
vjxbkf: folds 
DuckinF0nk: folds 
Uncalled bet ($6) returned to GERAKLmeat
GERAKLmeat collected $15 from pot
GERAKLmeat: doesn't show hand 
*** SUMMARY ***
Total pot $15 | Rake $0 
Seat 1: ZarubaNT folded before Flop (didn't bet)
Seat 2: GERAKLmeat collected ($15)
Seat 3: khlaus (button) folded before Flop (didn't bet)
Seat 4: vjxbkf (small blind) folded before Flop
Seat 5: DuckinF0nk (big blind) folded before Flop
Seat 6: d`svictoriae folded before Flop (didn't bet)


PokerStars Game #102599134585:  Hold'em No Limit ($3/$6 USD) - 2013/08/11 6:44:00 ET
Table 'Lorcia IV 40-100 bb' 6-max Seat #4 is the button
Seat 1: ZarubaNT ($762.83 in chips) 
Seat 2: GERAKLmeat ($649.86 in chips) 
Seat 3: khlaus ($628.79 in chips) 
Seat 4: vjxbkf ($600 in chips) 
Seat 5: DuckinF0nk ($898.17 in chips) 
Seat 6: d`svictoriae ($569.37 in chips) 
DuckinF0nk: posts small blind $3
d`svictoriae: posts big blind $6
*** HOLE CARDS ***
ZarubaNT: folds 
GERAKLmeat: raises $6 to $12
khlaus: folds 
vjxbkf: folds 
DuckinF0nk: folds 
d`svictoriae: calls $6
*** FLOP *** [8h Ts Ks]
d`svictoriae: checks 
GERAKLmeat: bets $18
d`svictoriae: folds 
Uncalled bet ($18) returned to GERAKLmeat
GERAKLmeat collected $25.78 from pot
GERAKLmeat: doesn't show hand 
*** SUMMARY ***
Total pot $27 | Rake $1.22 
Board [8h Ts Ks]
Seat 1: ZarubaNT folded before Flop (didn't bet)
Seat 2: GERAKLmeat collected ($25.78)
Seat 3: khlaus folded before Flop (didn't bet)
Seat 4: vjxbkf (button) folded before Flop (didn't bet)
Seat 5: DuckinF0nk (small blind) folded before Flop
Seat 6: d`svictoriae (big blind) folded on the Flop


PokerStars Game #102599148983:  Hold'em No Limit ($3/$6 USD) - 2013/08/11 6:44:32 ET
Table 'Lorcia IV 40-100 bb' 6-max Seat #5 is the button
Seat 1: ZarubaNT ($762.83 in chips) 
Seat 2: GERAKLmeat ($663.64 in chips) 
Seat 3: khlaus ($628.79 in chips) 
Seat 4: vjxbkf ($600 in chips) 
Seat 5: DuckinF0nk ($895.17 in chips) 
Seat 6: d`svictoriae ($557.37 in chips) 
d`svictoriae: posts small blind $3
ZarubaNT: posts big blind $6
*** HOLE CARDS ***
GERAKLmeat: raises $6 to $12
khlaus: folds 
vjxbkf: calls $12
DuckinF0nk: folds 
d`svictoriae: folds 
ZarubaNT: folds 
*** FLOP *** [2c 6c Ks]
GERAKLmeat: bets $16.07
vjxbkf: calls $16.07
*** TURN *** [2c 6c Ks] [Ts]
GERAKLmeat: bets $31.79
vjxbkf: raises $79.21 to $111
GERAKLmeat: folds 
Uncalled bet ($79.21) returned to vjxbkf
vjxbkf collected $125.92 from pot
vjxbkf: doesn't show hand 
*** SUMMARY ***
Total pot $128.72 | Rake $2.80 
Board [2c 6c Ks Ts]
Seat 1: ZarubaNT (big blind) folded before Flop
Seat 2: GERAKLmeat folded on the Turn
Seat 3: khlaus folded before Flop (didn't bet)
Seat 4: vjxbkf collected ($125.92)
Seat 5: DuckinF0nk (button) folded before Flop (didn't bet)
Seat 6: d`svictoriae (small blind) folded before Flop


PokerStars Game #102598908071:  Hold'em No Limit ($3/$6 USD) - 2013/08/11 6:35:26 ET
Table 'Lorcia IV 40-100 bb' 6-max Seat #6 is the button
Seat 1: ZarubaNT ($695.11 in chips) 
Seat 2: GERAKLmeat ($614.11 in chips) 
Seat 3: khlaus ($600 in chips) 
Seat 4: vjxbkf ($600 in chips) 
Seat 6: d`svictoriae ($631.60 in chips) 
ZarubaNT: posts small blind $3
GERAKLmeat: posts big blind $6
DuckinF0nk: sits out 
*** HOLE CARDS ***
khlaus: raises $12 to $18
vjxbkf: folds 
d`svictoriae: folds 
ZarubaNT: folds 
GERAKLmeat: calls $12
*** FLOP *** [5c As 6h]
GERAKLmeat: checks 
khlaus: checks 
*** TURN *** [5c As 6h] [3h]
GERAKLmeat: checks 
khlaus: checks 
*** RIVER *** [5c As 6h 3h] [2h]
GERAKLmeat: checks 
khlaus: bets $26
GERAKLmeat is disconnected 
GERAKLmeat is connected 
GERAKLmeat: folds 
Uncalled bet ($26) returned to khlaus
khlaus collected $37.24 from pot
khlaus: doesn't show hand 
*** SUMMARY ***
Total pot $39 | Rake $1.76 
Board [5c As 6h 3h 2h]
Seat 1: ZarubaNT (small blind) folded before Flop
Seat 2: GERAKLmeat (big blind) folded on the River
Seat 3: khlaus collected ($37.24)
Seat 4: vjxbkf folded before Flop (didn't bet)
Seat 6: d`svictoriae (button) folded before Flop (didn't bet)


PokerStars Game #102598965780:  Hold'em No Limit ($3/$6 USD) - 2013/08/11 6:37:39 ET
Table 'Lorcia IV 40-100 bb' 6-max Seat #1 is the button
Seat 1: ZarubaNT ($692.11 in chips) 
Seat 2: GERAKLmeat ($596.11 in chips) 
Seat 3: khlaus ($619.24 in chips) 
Seat 4: vjxbkf ($600 in chips) 
Seat 6: d`svictoriae ($631.60 in chips) 
GERAKLmeat: posts small blind $3
khlaus: posts big blind $6
DuckinF0nk: sits out 
*** HOLE CARDS ***
vjxbkf: folds 
d`svictoriae: raises $6 to $12
ZarubaNT: folds 
GERAKLmeat: raises $18 to $30
khlaus: folds 
d`svictoriae: calls $18
*** FLOP *** [Jc Kd 3d]
GERAKLmeat: bets $32.23
d`svictoriae: calls $32.23
*** TURN *** [Jc Kd 3d] [Td]
GERAKLmeat: bets $65.10
d`svictoriae: folds 
Uncalled bet ($65.10) returned to GERAKLmeat
GERAKLmeat collected $127.66 from pot
GERAKLmeat: doesn't show hand 
*** SUMMARY ***
Total pot $130.46 | Rake $2.80 
Board [Jc Kd 3d Td]
Seat 1: ZarubaNT (button) folded before Flop (didn't bet)
Seat 2: GERAKLmeat (small blind) collected ($127.66)
Seat 3: khlaus (big blind) folded before Flop
Seat 4: vjxbkf folded before Flop (didn't bet)
Seat 6: d`svictoriae folded on the Turn


PokerStars Game #102598993725:  Hold'em No Limit ($3/$6 USD) - 2013/08/11 6:38:43 ET
Table 'Lorcia IV 40-100 bb' 6-max Seat #2 is the button
Seat 1: ZarubaNT ($692.11 in chips) 
Seat 2: GERAKLmeat ($661.54 in chips) 
Seat 3: khlaus ($613.24 in chips) 
Seat 4: vjxbkf ($600 in chips) 
Seat 6: d`svictoriae ($569.37 in chips) 
khlaus: posts small blind $3
vjxbkf: posts big blind $6
DuckinF0nk: sits out 
*** HOLE CARDS ***
d`svictoriae: folds 
ZarubaNT: folds 
GERAKLmeat: raises $6 to $12
khlaus: folds 
vjxbkf: folds 
Uncalled bet ($6) returned to GERAKLmeat
GERAKLmeat collected $15 from pot
GERAKLmeat: doesn't show hand 
*** SUMMARY ***
Total pot $15 | Rake $0 
Seat 1: ZarubaNT folded before Flop (didn't bet)
Seat 2: GERAKLmeat (button) collected ($15)
Seat 3: khlaus (small blind) folded before Flop
Seat 4: vjxbkf (big blind) folded before Flop
Seat 6: d`svictoriae folded before Flop (didn't bet)


PokerStars Game #102599002148:  Hold'em No Limit ($3/$6 USD) - 2013/08/11 6:39:03 ET
Table 'Lorcia IV 40-100 bb' 6-max Seat #3 is the button
Seat 1: ZarubaNT ($692.11 in chips) 
Seat 2: GERAKLmeat ($670.54 in chips) 
Seat 3: khlaus ($610.24 in chips) 
Seat 4: vjxbkf ($600 in chips) 
Seat 5: DuckinF0nk ($952.17 in chips) 
Seat 6: d`svictoriae ($569.37 in chips) 
vjxbkf: posts small blind $3
DuckinF0nk: posts big blind $6
*** HOLE CARDS ***
d`svictoriae: raises $6 to $12
ZarubaNT: folds 
GERAKLmeat: folds 
khlaus: folds 
vjxbkf: folds 
DuckinF0nk: folds 
Uncalled bet ($6) returned to d`svictoriae
d`svictoriae collected $15 from pot
d`svictoriae: doesn't show hand 
*** SUMMARY ***
Total pot $15 | Rake $0 
Seat 1: ZarubaNT folded before Flop (didn't bet)
Seat 2: GERAKLmeat folded before Flop (didn't bet)
Seat 3: khlaus (button) folded before Flop (didn't bet)
Seat 4: vjxbkf (small blind) folded before Flop
Seat 5: DuckinF0nk (big blind) folded before Flop
Seat 6: d`svictoriae collected ($15)


PokerStars Game #102599014599:  Hold'em No Limit ($3/$6 USD) - 2013/08/11 6:39:32 ET
Table 'Lorcia IV 40-100 bb' 6-max Seat #4 is the button
Seat 1: ZarubaNT ($692.11 in chips) 
Seat 2: GERAKLmeat ($670.54 in chips) 
Seat 3: khlaus ($610.24 in chips) 
Seat 4: vjxbkf ($600 in chips) 
Seat 5: DuckinF0nk ($946.17 in chips) 
Seat 6: d`svictoriae ($578.37 in chips) 
DuckinF0nk: posts small blind $3
d`svictoriae: posts big blind $6
*** HOLE CARDS ***
ZarubaNT: raises $12 to $18
GERAKLmeat: folds 
khlaus: folds 
vjxbkf: folds 
DuckinF0nk: folds 
d`svictoriae: folds 
Uncalled bet ($12) returned to ZarubaNT
ZarubaNT collected $15 from pot
ZarubaNT: doesn't show hand 
*** SUMMARY ***
Total pot $15 | Rake $0 
Seat 1: ZarubaNT collected ($15)
Seat 2: GERAKLmeat folded before Flop (didn't bet)
Seat 3: khlaus folded before Flop (didn't bet)
Seat 4: vjxbkf (button) folded before Flop (didn't bet)
Seat 5: DuckinF0nk (small blind) folded before Flop
Seat 6: d`svictoriae (big blind) folded before Flop


PokerStars Game #102598776205:  Hold'em No Limit ($3/$6 USD) - 2013/08/11 6:30:21 ET
Table 'Lorcia IV 40-100 bb' 6-max Seat #4 is the button
Seat 1: ZarubaNT ($716.11 in chips) 
Seat 2: GERAKLmeat ($596.16 in chips) 
Seat 3: khlaus ($627.98 in chips) 
Seat 4: vjxbkf ($600 in chips) 
Seat 6: d`svictoriae ($588.07 in chips) 
d`svictoriae: posts small blind $3
ZarubaNT: posts big blind $6
*** HOLE CARDS ***
GERAKLmeat: raises $6 to $12
khlaus: folds 
vjxbkf: folds 
d`svictoriae: calls $9
ZarubaNT: folds 
*** FLOP *** [6c 5s 9h]
d`svictoriae: checks 
GERAKLmeat: bets $14.61
d`svictoriae: calls $14.61
*** TURN *** [6c 5s 9h] [Ah]
d`svictoriae: checks 
GERAKLmeat: checks 
*** RIVER *** [6c 5s 9h Ah] [8c]
d`svictoriae: checks 
GERAKLmeat: bets $45
d`svictoriae: folds 
Uncalled bet ($45) returned to GERAKLmeat
GERAKLmeat collected $56.56 from pot
GERAKLmeat: doesn't show hand 
*** SUMMARY ***
Total pot $59.22 | Rake $2.66 
Board [6c 5s 9h Ah 8c]
Seat 1: ZarubaNT (big blind) folded before Flop
Seat 2: GERAKLmeat collected ($56.56)
Seat 3: khlaus folded before Flop (didn't bet)
Seat 4: vjxbkf (button) folded before Flop (didn't bet)
Seat 6: d`svictoriae (small blind) folded on the River


PokerStars Game #102598805260:  Hold'em No Limit ($3/$6 USD) - 2013/08/11 6:31:28 ET
Table 'Lorcia IV 40-100 bb' 6-max Seat #6 is the button
Seat 1: ZarubaNT ($710.11 in chips) 
Seat 2: GERAKLmeat ($626.11 in chips) 
Seat 3: khlaus ($627.98 in chips) 
Seat 4: vjxbkf ($600 in chips) 
Seat 6: d`svictoriae ($561.46 in chips) 
ZarubaNT: posts small blind $3
GERAKLmeat: posts big blind $6
*** HOLE CARDS ***
khlaus: raises $12 to $18
vjxbkf: folds 
d`svictoriae: calls $18
ZarubaNT: folds 
GERAKLmeat: calls $12
*** FLOP *** [Jc Ts Ac]
GERAKLmeat: checks 
khlaus: checks 
d`svictoriae: checks 
*** TURN *** [Jc Ts Ac] [5c]
GERAKLmeat: checks 
khlaus: checks 
d`svictoriae: bets $24
GERAKLmeat: folds 
khlaus: folds 
Uncalled bet ($24) returned to d`svictoriae
d`svictoriae collected $54.44 from pot
d`svictoriae: doesn't show hand 
*** SUMMARY ***
Total pot $57 | Rake $2.56 
Board [Jc Ts Ac 5c]
Seat 1: ZarubaNT (small blind) folded before Flop
Seat 2: GERAKLmeat (big blind) folded on the Turn
Seat 3: khlaus folded on the Turn
Seat 4: vjxbkf folded before Flop (didn't bet)
Seat 6: d`svictoriae (button) collected ($54.44)


PokerStars Game #102598831931:  Hold'em No Limit ($3/$6 USD) - 2013/08/11 6:32:30 ET
Table 'Lorcia IV 40-100 bb' 6-max Seat #1 is the button
Seat 1: ZarubaNT ($707.11 in chips) 
Seat 2: GERAKLmeat ($608.11 in chips) 
Seat 3: khlaus ($609.98 in chips) 
Seat 4: vjxbkf ($600 in chips) 
Seat 6: d`svictoriae ($597.90 in chips) 
GERAKLmeat: posts small blind $3
khlaus: posts big blind $6
*** HOLE CARDS ***
vjxbkf: folds 
d`svictoriae: raises $6 to $12
ZarubaNT: folds 
GERAKLmeat: folds 
khlaus: folds 
Uncalled bet ($6) returned to d`svictoriae
d`svictoriae collected $15 from pot
d`svictoriae: doesn't show hand 
*** SUMMARY ***
Total pot $15 | Rake $0 
Seat 1: ZarubaNT (button) folded before Flop (didn't bet)
Seat 2: GERAKLmeat (small blind) folded before Flop
Seat 3: khlaus (big blind) folded before Flop
Seat 4: vjxbkf folded before Flop (didn't bet)
Seat 6: d`svictoriae collected ($15)


PokerStars Game #102598843318:  Hold'em No Limit ($3/$6 USD) - 2013/08/11 6:32:56 ET
Table 'Lorcia IV 40-100 bb' 6-max Seat #2 is the button
Seat 1: ZarubaNT ($707.11 in chips) 
Seat 2: GERAKLmeat ($605.11 in chips) 
Seat 3: khlaus ($603.98 in chips) 
Seat 4: vjxbkf ($600 in chips) 
Seat 6: d`svictoriae ($606.90 in chips) 
khlaus: posts small blind $3
vjxbkf: posts big blind $6
*** HOLE CARDS ***
d`svictoriae: folds 
ZarubaNT: folds 
GERAKLmeat: raises $6 to $12
khlaus: folds 
vjxbkf: folds 
Uncalled bet ($6) returned to GERAKLmeat
GERAKLmeat collected $15 from pot
GERAKLmeat: doesn't show hand 
*** SUMMARY ***
Total pot $15 | Rake $0 
Seat 1: ZarubaNT folded before Flop (didn't bet)
Seat 2: GERAKLmeat (button) collected ($15)
Seat 3: khlaus (small blind) folded before Flop
Seat 4: vjxbkf (big blind) folded before Flop
Seat 6: d`svictoriae folded before Flop (didn't bet)


PokerStars Game #102598852316:  Hold'em No Limit ($3/$6 USD) - 2013/08/11 6:33:17 ET
Table 'Lorcia IV 40-100 bb' 6-max Seat #3 is the button
Seat 1: ZarubaNT ($707.11 in chips) 
Seat 2: GERAKLmeat ($614.11 in chips) 
Seat 3: khlaus ($600.98 in chips) 
Seat 4: vjxbkf ($600 in chips) 
Seat 6: d`svictoriae ($606.90 in chips) 
vjxbkf: posts small blind $3
d`svictoriae: posts big blind $6
*** HOLE CARDS ***
ZarubaNT: folds 
GERAKLmeat: folds 
khlaus: raises $6 to $12
vjxbkf: folds 
d`svictoriae: calls $6
*** FLOP *** [2c Ad 6s]
d`svictoriae: checks 
khlaus: checks 
*** TURN *** [2c Ad 6s] [Ac]
d`svictoriae: checks 
khlaus: checks 
*** RIVER *** [2c Ad 6s Ac] [4c]
d`svictoriae: bets $12
khlaus: folds 
Uncalled bet ($12) returned to d`svictoriae
d`svictoriae collected $25.78 from pot
d`svictoriae: doesn't show hand 
*** SUMMARY ***
Total pot $27 | Rake $1.22 
Board [2c Ad 6s Ac 4c]
Seat 1: ZarubaNT folded before Flop (didn't bet)
Seat 2: GERAKLmeat folded before Flop (didn't bet)
Seat 3: khlaus (button) folded on the River
Seat 4: vjxbkf (small blind) folded before Flop
Seat 6: d`svictoriae (big blind) collected ($25.78)


PokerStars Game #102598883118:  Hold'em No Limit ($3/$6 USD) - 2013/08/11 6:34:29 ET
Table 'Lorcia IV 40-100 bb' 6-max Seat #4 is the button
Seat 1: ZarubaNT ($707.11 in chips) 
Seat 2: GERAKLmeat ($614.11 in chips) 
Seat 3: khlaus ($600 in chips) 
Seat 4: vjxbkf ($600 in chips) 
Seat 6: d`svictoriae ($620.68 in chips) 
DuckinF0nk will be allowed to play after the button
d`svictoriae: posts small blind $3
ZarubaNT: posts big blind $6
*** HOLE CARDS ***
GERAKLmeat: folds 
khlaus: folds 
vjxbkf: folds 
d`svictoriae: raises $6 to $12
ZarubaNT: calls $6
*** FLOP *** [3s Jc Jh]
d`svictoriae: checks 
ZarubaNT: checks 
*** TURN *** [3s Jc Jh] [4c]
d`svictoriae: checks 
ZarubaNT: checks 
*** RIVER *** [3s Jc Jh 4c] [8c]
d`svictoriae: checks 
ZarubaNT: checks 
*** SHOW DOWN ***
d`svictoriae: shows [8h Qh] (two pair, Jacks and Eights)
ZarubaNT: mucks hand 
d`svictoriae collected $22.92 from pot
*** SUMMARY ***
Total pot $24 | Rake $1.08 
Board [3s Jc Jh 4c 8c]
Seat 1: ZarubaNT (big blind) mucked
Seat 2: GERAKLmeat folded before Flop (didn't bet)
Seat 3: khlaus folded before Flop (didn't bet)
Seat 4: vjxbkf (button) folded before Flop (didn't bet)
Seat 6: d`svictoriae (small blind) showed [8h Qh] and won ($22.92) with two pair, Jacks and Eights


PokerStars Game #102599300053:  Hold'em No Limit ($3/$6 USD) - 2013/08/11 6:50:05 ET
Table 'Lorcia IV 40-100 bb' 6-max Seat #1 is the button
Seat 1: ZarubaNT ($753.83 in chips) 
Seat 2: GERAKLmeat ($720.26 in chips) 
Seat 3: khlaus ($628.79 in chips) 
Seat 5: DuckinF0nk ($850.17 in chips) 
Seat 6: d`svictoriae ($477.49 in chips) 
GERAKLmeat: posts small blind $3
khlaus: posts big blind $6
*** HOLE CARDS ***
DuckinF0nk: folds 
d`svictoriae: raises $6 to $12
ZarubaNT: folds 
GERAKLmeat: folds 
khlaus: calls $6
*** FLOP *** [9d Qs 8s]
khlaus: bets $18
d`svictoriae: calls $18
*** TURN *** [9d Qs 8s] [9c]
khlaus: checks 
d`svictoriae: checks 
*** RIVER *** [9d Qs 8s 9c] [5c]
khlaus: checks 
d`svictoriae: checks 
*** SHOW DOWN ***
khlaus: shows [7d Td] (a pair of Nines)
d`svictoriae: shows [8c Jc] (two pair, Nines and Eights)
d`svictoriae collected $60.20 from pot
*** SUMMARY ***
Total pot $63 | Rake $2.80 
Board [9d Qs 8s 9c 5c]
Seat 1: ZarubaNT (button) folded before Flop (didn't bet)
Seat 2: GERAKLmeat (small blind) folded before Flop
Seat 3: khlaus (big blind) showed [7d Td] and lost with a pair of Nines
Seat 5: DuckinF0nk folded before Flop (didn't bet)
Seat 6: d`svictoriae showed [8c Jc] and won ($60.20) with two pair, Nines and Eights


PokerStars Game #102599319015:  Hold'em No Limit ($3/$6 USD) - 2013/08/11 6:50:47 ET
Table 'Lorcia IV 40-100 bb' 6-max Seat #2 is the button
Seat 1: ZarubaNT ($753.83 in chips) 
Seat 2: GERAKLmeat ($717.26 in chips) 
Seat 3: khlaus ($600 in chips) 
Seat 5: DuckinF0nk ($850.17 in chips) 
Seat 6: d`svictoriae ($507.69 in chips) 
khlaus: posts small blind $3
DuckinF0nk: posts big blind $6
*** HOLE CARDS ***
d`svictoriae: raises $6 to $12
ZarubaNT: folds 
GERAKLmeat: folds 
khlaus: folds 
vjxbkf leaves the table
DuckinF0nk: raises $33 to $45
JulyShort joins the table at seat #4 
d`svictoriae: folds 
Uncalled bet ($33) returned to DuckinF0nk
DuckinF0nk collected $27 from pot
DuckinF0nk: doesn't show hand 
*** SUMMARY ***
Total pot $27 | Rake $0 
Seat 1: ZarubaNT folded before Flop (didn't bet)
Seat 2: GERAKLmeat (button) folded before Flop (didn't bet)
Seat 3: khlaus (small blind) folded before Flop
Seat 5: DuckinF0nk (big blind) collected ($27)
Seat 6: d`svictoriae folded before Flop


PokerStars Game #102599335984:  Hold'em No Limit ($3/$6 USD) - 2013/08/11 6:51:24 ET
Table 'Lorcia IV 40-100 bb' 6-max Seat #3 is the button
Seat 1: ZarubaNT ($753.83 in chips) 
Seat 2: GERAKLmeat ($717.26 in chips) 
Seat 3: khlaus ($600 in chips) 
Seat 5: DuckinF0nk ($865.17 in chips) 
Seat 6: d`svictoriae ($495.69 in chips) 
JulyShort will be allowed to play after the button
DuckinF0nk: posts small blind $3
d`svictoriae: posts big blind $6
*** HOLE CARDS ***
ZarubaNT: folds 
GERAKLmeat: raises $6 to $12
khlaus: calls $12
DuckinF0nk: raises $45 to $57
d`svictoriae: folds 
GERAKLmeat: calls $45
khlaus: folds 
*** FLOP *** [Ks 3d 3c]
DuckinF0nk: bets $69
GERAKLmeat: raises $69 to $138
DuckinF0nk: raises $81 to $219
GERAKLmeat: calls $81
*** TURN *** [Ks 3d 3c] [Ah]
DuckinF0nk: bets $126
GERAKLmeat: calls $126
*** RIVER *** [Ks 3d 3c Ah] [Tc]
JulyShort leaves the table
DuckinF0nk: bets $463.17 and is all-in
GERAKLmeat: calls $315.26 and is all-in
Uncalled bet ($147.91) returned to DuckinF0nk
*** SHOW DOWN ***
DuckinF0nk: shows [Qc Kh] (two pair, Kings and Threes)
GERAKLmeat: shows [Ts As] (two pair, Aces and Tens)
GERAKLmeat collected $1449.72 from pot
*** SUMMARY ***
Total pot $1452.52 | Rake $2.80 
Board [Ks 3d 3c Ah Tc]
Seat 1: ZarubaNT folded before Flop (didn't bet)
Seat 2: GERAKLmeat showed [Ts As] and won ($1449.72) with two pair, Aces and Tens
Seat 3: khlaus (button) folded before Flop
Seat 5: DuckinF0nk (small blind) showed [Qc Kh] and lost with two pair, Kings and Threes
Seat 6: d`svictoriae (big blind) folded before Flop


PokerStars Game #102599365638:  Hold'em No Limit ($3/$6 USD) - 2013/08/11 6:52:30 ET
Table 'Lorcia IV 40-100 bb' 6-max Seat #5 is the button
Seat 1: ZarubaNT ($753.83 in chips) 
Seat 2: GERAKLmeat ($1449.72 in chips) 
Seat 3: khlaus ($600 in chips) 
Seat 5: DuckinF0nk ($600 in chips) 
Seat 6: d`svictoriae ($489.69 in chips) 
d`svictoriae: posts small blind $3
ZarubaNT: posts big blind $6
*** HOLE CARDS ***
GERAKLmeat: folds 
khlaus: folds 
DuckinF0nk: folds 
d`svictoriae: raises $6 to $12
ZarubaNT: calls $6
*** FLOP *** [7d 2c Ks]
Alpha 5.20 joins the table at seat #4 
d`svictoriae: bets $18
ZarubaNT: folds 
Uncalled bet ($18) returned to d`svictoriae
d`svictoriae collected $22.92 from pot
d`svictoriae: doesn't show hand 
*** SUMMARY ***
Total pot $24 | Rake $1.08 
Board [7d 2c Ks]
Seat 1: ZarubaNT (big blind) folded on the Flop
Seat 2: GERAKLmeat folded before Flop (didn't bet)
Seat 3: khlaus folded before Flop (didn't bet)
Seat 5: DuckinF0nk (button) folded before Flop (didn't bet)
Seat 6: d`svictoriae (small blind) collected ($22.92)


PokerStars Game #102599376992:  Hold'em No Limit ($3/$6 USD) - 2013/08/11 6:52:55 ET
Table 'Lorcia IV 40-100 bb' 6-max Seat #6 is the button
Seat 1: ZarubaNT ($741.83 in chips) 
Seat 2: GERAKLmeat ($1449.72 in chips) 
Seat 3: khlaus ($600 in chips) 
Seat 5: DuckinF0nk ($600 in chips) 
Seat 6: d`svictoriae ($500.61 in chips) 
ZarubaNT: posts small blind $3
GERAKLmeat: posts big blind $6
Alpha 5.20: sits out 
*** HOLE CARDS ***
khlaus: folds 
DuckinF0nk: folds 
d`svictoriae: folds 
ZarubaNT: folds 
Uncalled bet ($3) returned to GERAKLmeat
GERAKLmeat collected $6 from pot
GERAKLmeat: doesn't show hand 
*** SUMMARY ***
Total pot $6 | Rake $0 
Seat 1: ZarubaNT (small blind) folded before Flop
Seat 2: GERAKLmeat (big blind) collected ($6)
Seat 3: khlaus folded before Flop (didn't bet)
Seat 5: DuckinF0nk folded before Flop (didn't bet)
Seat 6: d`svictoriae (button) folded before Flop (didn't bet)


PokerStars Game #102599380983:  Hold'em No Limit ($3/$6 USD) - 2013/08/11 6:53:04 ET
Table 'Lorcia IV 40-100 bb' 6-max Seat #1 is the button
Seat 1: ZarubaNT ($738.83 in chips) 
Seat 2: GERAKLmeat ($1452.72 in chips) 
Seat 3: khlaus ($600 in chips) 
Seat 5: DuckinF0nk ($600 in chips) 
Seat 6: d`svictoriae ($500.61 in chips) 
GERAKLmeat: posts small blind $3
khlaus: posts big blind $6
Alpha 5.20: sits out 
*** HOLE CARDS ***
DuckinF0nk: folds 
d`svictoriae: folds 
ZarubaNT: folds 
GERAKLmeat: raises $6 to $12
khlaus: calls $6
*** FLOP *** [7h Ts 4d]
GERAKLmeat: bets $11.68
khlaus: raises $25.32 to $37
GERAKLmeat: folds 
Uncalled bet ($25.32) returned to khlaus
khlaus collected $45.23 from pot
khlaus: doesn't show hand 
*** SUMMARY ***
Total pot $47.36 | Rake $2.13 
Board [7h Ts 4d]
Seat 1: ZarubaNT (button) folded before Flop (didn't bet)
Seat 2: GERAKLmeat (small blind) folded on the Flop
Seat 3: khlaus (big blind) collected ($45.23)
Seat 5: DuckinF0nk folded before Flop (didn't bet)
Seat 6: d`svictoriae folded before Flop (didn't bet)


PokerStars Game #102599398649:  Hold'em No Limit ($3/$6 USD) - 2013/08/11 6:53:42 ET
Table 'Lorcia IV 40-100 bb' 6-max Seat #2 is the button
Seat 1: ZarubaNT ($738.83 in chips) 
Seat 2: GERAKLmeat ($1429.04 in chips) 
Seat 3: khlaus ($621.55 in chips) 
Seat 4: Alpha 5.20 ($600 in chips) 
Seat 5: DuckinF0nk ($600 in chips) 
Seat 6: d`svictoriae ($500.61 in chips) 
khlaus: posts small blind $3
Alpha 5.20: posts big blind $6
*** HOLE CARDS ***
DuckinF0nk: folds 
d`svictoriae: folds 
ZarubaNT: folds 
GERAKLmeat: raises $6 to $12
khlaus: folds 
Alpha 5.20: raises $36 to $48
GERAKLmeat: calls $36
*** FLOP *** [Kh Tc 9h]
Alpha 5.20: bets $60
GERAKLmeat: folds 
Uncalled bet ($60) returned to Alpha 5.20
Alpha 5.20 collected $96.20 from pot
Alpha 5.20: doesn't show hand 
*** SUMMARY ***
Total pot $99 | Rake $2.80 
Board [Kh Tc 9h]
Seat 1: ZarubaNT folded before Flop (didn't bet)
Seat 2: GERAKLmeat (button) folded on the Flop
Seat 3: khlaus (small blind) folded before Flop
Seat 4: Alpha 5.20 (big blind) collected ($96.20)
Seat 5: DuckinF0nk folded before Flop (didn't bet)
Seat 6: d`svictoriae folded before Flop (didn't bet)


PokerStars Game #102599422014:  Hold'em No Limit ($3/$6 USD) - 2013/08/11 6:54:35 ET
Table 'Lorcia IV 40-100 bb' 6-max Seat #3 is the button
Seat 1: ZarubaNT ($738.83 in chips) 
Seat 2: GERAKLmeat ($1381.04 in chips) 
Seat 3: khlaus ($618.55 in chips) 
Seat 4: Alpha 5.20 ($648.20 in chips) 
Seat 5: DuckinF0nk ($600 in chips) 
Seat 6: d`svictoriae ($500.61 in chips) 
Alpha 5.20: posts small blind $3
DuckinF0nk: posts big blind $6
*** HOLE CARDS ***
d`svictoriae: raises $6 to $12
ZarubaNT: folds 
GERAKLmeat: folds 
khlaus: folds 
Alpha 5.20: folds 
DuckinF0nk: folds 
Uncalled bet ($6) returned to d`svictoriae
d`svictoriae collected $15 from pot
d`svictoriae: doesn't show hand 
*** SUMMARY ***
Total pot $15 | Rake $0 
Seat 1: ZarubaNT folded before Flop (didn't bet)
Seat 2: GERAKLmeat folded before Flop (didn't bet)
Seat 3: khlaus (button) folded before Flop (didn't bet)
Seat 4: Alpha 5.20 (small blind) folded before Flop
Seat 5: DuckinF0nk (big blind) folded before Flop
Seat 6: d`svictoriae collected ($15)


PokerStars Game #102599431269:  Hold'em No Limit ($3/$6 USD) - 2013/08/11 6:54:55 ET
Table 'Lorcia IV 40-100 bb' 6-max Seat #4 is the button
Seat 1: ZarubaNT ($738.83 in chips) 
Seat 2: GERAKLmeat ($1381.04 in chips) 
Seat 3: khlaus ($618.55 in chips) 
Seat 4: Alpha 5.20 ($645.20 in chips) 
Seat 5: DuckinF0nk ($600 in chips) 
Seat 6: d`svictoriae ($509.61 in chips) 
DuckinF0nk: posts small blind $3
d`svictoriae: posts big blind $6
*** HOLE CARDS ***
ZarubaNT: folds 
GERAKLmeat: folds 
khlaus: folds 
Alpha 5.20: raises $6 to $12
DuckinF0nk: folds 
d`svictoriae: folds 
Uncalled bet ($6) returned to Alpha 5.20
Alpha 5.20 collected $15 from pot
Alpha 5.20: doesn't show hand 
*** SUMMARY ***
Total pot $15 | Rake $0 
Seat 1: ZarubaNT folded before Flop (didn't bet)
Seat 2: GERAKLmeat folded before Flop (didn't bet)
Seat 3: khlaus folded before Flop (didn't bet)
Seat 4: Alpha 5.20 (button) collected ($15)
Seat 5: DuckinF0nk (small blind) folded before Flop
Seat 6: d`svictoriae (big blind) folded before Flop


PokerStars Game #102599190738:  Hold'em No Limit ($3/$6 USD) - 2013/08/11 6:46:03 ET
Table 'Lorcia IV 40-100 bb' 6-max Seat #6 is the button
Seat 1: ZarubaNT ($756.83 in chips) 
Seat 2: GERAKLmeat ($603.78 in chips) 
Seat 3: khlaus ($628.79 in chips) 
Seat 4: vjxbkf ($666.06 in chips) 
Seat 5: DuckinF0nk ($895.17 in chips) 
Seat 6: d`svictoriae ($554.37 in chips) 
ZarubaNT: posts small blind $3
GERAKLmeat: posts big blind $6
*** HOLE CARDS ***
khlaus: folds 
vjxbkf: folds 
DuckinF0nk: folds 
d`svictoriae: raises $6 to $12
ZarubaNT: folds 
GERAKLmeat: calls $6
*** FLOP *** [4c 5h 8h]
GERAKLmeat: bets $13.14
d`svictoriae: raises $13.14 to $26.28
GERAKLmeat: calls $13.14
*** TURN *** [4c 5h 8h] [6d]
GERAKLmeat: checks 
d`svictoriae: bets $54
GERAKLmeat: calls $54
*** RIVER *** [4c 5h 8h 6d] [Qd]
GERAKLmeat: checks 
d`svictoriae: bets $90
GERAKLmeat: raises $421.50 to $511.50 and is all-in
d`svictoriae: folds 
Uncalled bet ($421.50) returned to GERAKLmeat
GERAKLmeat collected $364.76 from pot
GERAKLmeat: doesn't show hand 
*** SUMMARY ***
Total pot $367.56 | Rake $2.80 
Board [4c 5h 8h 6d Qd]
Seat 1: ZarubaNT (small blind) folded before Flop
Seat 2: GERAKLmeat (big blind) collected ($364.76)
Seat 3: khlaus folded before Flop (didn't bet)
Seat 4: vjxbkf folded before Flop (didn't bet)
Seat 5: DuckinF0nk folded before Flop (didn't bet)
Seat 6: d`svictoriae (button) folded on the River


PokerStars Game #102599231764:  Hold'em No Limit ($3/$6 USD) - 2013/08/11 6:47:34 ET
Table 'Lorcia IV 40-100 bb' 6-max Seat #1 is the button
Seat 1: ZarubaNT ($753.83 in chips) 
Seat 2: GERAKLmeat ($786.26 in chips) 
Seat 3: khlaus ($628.79 in chips) 
Seat 4: vjxbkf ($666.06 in chips) 
Seat 5: DuckinF0nk ($895.17 in chips) 
Seat 6: d`svictoriae ($372.09 in chips) 
GERAKLmeat: posts small blind $3
khlaus: posts big blind $6
*** HOLE CARDS ***
vjxbkf: folds 
DuckinF0nk: folds 
d`svictoriae: raises $6 to $12
ZarubaNT: folds 
GERAKLmeat: raises $18 to $30
khlaus: folds 
d`svictoriae: raises $30 to $60
GERAKLmeat: calls $30
*** FLOP *** [Th Kh 2d]
GERAKLmeat: checks 
d`svictoriae: checks 
*** TURN *** [Th Kh 2d] [2s]
GERAKLmeat: checks 
d`svictoriae: checks 
*** RIVER *** [Th Kh 2d 2s] [Qs]
GERAKLmeat: checks 
d`svictoriae: checks 
*** SHOW DOWN ***
GERAKLmeat: shows [Jc 8c] (a pair of Deuces)
d`svictoriae: shows [9s Ah] (a pair of Deuces - Ace kicker)
d`svictoriae collected $123.20 from pot
*** SUMMARY ***
Total pot $126 | Rake $2.80 
Board [Th Kh 2d 2s Qs]
Seat 1: ZarubaNT (button) folded before Flop (didn't bet)
Seat 2: GERAKLmeat (small blind) showed [Jc 8c] and lost with a pair of Deuces
Seat 3: khlaus (big blind) folded before Flop
Seat 4: vjxbkf folded before Flop (didn't bet)
Seat 5: DuckinF0nk folded before Flop (didn't bet)
Seat 6: d`svictoriae showed [9s Ah] and won ($123.20) with a pair of Deuces


PokerStars Game #102599258539:  Hold'em No Limit ($3/$6 USD) - 2013/08/11 6:48:33 ET
Table 'Lorcia IV 40-100 bb' 6-max Seat #2 is the button
Seat 1: ZarubaNT ($753.83 in chips) 
Seat 2: GERAKLmeat ($726.26 in chips) 
Seat 3: khlaus ($622.79 in chips) 
Seat 5: DuckinF0nk ($895.17 in chips) 
Seat 6: d`svictoriae ($435.29 in chips) 
khlaus: posts small blind $3
vjxbkf: is sitting out 
DuckinF0nk: posts big blind $6
*** HOLE CARDS ***
d`svictoriae: folds 
ZarubaNT: raises $9 to $15
GERAKLmeat: folds 
khlaus: folds 
DuckinF0nk: folds 
Uncalled bet ($9) returned to ZarubaNT
ZarubaNT collected $15 from pot
ZarubaNT: doesn't show hand 
*** SUMMARY ***
Total pot $15 | Rake $0 
Seat 1: ZarubaNT collected ($15)
Seat 2: GERAKLmeat (button) folded before Flop (didn't bet)
Seat 3: khlaus (small blind) folded before Flop
Seat 5: DuckinF0nk (big blind) folded before Flop
Seat 6: d`svictoriae folded before Flop (didn't bet)


PokerStars Game #102599266222:  Hold'em No Limit ($3/$6 USD) - 2013/08/11 6:48:50 ET
Table 'Lorcia IV 40-100 bb' 6-max Seat #3 is the button
Seat 1: ZarubaNT ($762.83 in chips) 
Seat 2: GERAKLmeat ($726.26 in chips) 
Seat 3: khlaus ($619.79 in chips) 
Seat 5: DuckinF0nk ($889.17 in chips) 
Seat 6: d`svictoriae ($435.29 in chips) 
DuckinF0nk: posts small blind $3
d`svictoriae: posts big blind $6
*** HOLE CARDS ***
ZarubaNT: folds 
GERAKLmeat: folds 
khlaus: raises $12 to $18
DuckinF0nk: folds 
d`svictoriae: folds 
Uncalled bet ($12) returned to khlaus
khlaus collected $15 from pot
khlaus: doesn't show hand 
*** SUMMARY ***
Total pot $15 | Rake $0 
Seat 1: ZarubaNT folded before Flop (didn't bet)
Seat 2: GERAKLmeat folded before Flop (didn't bet)
Seat 3: khlaus (button) collected ($15)
Seat 5: DuckinF0nk (small blind) folded before Flop
Seat 6: d`svictoriae (big blind) folded before Flop


PokerStars Game #102599272703:  Hold'em No Limit ($3/$6 USD) - 2013/08/11 6:49:05 ET
Table 'Lorcia IV 40-100 bb' 6-max Seat #5 is the button
Seat 1: ZarubaNT ($762.83 in chips) 
Seat 2: GERAKLmeat ($726.26 in chips) 
Seat 3: khlaus ($628.79 in chips) 
Seat 5: DuckinF0nk ($886.17 in chips) 
Seat 6: d`svictoriae ($429.29 in chips) 
d`svictoriae: posts small blind $3
ZarubaNT: posts big blind $6
*** HOLE CARDS ***
GERAKLmeat: folds 
khlaus: folds 
DuckinF0nk: raises $9 to $15
d`svictoriae: calls $12
ZarubaNT: folds 
*** FLOP *** [Tc 4s 4c]
d`svictoriae: checks 
DuckinF0nk: bets $21
d`svictoriae: raises $21 to $42
DuckinF0nk: folds 
Uncalled bet ($21) returned to d`svictoriae
d`svictoriae collected $75.20 from pot
d`svictoriae: doesn't show hand 
*** SUMMARY ***
Total pot $78 | Rake $2.80 
Board [Tc 4s 4c]
Seat 1: ZarubaNT (big blind) folded before Flop
Seat 2: GERAKLmeat folded before Flop (didn't bet)
Seat 3: khlaus folded before Flop (didn't bet)
Seat 5: DuckinF0nk (button) folded on the Flop
Seat 6: d`svictoriae (small blind) collected ($75.20)


PokerStars Game #102599292072:  Hold'em No Limit ($3/$6 USD) - 2013/08/11 6:49:47 ET
Table 'Lorcia IV 40-100 bb' 6-max Seat #6 is the button
Seat 1: ZarubaNT ($756.83 in chips) 
Seat 2: GERAKLmeat ($726.26 in chips) 
Seat 3: khlaus ($628.79 in chips) 
Seat 5: DuckinF0nk ($850.17 in chips) 
Seat 6: d`svictoriae ($468.49 in chips) 
ZarubaNT: posts small blind $3
GERAKLmeat: posts big blind $6
*** HOLE CARDS ***
khlaus: folds 
DuckinF0nk: folds 
d`svictoriae: raises $6 to $12
ZarubaNT: folds 
GERAKLmeat: folds 
Uncalled bet ($6) returned to d`svictoriae
d`svictoriae collected $15 from pot
d`svictoriae: doesn't show hand 
*** SUMMARY ***
Total pot $15 | Rake $0 
Seat 1: ZarubaNT (small blind) folded before Flop
Seat 2: GERAKLmeat (big blind) folded before Flop
Seat 3: khlaus folded before Flop (didn't bet)
Seat 5: DuckinF0nk folded before Flop (didn't bet)
Seat 6: d`svictoriae (button) collected ($15)


PokerStars Game #102599565349:  Hold'em No Limit ($3/$6 USD) - 2013/08/11 7:01:08 ET
Table 'Lorcia IV 40-100 bb' 6-max Seat #1 is the button
Seat 1: ZarubaNT ($714.83 in chips) 
Seat 2: GERAKLmeat ($1283.17 in chips) 
Seat 3: khlaus ($709.54 in chips) 
Seat 4: Alpha 5.20 ($969.40 in chips) 
Seat 5: DuckinF0nk ($621 in chips) 
Seat 6: d`svictoriae ($191.61 in chips) 
GERAKLmeat: posts small blind $3
khlaus: posts big blind $6
*** HOLE CARDS ***
Alpha 5.20: folds 
DuckinF0nk: folds 
d`svictoriae: raises $6 to $12
ZarubaNT: folds 
GERAKLmeat: folds 
khlaus: folds 
Uncalled bet ($6) returned to d`svictoriae
d`svictoriae collected $15 from pot
d`svictoriae: doesn't show hand 
*** SUMMARY ***
Total pot $15 | Rake $0 
Seat 1: ZarubaNT (button) folded before Flop (didn't bet)
Seat 2: GERAKLmeat (small blind) folded before Flop
Seat 3: khlaus (big blind) folded before Flop
Seat 4: Alpha 5.20 folded before Flop (didn't bet)
Seat 5: DuckinF0nk folded before Flop (didn't bet)
Seat 6: d`svictoriae collected ($15)


PokerStars Game #102599573311:  Hold'em No Limit ($3/$6 USD) - 2013/08/11 7:01:28 ET
Table 'Lorcia IV 40-100 bb' 6-max Seat #2 is the button
Seat 1: ZarubaNT ($714.83 in chips) 
Seat 2: GERAKLmeat ($1280.17 in chips) 
Seat 3: khlaus ($703.54 in chips) 
Seat 4: Alpha 5.20 ($969.40 in chips) 
Seat 5: DuckinF0nk ($621 in chips) 
Seat 6: d`svictoriae ($200.61 in chips) 
khlaus: posts small blind $3
Alpha 5.20: posts big blind $6
*** HOLE CARDS ***
DuckinF0nk: folds 
d`svictoriae: folds 
ZarubaNT: folds 
GERAKLmeat: raises $6 to $12
khlaus: raises $18 to $30
Alpha 5.20: raises $60 to $90
GERAKLmeat: folds 
khlaus: folds 
Uncalled bet ($60) returned to Alpha 5.20
Alpha 5.20 collected $72 from pot
Alpha 5.20: doesn't show hand 
*** SUMMARY ***
Total pot $72 | Rake $0 
Seat 1: ZarubaNT folded before Flop (didn't bet)
Seat 2: GERAKLmeat (button) folded before Flop
Seat 3: khlaus (small blind) folded before Flop
Seat 4: Alpha 5.20 (big blind) collected ($72)
Seat 5: DuckinF0nk folded before Flop (didn't bet)
Seat 6: d`svictoriae folded before Flop (didn't bet)


PokerStars Game #102599594620:  Hold'em No Limit ($3/$6 USD) - 2013/08/11 7:02:17 ET
Table 'Lorcia IV 40-100 bb' 6-max Seat #3 is the button
Seat 1: ZarubaNT ($714.83 in chips) 
Seat 2: GERAKLmeat ($1268.17 in chips) 
Seat 3: khlaus ($673.54 in chips) 
Seat 4: Alpha 5.20 ($1011.40 in chips) 
Seat 5: DuckinF0nk ($621 in chips) 
Seat 6: d`svictoriae ($200.61 in chips) 
Alpha 5.20: posts small blind $3
DuckinF0nk: posts big blind $6
*** HOLE CARDS ***
d`svictoriae: folds 
ZarubaNT: raises $12 to $18
GERAKLmeat: folds 
khlaus: folds 
Alpha 5.20: folds 
DuckinF0nk: folds 
Uncalled bet ($12) returned to ZarubaNT
ZarubaNT collected $15 from pot
ZarubaNT: doesn't show hand 
*** SUMMARY ***
Total pot $15 | Rake $0 
Seat 1: ZarubaNT collected ($15)
Seat 2: GERAKLmeat folded before Flop (didn't bet)
Seat 3: khlaus (button) folded before Flop (didn't bet)
Seat 4: Alpha 5.20 (small blind) folded before Flop
Seat 5: DuckinF0nk (big blind) folded before Flop
Seat 6: d`svictoriae folded before Flop (didn't bet)


PokerStars Game #102599603815:  Hold'em No Limit ($3/$6 USD) - 2013/08/11 7:02:37 ET
Table 'Lorcia IV 40-100 bb' 6-max Seat #4 is the button
Seat 1: ZarubaNT ($723.83 in chips) 
Seat 2: GERAKLmeat ($1268.17 in chips) 
Seat 3: khlaus ($673.54 in chips) 
Seat 4: Alpha 5.20 ($1008.40 in chips) 
Seat 5: DuckinF0nk ($615 in chips) 
Seat 6: d`svictoriae ($200.61 in chips) 
DuckinF0nk: posts small blind $3
d`svictoriae: posts big blind $6
*** HOLE CARDS ***
ZarubaNT: folds 
GERAKLmeat: folds 
khlaus: folds 
Alpha 5.20: raises $6 to $12
DuckinF0nk: raises $30 to $42
d`svictoriae: folds 
Alpha 5.20: calls $30
*** FLOP *** [6c 6h Ah]
DuckinF0nk: bets $48
Alpha 5.20: calls $48
*** TURN *** [6c 6h Ah] [3d]
DuckinF0nk: checks 
Alpha 5.20: bets $108
DuckinF0nk: folds 
Uncalled bet ($108) returned to Alpha 5.20
Alpha 5.20 collected $183.20 from pot
Alpha 5.20: doesn't show hand 
*** SUMMARY ***
Total pot $186 | Rake $2.80 
Board [6c 6h Ah 3d]
Seat 1: ZarubaNT folded before Flop (didn't bet)
Seat 2: GERAKLmeat folded before Flop (didn't bet)
Seat 3: khlaus folded before Flop (didn't bet)
Seat 4: Alpha 5.20 (button) collected ($183.20)
Seat 5: DuckinF0nk (small blind) folded on the Turn
Seat 6: d`svictoriae (big blind) folded before Flop


PokerStars Game #102599648757:  Hold'em No Limit ($3/$6 USD) - 2013/08/11 7:04:17 ET
Table 'Lorcia IV 40-100 bb' 6-max Seat #5 is the button
Seat 1: ZarubaNT ($723.83 in chips) 
Seat 2: GERAKLmeat ($1268.17 in chips) 
Seat 3: khlaus ($673.54 in chips) 
Seat 4: Alpha 5.20 ($1101.60 in chips) 
Seat 5: DuckinF0nk ($600 in chips) 
Seat 6: d`svictoriae ($194.61 in chips) 
d`svictoriae: posts small blind $3
ZarubaNT: posts big blind $6
*** HOLE CARDS ***
GERAKLmeat: raises $6 to $12
khlaus: folds 
Alpha 5.20: folds 
DuckinF0nk: folds 
d`svictoriae: calls $9
ZarubaNT: folds 
*** FLOP *** [5c 2c Qs]
d`svictoriae: checks 
GERAKLmeat: bets $14.61
d`svictoriae: folds 
Uncalled bet ($14.61) returned to GERAKLmeat
GERAKLmeat collected $28.65 from pot
GERAKLmeat: doesn't show hand 
*** SUMMARY ***
Total pot $30 | Rake $1.35 
Board [5c 2c Qs]
Seat 1: ZarubaNT (big blind) folded before Flop
Seat 2: GERAKLmeat collected ($28.65)
Seat 3: khlaus folded before Flop (didn't bet)
Seat 4: Alpha 5.20 folded before Flop (didn't bet)
Seat 5: DuckinF0nk (button) folded before Flop (didn't bet)
Seat 6: d`svictoriae (small blind) folded on the Flop


PokerStars Game #102599663817:  Hold'em No Limit ($3/$6 USD) - 2013/08/11 7:04:49 ET
Table 'Lorcia IV 40-100 bb' 6-max Seat #6 is the button
Seat 1: ZarubaNT ($717.83 in chips) 
Seat 2: GERAKLmeat ($1284.82 in chips) 
Seat 3: khlaus ($673.54 in chips) 
Seat 4: Alpha 5.20 ($1101.60 in chips) 
Seat 5: DuckinF0nk ($600 in chips) 
Seat 6: d`svictoriae ($182.61 in chips) 
ZarubaNT: posts small blind $3
GERAKLmeat: posts big blind $6
*** HOLE CARDS ***
khlaus: folds 
Alpha 5.20: folds 
DuckinF0nk: folds 
d`svictoriae: folds 
ZarubaNT: folds 
Uncalled bet ($3) returned to GERAKLmeat
GERAKLmeat collected $6 from pot
GERAKLmeat: doesn't show hand 
*** SUMMARY ***
Total pot $6 | Rake $0 
Seat 1: ZarubaNT (small blind) folded before Flop
Seat 2: GERAKLmeat (big blind) collected ($6)
Seat 3: khlaus folded before Flop (didn't bet)
Seat 4: Alpha 5.20 folded before Flop (didn't bet)
Seat 5: DuckinF0nk folded before Flop (didn't bet)
Seat 6: d`svictoriae (button) folded before Flop (didn't bet)


PokerStars Game #102599441094:  Hold'em No Limit ($3/$6 USD) - 2013/08/11 6:55:19 ET
Table 'Lorcia IV 40-100 bb' 6-max Seat #5 is the button
Seat 1: ZarubaNT ($738.83 in chips) 
Seat 2: GERAKLmeat ($1381.04 in chips) 
Seat 3: khlaus ($618.55 in chips) 
Seat 4: Alpha 5.20 ($654.20 in chips) 
Seat 5: DuckinF0nk ($600 in chips) 
Seat 6: d`svictoriae ($503.61 in chips) 
d`svictoriae: posts small blind $3
ZarubaNT: posts big blind $6
*** HOLE CARDS ***
GERAKLmeat: raises $6 to $12
khlaus: calls $12
Alpha 5.20: folds 
DuckinF0nk: folds 
d`svictoriae: folds 
ZarubaNT: calls $6
*** FLOP *** [3d 3s Tc]
ZarubaNT: checks 
GERAKLmeat: bets $10.79
khlaus: calls $10.79
ZarubaNT: folds 
*** TURN *** [3d 3s Tc] [Qh]
GERAKLmeat: bets $50
khlaus: calls $50
*** RIVER *** [3d 3s Tc Qh] [8c]
GERAKLmeat: checks 
khlaus: bets $120
GERAKLmeat: folds 
Uncalled bet ($120) returned to khlaus
khlaus collected $157.78 from pot
khlaus: doesn't show hand 
*** SUMMARY ***
Total pot $160.58 | Rake $2.80 
Board [3d 3s Tc Qh 8c]
Seat 1: ZarubaNT (big blind) folded on the Flop
Seat 2: GERAKLmeat folded on the River
Seat 3: khlaus collected ($157.78)
Seat 4: Alpha 5.20 folded before Flop (didn't bet)
Seat 5: DuckinF0nk (button) folded before Flop (didn't bet)
Seat 6: d`svictoriae (small blind) folded before Flop


PokerStars Game #102599467947:  Hold'em No Limit ($3/$6 USD) - 2013/08/11 6:56:37 ET
Table 'Lorcia IV 40-100 bb' 6-max Seat #6 is the button
Seat 1: ZarubaNT ($726.83 in chips) 
Seat 2: GERAKLmeat ($1308.25 in chips) 
Seat 3: khlaus ($703.54 in chips) 
Seat 4: Alpha 5.20 ($654.20 in chips) 
Seat 5: DuckinF0nk ($600 in chips) 
Seat 6: d`svictoriae ($500.61 in chips) 
ZarubaNT: posts small blind $3
GERAKLmeat: posts big blind $6
*** HOLE CARDS ***
khlaus: folds 
Alpha 5.20: folds 
DuckinF0nk: folds 
d`svictoriae: raises $6 to $12
ZarubaNT: folds 
GERAKLmeat: folds 
Uncalled bet ($6) returned to d`svictoriae
d`svictoriae collected $15 from pot
d`svictoriae: doesn't show hand 
*** SUMMARY ***
Total pot $15 | Rake $0 
Seat 1: ZarubaNT (small blind) folded before Flop
Seat 2: GERAKLmeat (big blind) folded before Flop
Seat 3: khlaus folded before Flop (didn't bet)
Seat 4: Alpha 5.20 folded before Flop (didn't bet)
Seat 5: DuckinF0nk folded before Flop (didn't bet)
Seat 6: d`svictoriae (button) collected ($15)


PokerStars Game #102599475053:  Hold'em No Limit ($3/$6 USD) - 2013/08/11 6:56:57 ET
Table 'Lorcia IV 40-100 bb' 6-max Seat #1 is the button
Seat 1: ZarubaNT ($723.83 in chips) 
Seat 2: GERAKLmeat ($1302.25 in chips) 
Seat 3: khlaus ($703.54 in chips) 
Seat 4: Alpha 5.20 ($654.20 in chips) 
Seat 5: DuckinF0nk ($600 in chips) 
Seat 6: d`svictoriae ($509.61 in chips) 
GERAKLmeat: posts small blind $3
khlaus: posts big blind $6
*** HOLE CARDS ***
Alpha 5.20: folds 
DuckinF0nk: folds 
d`svictoriae: folds 
ZarubaNT: folds 
GERAKLmeat: raises $6 to $12
khlaus: calls $6
*** FLOP *** [8h Jh 8d]
GERAKLmeat: bets $11.68
khlaus: folds 
Uncalled bet ($11.68) returned to GERAKLmeat
GERAKLmeat collected $22.92 from pot
GERAKLmeat: doesn't show hand 
*** SUMMARY ***
Total pot $24 | Rake $1.08 
Board [8h Jh 8d]
Seat 1: ZarubaNT (button) folded before Flop (didn't bet)
Seat 2: GERAKLmeat (small blind) collected ($22.92)
Seat 3: khlaus (big blind) folded on the Flop
Seat 4: Alpha 5.20 folded before Flop (didn't bet)
Seat 5: DuckinF0nk folded before Flop (didn't bet)
Seat 6: d`svictoriae folded before Flop (didn't bet)


PokerStars Game #102599490649:  Hold'em No Limit ($3/$6 USD) - 2013/08/11 6:57:41 ET
Table 'Lorcia IV 40-100 bb' 6-max Seat #2 is the button
Seat 1: ZarubaNT ($723.83 in chips) 
Seat 2: GERAKLmeat ($1313.17 in chips) 
Seat 3: khlaus ($691.54 in chips) 
Seat 4: Alpha 5.20 ($654.20 in chips) 
Seat 5: DuckinF0nk ($600 in chips) 
Seat 6: d`svictoriae ($509.61 in chips) 
khlaus: posts small blind $3
Alpha 5.20: posts big blind $6
*** HOLE CARDS ***
DuckinF0nk: folds 
d`svictoriae: folds 
ZarubaNT: folds 
GERAKLmeat: raises $6 to $12
khlaus: raises $18 to $30
Alpha 5.20: folds 
GERAKLmeat: folds 
Uncalled bet ($18) returned to khlaus
khlaus collected $30 from pot
khlaus: doesn't show hand 
*** SUMMARY ***
Total pot $30 | Rake $0 
Seat 1: ZarubaNT folded before Flop (didn't bet)
Seat 2: GERAKLmeat (button) folded before Flop
Seat 3: khlaus (small blind) collected ($30)
Seat 4: Alpha 5.20 (big blind) folded before Flop
Seat 5: DuckinF0nk folded before Flop (didn't bet)
Seat 6: d`svictoriae folded before Flop (didn't bet)


PokerStars Game #102599502166:  Hold'em No Limit ($3/$6 USD) - 2013/08/11 6:58:14 ET
Table 'Lorcia IV 40-100 bb' 6-max Seat #3 is the button
Seat 1: ZarubaNT ($723.83 in chips) 
Seat 2: GERAKLmeat ($1301.17 in chips) 
Seat 3: khlaus ($709.54 in chips) 
Seat 4: Alpha 5.20 ($648.20 in chips) 
Seat 5: DuckinF0nk ($600 in chips) 
Seat 6: d`svictoriae ($509.61 in chips) 
Alpha 5.20: posts small blind $3
DuckinF0nk: posts big blind $6
*** HOLE CARDS ***
d`svictoriae: folds 
ZarubaNT: folds 
GERAKLmeat: raises $6 to $12
khlaus: folds 
Alpha 5.20: folds 
DuckinF0nk: raises $33 to $45
GERAKLmeat: folds 
Uncalled bet ($33) returned to DuckinF0nk
DuckinF0nk collected $27 from pot
DuckinF0nk: doesn't show hand 
*** SUMMARY ***
Total pot $27 | Rake $0 
Seat 1: ZarubaNT folded before Flop (didn't bet)
Seat 2: GERAKLmeat folded before Flop
Seat 3: khlaus (button) folded before Flop (didn't bet)
Seat 4: Alpha 5.20 (small blind) folded before Flop
Seat 5: DuckinF0nk (big blind) collected ($27)
Seat 6: d`svictoriae folded before Flop (didn't bet)


PokerStars Game #102599508474:  Hold'em No Limit ($3/$6 USD) - 2013/08/11 6:58:33 ET
Table 'Lorcia IV 40-100 bb' 6-max Seat #4 is the button
Seat 1: ZarubaNT ($723.83 in chips) 
Seat 2: GERAKLmeat ($1289.17 in chips) 
Seat 3: khlaus ($709.54 in chips) 
Seat 4: Alpha 5.20 ($645.20 in chips) 
Seat 5: DuckinF0nk ($615 in chips) 
Seat 6: d`svictoriae ($509.61 in chips) 
DuckinF0nk: posts small blind $3
d`svictoriae: posts big blind $6
*** HOLE CARDS ***
ZarubaNT: folds 
GERAKLmeat: folds 
khlaus: folds 
Alpha 5.20: raises $6 to $12
DuckinF0nk: folds 
d`svictoriae: raises $18 to $30
Alpha 5.20: folds 
Uncalled bet ($18) returned to d`svictoriae
d`svictoriae collected $27 from pot
d`svictoriae: doesn't show hand 
*** SUMMARY ***
Total pot $27 | Rake $0 
Seat 1: ZarubaNT folded before Flop (didn't bet)
Seat 2: GERAKLmeat folded before Flop (didn't bet)
Seat 3: khlaus folded before Flop (didn't bet)
Seat 4: Alpha 5.20 (button) folded before Flop
Seat 5: DuckinF0nk (small blind) folded before Flop
Seat 6: d`svictoriae (big blind) collected ($27)


PokerStars Game #102599518537:  Hold'em No Limit ($3/$6 USD) - 2013/08/11 6:59:01 ET
Table 'Lorcia IV 40-100 bb' 6-max Seat #5 is the button
Seat 1: ZarubaNT ($723.83 in chips) 
Seat 2: GERAKLmeat ($1289.17 in chips) 
Seat 3: khlaus ($709.54 in chips) 
Seat 4: Alpha 5.20 ($633.20 in chips) 
Seat 5: DuckinF0nk ($612 in chips) 
Seat 6: d`svictoriae ($524.61 in chips) 
d`svictoriae: posts small blind $3
ZarubaNT: posts big blind $6
*** HOLE CARDS ***
GERAKLmeat: folds 
khlaus: folds 
Alpha 5.20: folds 
DuckinF0nk: raises $9 to $15
d`svictoriae: folds 
ZarubaNT: folds 
Uncalled bet ($9) returned to DuckinF0nk
DuckinF0nk collected $15 from pot
DuckinF0nk: doesn't show hand 
*** SUMMARY ***
Total pot $15 | Rake $0 
Seat 1: ZarubaNT (big blind) folded before Flop
Seat 2: GERAKLmeat folded before Flop (didn't bet)
Seat 3: khlaus folded before Flop (didn't bet)
Seat 4: Alpha 5.20 folded before Flop (didn't bet)
Seat 5: DuckinF0nk (button) collected ($15)
Seat 6: d`svictoriae (small blind) folded before Flop


PokerStars Game #102599526249:  Hold'em No Limit ($3/$6 USD) - 2013/08/11 6:59:23 ET
Table 'Lorcia IV 40-100 bb' 6-max Seat #6 is the button
Seat 1: ZarubaNT ($717.83 in chips) 
Seat 2: GERAKLmeat ($1289.17 in chips) 
Seat 3: khlaus ($709.54 in chips) 
Seat 4: Alpha 5.20 ($633.20 in chips) 
Seat 5: DuckinF0nk ($621 in chips) 
Seat 6: d`svictoriae ($521.61 in chips) 
ZarubaNT: posts small blind $3
GERAKLmeat: posts big blind $6
*** HOLE CARDS ***
khlaus: folds 
Alpha 5.20: raises $12 to $18
DuckinF0nk: folds 
d`svictoriae: calls $18
ZarubaNT: folds 
GERAKLmeat: folds 
*** FLOP *** [Td 2c 2d]
Alpha 5.20: bets $30
d`svictoriae: raises $30 to $60
Alpha 5.20: calls $30
*** TURN *** [Td 2c 2d] [7h]
Alpha 5.20: checks 
d`svictoriae: bets $84
Alpha 5.20: calls $84
*** RIVER *** [Td 2c 2d 7h] [4h]
Alpha 5.20: checks 
d`svictoriae: bets $168
Alpha 5.20: calls $168
*** SHOW DOWN ***
d`svictoriae: shows [9d Kd] (a pair of Deuces)
Alpha 5.20: shows [9c Tc] (two pair, Tens and Deuces)
Alpha 5.20 collected $666.20 from pot
*** SUMMARY ***
Total pot $669 | Rake $2.80 
Board [Td 2c 2d 7h 4h]
Seat 1: ZarubaNT (small blind) folded before Flop
Seat 2: GERAKLmeat (big blind) folded before Flop
Seat 3: khlaus folded before Flop (didn't bet)
Seat 4: Alpha 5.20 showed [9c Tc] and won ($666.20) with two pair, Tens and Deuces
Seat 5: DuckinF0nk folded before Flop (didn't bet)
Seat 6: d`svictoriae (button) showed [9d Kd] and lost with a pair of Deuces


PokerStars Game #102599669800:  Hold'em No Limit ($3/$6 USD) - 2013/08/11 7:05:02 ET
Table 'Lorcia IV 40-100 bb' 6-max Seat #1 is the button
Seat 1: ZarubaNT ($714.83 in chips) 
Seat 2: GERAKLmeat ($1287.82 in chips) 
Seat 3: khlaus ($673.54 in chips) 
Seat 4: Alpha 5.20 ($1101.60 in chips) 
Seat 5: DuckinF0nk ($600 in chips) 
Seat 6: d`svictoriae ($182.61 in chips) 
GERAKLmeat: posts small blind $3
khlaus: posts big blind $6
*** HOLE CARDS ***
Alpha 5.20: folds 
DuckinF0nk: folds 
d`svictoriae: folds 
ZarubaNT: raises $6 to $12
GERAKLmeat: raises $24 to $36
khlaus: folds 
ZarubaNT: raises $66 to $102
GERAKLmeat: raises $98 to $200
ZarubaNT: raises $514.83 to $714.83 and is all-in
GERAKLmeat: calls $514.83
*** FLOP *** [3d 6h Ks]
*** TURN *** [3d 6h Ks] [Qc]
*** RIVER *** [3d 6h Ks Qc] [6s]
*** SHOW DOWN ***
GERAKLmeat: shows [Th Td] (two pair, Tens and Sixes)
ZarubaNT: shows [Qd Ad] (two pair, Queens and Sixes)
ZarubaNT collected $1432.86 from pot
*** SUMMARY ***
Total pot $1435.66 | Rake $2.80 
Board [3d 6h Ks Qc 6s]
Seat 1: ZarubaNT (button) showed [Qd Ad] and won ($1432.86) with two pair, Queens and Sixes
Seat 2: GERAKLmeat (small blind) showed [Th Td] and lost with two pair, Tens and Sixes
Seat 3: khlaus (big blind) folded before Flop
Seat 4: Alpha 5.20 folded before Flop (didn't bet)
Seat 5: DuckinF0nk folded before Flop (didn't bet)
Seat 6: d`svictoriae folded before Flop (didn't bet)


PokerStars Game #102599707661:  Hold'em No Limit ($3/$6 USD) - 2013/08/11 7:06:25 ET
Table 'Lorcia IV 40-100 bb' 6-max Seat #2 is the button
Seat 1: ZarubaNT ($1432.86 in chips) 
Seat 2: GERAKLmeat ($572.99 in chips) 
Seat 3: khlaus ($667.54 in chips) 
Seat 4: Alpha 5.20 ($1101.60 in chips) 
Seat 5: DuckinF0nk ($600 in chips) 
Seat 6: d`svictoriae ($182.61 in chips) 
khlaus: posts small blind $3
Alpha 5.20: posts big blind $6
*** HOLE CARDS ***
DuckinF0nk: folds 
d`svictoriae: folds 
ZarubaNT: folds 
GERAKLmeat: raises $6 to $12
khlaus: folds 
Alpha 5.20: raises $36 to $48
GERAKLmeat: folds 
Uncalled bet ($36) returned to Alpha 5.20
Alpha 5.20 collected $27 from pot
Alpha 5.20: doesn't show hand 
*** SUMMARY ***
Total pot $27 | Rake $0 
Seat 1: ZarubaNT folded before Flop (didn't bet)
Seat 2: GERAKLmeat (button) folded before Flop
Seat 3: khlaus (small blind) folded before Flop
Seat 4: Alpha 5.20 (big blind) collected ($27)
Seat 5: DuckinF0nk folded before Flop (didn't bet)
Seat 6: d`svictoriae folded before Flop (didn't bet)


PokerStars Game #102599720336:  Hold'em No Limit ($3/$6 USD) - 2013/08/11 7:06:52 ET
Table 'Lorcia IV 40-100 bb' 6-max Seat #3 is the button
Seat 1: ZarubaNT ($1432.86 in chips) 
Seat 2: GERAKLmeat ($560.99 in chips) 
Seat 3: khlaus ($664.54 in chips) 
Seat 4: Alpha 5.20 ($1116.60 in chips) 
Seat 5: DuckinF0nk ($600 in chips) 
Seat 6: d`svictoriae ($182.61 in chips) 
Alpha 5.20: posts small blind $3
DuckinF0nk: posts big blind $6
*** HOLE CARDS ***
d`svictoriae: raises $6 to $12
ZarubaNT: calls $12
GERAKLmeat: folds 
khlaus: folds 
Alpha 5.20: folds 
DuckinF0nk: calls $6
*** FLOP *** [Js 9h 8d]
DuckinF0nk: checks 
d`svictoriae: checks 
ZarubaNT: bets $24
DuckinF0nk: folds 
d`svictoriae: calls $24
*** TURN *** [Js 9h 8d] [Qs]
d`svictoriae: checks 
ZarubaNT: checks 
*** RIVER *** [Js 9h 8d Qs] [2d]
d`svictoriae: checks 
ZarubaNT: checks 
*** SHOW DOWN ***
d`svictoriae: shows [2s Ks] (a pair of Deuces)
ZarubaNT: shows [Jd Kc] (a pair of Jacks)
ZarubaNT collected $84.20 from pot
*** SUMMARY ***
Total pot $87 | Rake $2.80 
Board [Js 9h 8d Qs 2d]
Seat 1: ZarubaNT showed [Jd Kc] and won ($84.20) with a pair of Jacks
Seat 2: GERAKLmeat folded before Flop (didn't bet)
Seat 3: khlaus (button) folded before Flop (didn't bet)
Seat 4: Alpha 5.20 (small blind) folded before Flop
Seat 5: DuckinF0nk (big blind) folded on the Flop
Seat 6: d`svictoriae showed [2s Ks] and lost with a pair of Deuces


PokerStars Game #102599767111:  Hold'em No Limit ($3/$6 USD) - 2013/08/11 7:08:35 ET
Table 'Lorcia IV 40-100 bb' 6-max Seat #4 is the button
Seat 1: ZarubaNT ($1481.06 in chips) 
Seat 2: GERAKLmeat ($560.99 in chips) 
Seat 3: khlaus ($664.54 in chips) 
Seat 4: Alpha 5.20 ($1113.60 in chips) 
Seat 5: DuckinF0nk ($600 in chips) 
Seat 6: d`svictoriae ($146.61 in chips) 
DuckinF0nk: posts small blind $3
d`svictoriae: posts big blind $6
*** HOLE CARDS ***
ZarubaNT: raises $12 to $18
GERAKLmeat: folds 
khlaus: folds 
Alpha 5.20: folds 
DuckinF0nk: folds 
d`svictoriae: folds 
Uncalled bet ($12) returned to ZarubaNT
ZarubaNT collected $15 from pot
ZarubaNT: doesn't show hand 
*** SUMMARY ***
Total pot $15 | Rake $0 
Seat 1: ZarubaNT collected ($15)
Seat 2: GERAKLmeat folded before Flop (didn't bet)
Seat 3: khlaus folded before Flop (didn't bet)
Seat 4: Alpha 5.20 (button) folded before Flop (didn't bet)
Seat 5: DuckinF0nk (small blind) folded before Flop
Seat 6: d`svictoriae (big blind) folded before Flop


PokerStars Game #102599778712:  Hold'em No Limit ($3/$6 USD) - 2013/08/11 7:09:00 ET
Table 'Lorcia IV 40-100 bb' 6-max Seat #5 is the button
Seat 1: ZarubaNT ($1490.06 in chips) 
Seat 2: GERAKLmeat ($560.99 in chips) 
Seat 3: khlaus ($664.54 in chips) 
Seat 4: Alpha 5.20 ($1113.60 in chips) 
Seat 5: DuckinF0nk ($600 in chips) 
Seat 6: d`svictoriae ($140.61 in chips) 
d`svictoriae: posts small blind $3
ZarubaNT: posts big blind $6
*** HOLE CARDS ***
GERAKLmeat: raises $6 to $12
khlaus: folds 
Alpha 5.20: raises $33 to $45
DuckinF0nk: folds 
d`svictoriae: folds 
ZarubaNT: folds 
GERAKLmeat: raises $45 to $90
Alpha 5.20: calls $45
*** FLOP *** [Js Qs 5c]
GERAKLmeat: bets $94.96
Alpha 5.20: raises $928.64 to $1023.60 and is all-in
GERAKLmeat: folds 
Uncalled bet ($928.64) returned to Alpha 5.20
Alpha 5.20 collected $376.12 from pot
Alpha 5.20: doesn't show hand 
*** SUMMARY ***
Total pot $378.92 | Rake $2.80 
Board [Js Qs 5c]
Seat 1: ZarubaNT (big blind) folded before Flop
Seat 2: GERAKLmeat folded on the Flop
Seat 3: khlaus folded before Flop (didn't bet)
Seat 4: Alpha 5.20 collected ($376.12)
Seat 5: DuckinF0nk (button) folded before Flop (didn't bet)
Seat 6: d`svictoriae (small blind) folded before Flop


PokerStars Game #102599806808:  Hold'em No Limit ($3/$6 USD) - 2013/08/11 7:10:01 ET
Table 'Lorcia IV 40-100 bb' 6-max Seat #6 is the button
Seat 1: ZarubaNT ($1484.06 in chips) 
Seat 2: GERAKLmeat ($376.03 in chips) 
Seat 3: khlaus ($664.54 in chips) 
Seat 4: Alpha 5.20 ($1304.76 in chips) 
Seat 5: DuckinF0nk ($600 in chips) 
Seat 6: d`svictoriae ($137.61 in chips) 
ZarubaNT: posts small blind $3
GERAKLmeat: posts big blind $6
*** HOLE CARDS ***
khlaus: raises $12 to $18
Alpha 5.20: folds 
DuckinF0nk: calls $18
d`svictoriae: calls $18
ZarubaNT: folds 
GERAKLmeat: calls $12
*** FLOP *** [3s 5c Kh]
GERAKLmeat: checks 
khlaus: bets $54
DuckinF0nk: folds 
d`svictoriae: folds 
GERAKLmeat: calls $54
*** TURN *** [3s 5c Kh] [As]
GERAKLmeat: checks 
khlaus: bets $104
GERAKLmeat: folds 
Uncalled bet ($104) returned to khlaus
khlaus collected $180.20 from pot
khlaus: doesn't show hand 
*** SUMMARY ***
Total pot $183 | Rake $2.80 
Board [3s 5c Kh As]
Seat 1: ZarubaNT (small blind) folded before Flop
Seat 2: GERAKLmeat (big blind) folded on the Turn
Seat 3: khlaus collected ($180.20)
Seat 4: Alpha 5.20 folded before Flop (didn't bet)
Seat 5: DuckinF0nk folded on the Flop
Seat 6: d`svictoriae (button) folded on the Flop


PokerStars Game #102599839414:  Hold'em No Limit ($3/$6 USD) - 2013/08/11 7:11:12 ET
Table 'Lorcia IV 40-100 bb' 6-max Seat #1 is the button
Seat 1: ZarubaNT ($1481.06 in chips) 
Seat 2: GERAKLmeat ($304.03 in chips) 
Seat 3: khlaus ($772.74 in chips) 
Seat 4: Alpha 5.20 ($1304.76 in chips) 
Seat 5: DuckinF0nk ($600 in chips) 
Seat 6: d`svictoriae ($119.61 in chips) 
GERAKLmeat: posts small blind $3
khlaus: posts big blind $6
*** HOLE CARDS ***
Alpha 5.20: folds 
DuckinF0nk: folds 
d`svictoriae: folds 
ZarubaNT: raises $6 to $12
GERAKLmeat: folds 
khlaus: folds 
Uncalled bet ($6) returned to ZarubaNT
ZarubaNT collected $15 from pot
ZarubaNT: doesn't show hand 
*** SUMMARY ***
Total pot $15 | Rake $0 
Seat 1: ZarubaNT (button) collected ($15)
Seat 2: GERAKLmeat (small blind) folded before Flop
Seat 3: khlaus (big blind) folded before Flop
Seat 4: Alpha 5.20 folded before Flop (didn't bet)
Seat 5: DuckinF0nk folded before Flop (didn't bet)
Seat 6: d`svictoriae folded before Flop (didn't bet)


PokerStars Game #102599850157:  Hold'em No Limit ($3/$6 USD) - 2013/08/11 7:11:35 ET
Table 'Lorcia IV 40-100 bb' 6-max Seat #2 is the button
Seat 1: ZarubaNT ($1490.06 in chips) 
Seat 2: GERAKLmeat ($301.03 in chips) 
Seat 3: khlaus ($766.74 in chips) 
Seat 4: Alpha 5.20 ($1304.76 in chips) 
Seat 5: DuckinF0nk ($600 in chips) 
Seat 6: d`svictoriae ($119.61 in chips) 
khlaus: posts small blind $3
Alpha 5.20: posts big blind $6
*** HOLE CARDS ***
DuckinF0nk: folds 
d`svictoriae: raises $6 to $12
DuckinF0nk leaves the table
ZarubaNT: calls $12
GERAKLmeat: folds 
stds st joins the table at seat #5 
khlaus: folds 
Alpha 5.20: folds 
*** FLOP *** [9d 5c 7h]
d`svictoriae: bets $24
ZarubaNT: calls $24
*** TURN *** [9d 5c 7h] [4h]
d`svictoriae: bets $83.61 and is all-in
ZarubaNT: calls $83.61
*** RIVER *** [9d 5c 7h 4h] [4d]
*** SHOW DOWN ***
d`svictoriae: shows [Jh Jc] (two pair, Jacks and Fours)
ZarubaNT: shows [Ts 9s] (two pair, Nines and Fours)
d`svictoriae collected $245.42 from pot
*** SUMMARY ***
Total pot $248.22 | Rake $2.80 
Board [9d 5c 7h 4h 4d]
Seat 1: ZarubaNT showed [Ts 9s] and lost with two pair, Nines and Fours
Seat 2: GERAKLmeat (button) folded before Flop (didn't bet)
Seat 3: khlaus (small blind) folded before Flop
Seat 4: Alpha 5.20 (big blind) folded before Flop
Seat 5: DuckinF0nk folded before Flop (didn't bet)
Seat 6: d`svictoriae showed [Jh Jc] and won ($245.42) with two pair, Jacks and Fours


PokerStars Game #102599879147:  Hold'em No Limit ($3/$6 USD) - 2013/08/11 7:12:38 ET
Table 'Lorcia IV 40-100 bb' 6-max Seat #3 is the button
Seat 1: ZarubaNT ($1370.45 in chips) 
Seat 2: GERAKLmeat ($301.03 in chips) 
Seat 3: khlaus ($763.74 in chips) 
Seat 4: Alpha 5.20 ($1298.76 in chips) 
Seat 5: stds st ($240 in chips) 
Seat 6: d`svictoriae ($245.42 in chips) 
Alpha 5.20: posts small blind $3
stds st: posts big blind $6
*** HOLE CARDS ***
d`svictoriae: raises $6 to $12
ZarubaNT: calls $12
GERAKLmeat: calls $12
khlaus: folds 
Alpha 5.20: calls $9
stds st: calls $6
*** FLOP *** [Kh 6c Ts]
Alpha 5.20: checks 
stds st: checks 
d`svictoriae: bets $36
ZarubaNT: folds 
GERAKLmeat: folds 
Alpha 5.20: raises $60 to $96
stds st: folds 
d`svictoriae: raises $137.42 to $233.42 and is all-in
Alpha 5.20: calls $137.42
*** TURN *** [Kh 6c Ts] [7s]
*** RIVER *** [Kh 6c Ts 7s] [Qd]
*** SHOW DOWN ***
Alpha 5.20: shows [Qh Ks] (two pair, Kings and Queens)
d`svictoriae: mucks hand 
Alpha 5.20 collected $524.04 from pot
*** SUMMARY ***
Total pot $526.84 | Rake $2.80 
Board [Kh 6c Ts 7s Qd]
Seat 1: ZarubaNT folded on the Flop
Seat 2: GERAKLmeat folded on the Flop
Seat 3: khlaus (button) folded before Flop (didn't bet)
Seat 4: Alpha 5.20 (small blind) showed [Qh Ks] and won ($524.04) with two pair, Kings and Queens
Seat 5: stds st (big blind) folded on the Flop
Seat 6: d`svictoriae mucked


PokerStars Game #102599921112:  Hold'em No Limit ($3/$6 USD) - 2013/08/11 7:14:09 ET
Table 'Lorcia IV 40-100 bb' 6-max Seat #4 is the button
Seat 1: ZarubaNT ($1358.45 in chips) 
Seat 2: GERAKLmeat ($289.03 in chips) 
Seat 3: khlaus ($763.74 in chips) 
Seat 4: Alpha 5.20 ($1577.38 in chips) 
Seat 5: stds st ($228 in chips) 
stds st: posts small blind $3
ZarubaNT: posts big blind $6
*** HOLE CARDS ***
GERAKLmeat: folds 
khlaus: folds 
Alpha 5.20: folds 
stds st: folds 
Uncalled bet ($3) returned to ZarubaNT
ZarubaNT collected $6 from pot
*** SUMMARY ***
Total pot $6 | Rake $0 
Seat 1: ZarubaNT (big blind) collected ($6)
Seat 2: GERAKLmeat folded before Flop (didn't bet)
Seat 3: khlaus folded before Flop (didn't bet)
Seat 4: Alpha 5.20 (button) folded before Flop (didn't bet)
Seat 5: stds st (small blind) folded before Flop


PokerStars Game #102599931176:  Hold'em No Limit ($3/$6 USD) - 2013/08/11 7:14:31 ET
Table 'Lorcia IV 40-100 bb' 6-max Seat #5 is the button
Seat 1: ZarubaNT ($1361.45 in chips) 
Seat 2: GERAKLmeat ($289.03 in chips) 
Seat 3: khlaus ($763.74 in chips) 
Seat 4: Alpha 5.20 ($1577.38 in chips) 
Seat 5: stds st ($225 in chips) 
ZarubaNT: posts small blind $3
GERAKLmeat: posts big blind $6
*** HOLE CARDS ***
d`svictoriae leaves the table
khlaus: folds 
Alpha 5.20: folds 
stds st: raises $6 to $12
khlaus leaves the table
ZarubaNT: folds 
GERAKLmeat: folds 
Uncalled bet ($6) returned to stds st
khk24 joins the table at seat #3 
stds st collected $15 from pot
stds st: doesn't show hand 
*** SUMMARY ***
Total pot $15 | Rake $0 
Seat 1: ZarubaNT (small blind) folded before Flop
Seat 2: GERAKLmeat (big blind) folded before Flop
Seat 3: khlaus folded before Flop (didn't bet)
Seat 4: Alpha 5.20 folded before Flop (didn't bet)
Seat 5: stds st (button) collected ($15)


PokerStars Game #102599936972:  Hold'em No Limit ($3/$6 USD) - 2013/08/11 7:14:44 ET
Table 'Lorcia IV 40-100 bb' 6-max Seat #1 is the button
Seat 1: ZarubaNT ($1358.45 in chips) 
Seat 2: GERAKLmeat ($283.03 in chips) 
Seat 3: khk24 ($600 in chips) 
Seat 4: Alpha 5.20 ($1577.38 in chips) 
Seat 5: stds st ($234 in chips) 
GERAKLmeat: posts small blind $3
khk24: posts big blind $6
*** HOLE CARDS ***
Alpha 5.20: folds 
stds st: folds 
ZarubaNT: raises $6 to $12
Hristo008 joins the table at seat #6 
GERAKLmeat: folds 
khk24: calls $6
*** FLOP *** [3h 7s Jh]
khk24: checks 
ZarubaNT: checks 
*** TURN *** [3h 7s Jh] [9s]
khk24: bets $18
Hristo008 leaves the table
ZarubaNT: calls $18
*** RIVER *** [3h 7s Jh 9s] [6d]
khk24: checks 
ZarubaNT: checks 
*** SHOW DOWN ***
khk24: shows [Tc 9d] (a pair of Nines)
ZarubaNT: shows [9c Ac] (a pair of Nines - Ace kicker)
ZarubaNT collected $60.20 from pot
*** SUMMARY ***
Total pot $63 | Rake $2.80 
Board [3h 7s Jh 9s 6d]
Seat 1: ZarubaNT (button) showed [9c Ac] and won ($60.20) with a pair of Nines
Seat 2: GERAKLmeat (small blind) folded before Flop
Seat 3: khk24 (big blind) showed [Tc 9d] and lost with a pair of Nines
Seat 4: Alpha 5.20 folded before Flop (didn't bet)
Seat 5: stds st folded before Flop (didn't bet)


PokerStars Game #102599953413:  Hold'em No Limit ($3/$6 USD) - 2013/08/11 7:15:19 ET
Table 'Lorcia IV 40-100 bb' 6-max Seat #2 is the button
Seat 1: ZarubaNT ($1388.65 in chips) 
Seat 2: GERAKLmeat ($280.03 in chips) 
Seat 3: khk24 ($600 in chips) 
Seat 4: Alpha 5.20 ($1577.38 in chips) 
Seat 5: stds st ($234 in chips) 
khk24: posts small blind $3
Alpha 5.20: posts big blind $6
*** HOLE CARDS ***
stds st: folds 
ZarubaNT: folds 
GERAKLmeat: raises $6 to $12
khk24: folds 
Alpha 5.20: folds 
Uncalled bet ($6) returned to GERAKLmeat
GERAKLmeat collected $15 from pot
GERAKLmeat: doesn't show hand 
*** SUMMARY ***
Total pot $15 | Rake $0 
Seat 1: ZarubaNT folded before Flop (didn't bet)
Seat 2: GERAKLmeat (button) collected ($15)
Seat 3: khk24 (small blind) folded before Flop
Seat 4: Alpha 5.20 (big blind) folded before Flop
Seat 5: stds st folded before Flop (didn't bet)


PokerStars Game #102599965294:  Hold'em No Limit ($3/$6 USD) - 2013/08/11 7:15:45 ET
Table 'Lorcia IV 40-100 bb' 6-max Seat #3 is the button
Seat 2: GERAKLmeat ($289.03 in chips) 
Seat 3: khk24 ($600 in chips) 
Seat 4: Alpha 5.20 ($1571.38 in chips) 
Alpha 5.20: posts small blind $3
stds st: is sitting out 
ZarubaNT: is sitting out 
GERAKLmeat: posts big blind $6
*** HOLE CARDS ***
ZarubaNT leaves the table
khk24: raises $6 to $12
Alpha 5.20: folds 
GERAKLmeat: folds 
Uncalled bet ($6) returned to khk24
khk24 collected $15 from pot
khk24: doesn't show hand 
*** SUMMARY ***
Total pot $15 | Rake $0 
Seat 2: GERAKLmeat (big blind) folded before Flop
Seat 3: khk24 (button) collected ($15)
Seat 4: Alpha 5.20 (small blind) folded before Flop


PokerStars Game #102601104976:  Hold'em No Limit ($3/$6 USD) - 2013/08/11 7:55:11 ET
Table 'Lorcia IV 40-100 bb' 6-max Seat #5 is the button
Seat 1: Scarface.VLT ($713.71 in chips) 
Seat 2: Ratatuj ($274.48 in chips) 
Seat 3: ZarubaNT ($1255.05 in chips) 
Seat 4: GERAKLmeat ($256.03 in chips) 
Seat 5: klenius ($672.14 in chips) 
Seat 6: $-Twackle-$ ($1099.40 in chips) 
$-Twackle-$: posts small blind $3
Scarface.VLT: posts big blind $6
*** HOLE CARDS ***
Ratatuj: folds 
ZarubaNT: folds 
GERAKLmeat: raises $6 to $12
klenius: folds 
$-Twackle-$: folds 
Scarface.VLT: folds 
Uncalled bet ($6) returned to GERAKLmeat
GERAKLmeat collected $15 from pot
GERAKLmeat: doesn't show hand 
*** SUMMARY ***
Total pot $15 | Rake $0 
Seat 1: Scarface.VLT (big blind) folded before Flop
Seat 2: Ratatuj folded before Flop (didn't bet)
Seat 3: ZarubaNT folded before Flop (didn't bet)
Seat 4: GERAKLmeat collected ($15)
Seat 5: klenius (button) folded before Flop (didn't bet)
Seat 6: $-Twackle-$ (small blind) folded before Flop


PokerStars Game #102601117552:  Hold'em No Limit ($3/$6 USD) - 2013/08/11 7:55:43 ET
Table 'Lorcia IV 40-100 bb' 6-max Seat #6 is the button
Seat 1: Scarface.VLT ($707.71 in chips) 
Seat 2: Ratatuj ($274.48 in chips) 
Seat 3: ZarubaNT ($1255.05 in chips) 
Seat 4: GERAKLmeat ($265.03 in chips) 
Seat 5: klenius ($672.14 in chips) 
Seat 6: $-Twackle-$ ($1096.40 in chips) 
Scarface.VLT: posts small blind $3
Ratatuj: posts big blind $6
*** HOLE CARDS ***
ZarubaNT: folds 
GERAKLmeat: raises $6 to $12
klenius: raises $24 to $36
$-Twackle-$: folds 
Scarface.VLT: folds 
Ratatuj: folds 
GERAKLmeat: folds 
Uncalled bet ($24) returned to klenius
klenius collected $33 from pot
*** SUMMARY ***
Total pot $33 | Rake $0 
Seat 1: Scarface.VLT (small blind) folded before Flop
Seat 2: Ratatuj (big blind) folded before Flop
Seat 3: ZarubaNT folded before Flop (didn't bet)
Seat 4: GERAKLmeat folded before Flop
Seat 5: klenius collected ($33)
Seat 6: $-Twackle-$ (button) folded before Flop (didn't bet)


PokerStars Game #102601129827:  Hold'em No Limit ($3/$6 USD) - 2013/08/11 7:56:14 ET
Table 'Lorcia IV 40-100 bb' 6-max Seat #1 is the button
Seat 1: Scarface.VLT ($704.71 in chips) 
Seat 2: Ratatuj ($268.48 in chips) 
Seat 3: ZarubaNT ($1255.05 in chips) 
Seat 4: GERAKLmeat ($253.03 in chips) 
Seat 5: klenius ($693.14 in chips) 
Seat 6: $-Twackle-$ ($1096.40 in chips) 
Ratatuj: posts small blind $3
ZarubaNT: posts big blind $6
*** HOLE CARDS ***
GERAKLmeat: folds 
klenius: raises $6 to $12
$-Twackle-$: folds 
Scarface.VLT: folds 
Ratatuj: folds 
ZarubaNT: folds 
Uncalled bet ($6) returned to klenius
klenius collected $15 from pot
*** SUMMARY ***
Total pot $15 | Rake $0 
Seat 1: Scarface.VLT (button) folded before Flop (didn't bet)
Seat 2: Ratatuj (small blind) folded before Flop
Seat 3: ZarubaNT (big blind) folded before Flop
Seat 4: GERAKLmeat folded before Flop (didn't bet)
Seat 5: klenius collected ($15)
Seat 6: $-Twackle-$ folded before Flop (didn't bet)


PokerStars Game #102601139139:  Hold'em No Limit ($3/$6 USD) - 2013/08/11 7:56:38 ET
Table 'Lorcia IV 40-100 bb' 6-max Seat #2 is the button
Seat 1: Scarface.VLT ($704.71 in chips) 
Seat 2: Ratatuj ($265.48 in chips) 
Seat 3: ZarubaNT ($1249.05 in chips) 
Seat 4: GERAKLmeat ($253.03 in chips) 
Seat 5: klenius ($702.14 in chips) 
Seat 6: $-Twackle-$ ($1096.40 in chips) 
ZarubaNT: posts small blind $3
GERAKLmeat: posts big blind $6
*** HOLE CARDS ***
klenius: folds 
$-Twackle-$: raises $6 to $12
Scarface.VLT: folds 
Ratatuj: calls $12
ZarubaNT: folds 
GERAKLmeat: folds 
*** FLOP *** [Ad 5c 6c]
$-Twackle-$: checks 
Ratatuj: bets $20.80
$-Twackle-$: raises $47 to $67.80
Ratatuj: folds 
Uncalled bet ($47) returned to $-Twackle-$
$-Twackle-$ collected $71.80 from pot
$-Twackle-$: doesn't show hand 
*** SUMMARY ***
Total pot $74.60 | Rake $2.80 
Board [Ad 5c 6c]
Seat 1: Scarface.VLT folded before Flop (didn't bet)
Seat 2: Ratatuj (button) folded on the Flop
Seat 3: ZarubaNT (small blind) folded before Flop
Seat 4: GERAKLmeat (big blind) folded before Flop
Seat 5: klenius folded before Flop (didn't bet)
Seat 6: $-Twackle-$ collected ($71.80)


PokerStars Game #102601160518:  Hold'em No Limit ($3/$6 USD) - 2013/08/11 7:57:33 ET
Table 'Lorcia IV 40-100 bb' 6-max Seat #3 is the button
Seat 1: Scarface.VLT ($704.71 in chips) 
Seat 2: Ratatuj ($232.68 in chips) 
Seat 3: ZarubaNT ($1246.05 in chips) 
Seat 4: GERAKLmeat ($247.03 in chips) 
Seat 5: klenius ($702.14 in chips) 
Seat 6: $-Twackle-$ ($1135.40 in chips) 
GERAKLmeat: posts small blind $3
klenius: posts big blind $6
*** HOLE CARDS ***
$-Twackle-$: folds 
Scarface.VLT: folds 
Ratatuj: raises $6 to $12
ZarubaNT: calls $12
GERAKLmeat: folds 
klenius: folds 
*** FLOP *** [Qs Ad 5h]
Ratatuj: bets $12.60
ZarubaNT: calls $12.60
*** TURN *** [Qs Ad 5h] [7d]
Ratatuj: checks 
ZarubaNT: bets $42
Ratatuj: folds 
Uncalled bet ($42) returned to ZarubaNT
ZarubaNT collected $55.58 from pot
ZarubaNT: doesn't show hand 
*** SUMMARY ***
Total pot $58.20 | Rake $2.62 
Board [Qs Ad 5h 7d]
Seat 1: Scarface.VLT folded before Flop (didn't bet)
Seat 2: Ratatuj folded on the Turn
Seat 3: ZarubaNT (button) collected ($55.58)
Seat 4: GERAKLmeat (small blind) folded before Flop
Seat 5: klenius (big blind) folded before Flop
Seat 6: $-Twackle-$ folded before Flop (didn't bet)


PokerStars Game #102601179502:  Hold'em No Limit ($3/$6 USD) - 2013/08/11 7:58:21 ET
Table 'Lorcia IV 40-100 bb' 6-max Seat #4 is the button
Seat 1: Scarface.VLT ($704.71 in chips) 
Seat 2: Ratatuj ($208.08 in chips) 
Seat 3: ZarubaNT ($1277.03 in chips) 
Seat 4: GERAKLmeat ($244.03 in chips) 
Seat 5: klenius ($696.14 in chips) 
klenius: posts small blind $3
$-Twackle-$: is sitting out 
Scarface.VLT: posts big blind $6
*** HOLE CARDS ***
Ratatuj: raises $7.32 to $13.32
ZarubaNT: folds 
$-Twackle-$ leaves the table
GERAKLmeat: raises $16.68 to $30
LukaschenkoA joins the table at seat #6 
klenius: folds 
Scarface.VLT: folds 
Ratatuj: raises $177 to $207
GERAKLmeat: raises $37.03 to $244.03 and is all-in
Ratatuj: calls $1.08 and is all-in
Uncalled bet ($35.95) returned to GERAKLmeat
*** FLOP *** [2h Ks Ac]
*** TURN *** [2h Ks Ac] [Tc]
*** RIVER *** [2h Ks Ac Tc] [8s]
*** SHOW DOWN ***
Ratatuj: shows [4c 4d] (a pair of Fours)
GERAKLmeat: shows [Kh Ah] (two pair, Aces and Kings)
GERAKLmeat collected $422.36 from pot
*** SUMMARY ***
Total pot $425.16 | Rake $2.80 
Board [2h Ks Ac Tc 8s]
Seat 1: Scarface.VLT (big blind) folded before Flop
Seat 2: Ratatuj showed [4c 4d] and lost with a pair of Fours
Seat 3: ZarubaNT folded before Flop (didn't bet)
Seat 4: GERAKLmeat (button) showed [Kh Ah] and won ($422.36) with two pair, Aces and Kings
Seat 5: klenius (small blind) folded before Flop


PokerStars Game #102601192367:  Hold'em No Limit ($3/$6 USD) - 2013/08/11 7:58:54 ET
Table 'Lorcia IV 40-100 bb' 6-max Seat #5 is the button
Seat 1: Scarface.VLT ($698.71 in chips) 
Seat 2: Ratatuj ($240 in chips) 
Seat 3: ZarubaNT ($1277.03 in chips) 
Seat 4: GERAKLmeat ($458.31 in chips) 
Seat 5: klenius ($693.14 in chips) 
LukaschenkoA will be allowed to play after the button
Scarface.VLT: posts small blind $3
Ratatuj: posts big blind $6
*** HOLE CARDS ***
ZarubaNT: folds 
GERAKLmeat: folds 
klenius: raises $6 to $12
Scarface.VLT: raises $30 to $42
Ratatuj said, "vrubaj ritu!"
Ratatuj: folds 
klenius: raises $102 to $144
Scarface.VLT: folds 
Uncalled bet ($102) returned to klenius
klenius collected $90 from pot
*** SUMMARY ***
Total pot $90 | Rake $0 
Seat 1: Scarface.VLT (small blind) folded before Flop
Seat 2: Ratatuj (big blind) folded before Flop
Seat 3: ZarubaNT folded before Flop (didn't bet)
Seat 4: GERAKLmeat folded before Flop (didn't bet)
Seat 5: klenius (button) collected ($90)


PokerStars Game #102601211348:  Hold'em No Limit ($3/$6 USD) - 2013/08/11 7:59:41 ET
Table 'Lorcia IV 40-100 bb' 6-max Seat #1 is the button
Seat 1: Scarface.VLT ($656.71 in chips) 
Seat 2: Ratatuj ($234 in chips) 
Seat 3: ZarubaNT ($1277.03 in chips) 
Seat 4: GERAKLmeat ($458.31 in chips) 
Seat 5: klenius ($741.14 in chips) 
Ratatuj: posts small blind $3
ZarubaNT: posts big blind $6
LukaschenkoA: sits out 
*** HOLE CARDS ***
GERAKLmeat: folds 
klenius: folds 
Scarface.VLT: folds 
Ratatuj: raises $7.80 to $13.80
ZarubaNT: folds 
Uncalled bet ($7.80) returned to Ratatuj
Ratatuj collected $12 from pot
Ratatuj: doesn't show hand 
*** SUMMARY ***
Total pot $12 | Rake $0 
Seat 1: Scarface.VLT (button) folded before Flop (didn't bet)
Seat 2: Ratatuj (small blind) collected ($12)
Seat 3: ZarubaNT (big blind) folded before Flop
Seat 4: GERAKLmeat folded before Flop (didn't bet)
Seat 5: klenius folded before Flop (didn't bet)


PokerStars Game #102601216304:  Hold'em No Limit ($3/$6 USD) - 2013/08/11 7:59:53 ET
Table 'Lorcia IV 40-100 bb' 6-max Seat #2 is the button
Seat 1: Scarface.VLT ($656.71 in chips) 
Seat 2: Ratatuj ($240 in chips) 
Seat 3: ZarubaNT ($1271.03 in chips) 
Seat 4: GERAKLmeat ($458.31 in chips) 
Seat 5: klenius ($741.14 in chips) 
ZarubaNT: posts small blind $3
GERAKLmeat: posts big blind $6
LukaschenkoA: sits out 
*** HOLE CARDS ***
klenius: folds 
Scarface.VLT: folds 
Ratatuj: raises $6.42 to $12.42
ZarubaNT: folds 
GERAKLmeat: folds 
Uncalled bet ($6.42) returned to Ratatuj
Ratatuj collected $15 from pot
Ratatuj: doesn't show hand 
*** SUMMARY ***
Total pot $15 | Rake $0 
Seat 1: Scarface.VLT folded before Flop (didn't bet)
Seat 2: Ratatuj (button) collected ($15)
Seat 3: ZarubaNT (small blind) folded before Flop
Seat 4: GERAKLmeat (big blind) folded before Flop
Seat 5: klenius folded before Flop (didn't bet)


PokerStars Game #102600373230:  Hold'em No Limit ($3/$6 USD) - 2013/08/11 7:30:14 ET
Table 'Lorcia IV 40-100 bb' 6-max Seat #1 is the button
Seat 1: Nahar ($262.20 in chips) 
Seat 2: Ratatuj ($234 in chips) 
Seat 4: Sir_Fuj1 ($247.20 in chips) 
Seat 5: klenius ($667.59 in chips) 
Seat 6: $-Twackle-$ ($606 in chips) 
Ratatuj: posts small blind $3
Sir_Fuj1: posts big blind $6
*** HOLE CARDS ***
klenius: folds 
$-Twackle-$: raises $10.20 to $16.20
Nahar: folds 
Ratatuj: folds 
Sir_Fuj1: folds 
Uncalled bet ($10.20) returned to $-Twackle-$
$-Twackle-$ collected $15 from pot
$-Twackle-$: doesn't show hand 
*** SUMMARY ***
Total pot $15 | Rake $0 
Seat 1: Nahar (button) folded before Flop (didn't bet)
Seat 2: Ratatuj (small blind) folded before Flop
Seat 4: Sir_Fuj1 (big blind) folded before Flop
Seat 5: klenius folded before Flop (didn't bet)
Seat 6: $-Twackle-$ collected ($15)


PokerStars Game #102600383640:  Hold'em No Limit ($3/$6 USD) - 2013/08/11 7:30:36 ET
Table 'Lorcia IV 40-100 bb' 6-max Seat #2 is the button
Seat 1: Nahar ($262.20 in chips) 
Seat 2: Ratatuj ($231 in chips) 
Seat 4: Sir_Fuj1 ($241.20 in chips) 
Seat 5: klenius ($667.59 in chips) 
Seat 6: $-Twackle-$ ($615 in chips) 
Sir_Fuj1: posts small blind $3
klenius: posts big blind $6
*** HOLE CARDS ***
$-Twackle-$: folds 
Nahar: folds 
Ratatuj: raises $6.42 to $12.42
Sir_Fuj1: folds 
klenius: raises $29.58 to $42
Ratatuj: folds 
Uncalled bet ($29.58) returned to klenius
klenius collected $27.84 from pot
*** SUMMARY ***
Total pot $27.84 | Rake $0 
Seat 1: Nahar folded before Flop (didn't bet)
Seat 2: Ratatuj (button) folded before Flop
Seat 4: Sir_Fuj1 (small blind) folded before Flop
Seat 5: klenius (big blind) collected ($27.84)
Seat 6: $-Twackle-$ folded before Flop (didn't bet)


PokerStars Game #102600404690:  Hold'em No Limit ($3/$6 USD) - 2013/08/11 7:31:20 ET
Table 'Lorcia IV 40-100 bb' 6-max Seat #4 is the button
Seat 1: Nahar ($262.20 in chips) 
Seat 2: Ratatuj ($218.58 in chips) 
Seat 4: Sir_Fuj1 ($238.20 in chips) 
Seat 5: klenius ($683.01 in chips) 
Seat 6: $-Twackle-$ ($615 in chips) 
klenius: posts small blind $3
$-Twackle-$: posts big blind $6
*** HOLE CARDS ***
Nahar: folds 
Ratatuj: folds 
Sir_Fuj1: folds 
klenius: raises $6 to $12
$-Twackle-$: folds 
Uncalled bet ($6) returned to klenius
klenius collected $12 from pot
*** SUMMARY ***
Total pot $12 | Rake $0 
Seat 1: Nahar folded before Flop (didn't bet)
Seat 2: Ratatuj folded before Flop (didn't bet)
Seat 4: Sir_Fuj1 (button) folded before Flop (didn't bet)
Seat 5: klenius (small blind) collected ($12)
Seat 6: $-Twackle-$ (big blind) folded before Flop


PokerStars Game #102600412641:  Hold'em No Limit ($3/$6 USD) - 2013/08/11 7:31:36 ET
Table 'Lorcia IV 40-100 bb' 6-max Seat #5 is the button
Seat 2: Ratatuj ($218.58 in chips) 
Seat 4: Sir_Fuj1 ($238.20 in chips) 
Seat 5: klenius ($689.01 in chips) 
Seat 6: $-Twackle-$ ($609 in chips) 
$-Twackle-$: posts small blind $3
Nahar: is sitting out 
Ratatuj: posts big blind $6
*** HOLE CARDS ***
Sir_Fuj1: folds 
Nahar leaves the table
klenius: folds 
ZarubaNT joins the table at seat #3 
$-Twackle-$: folds 
Uncalled bet ($3) returned to Ratatuj
Ratatuj collected $6 from pot
Ratatuj: doesn't show hand 
*** SUMMARY ***
Total pot $6 | Rake $0 
Seat 2: Ratatuj (big blind) collected ($6)
Seat 4: Sir_Fuj1 folded before Flop (didn't bet)
Seat 5: klenius (button) folded before Flop (didn't bet)
Seat 6: $-Twackle-$ (small blind) folded before Flop


PokerStars Game #102600422388:  Hold'em No Limit ($3/$6 USD) - 2013/08/11 7:31:56 ET
Table 'Lorcia IV 40-100 bb' 6-max Seat #6 is the button
Seat 2: Ratatuj ($221.58 in chips) 
Seat 3: ZarubaNT ($1388.65 in chips) 
Seat 4: Sir_Fuj1 ($238.20 in chips) 
Seat 5: klenius ($689.01 in chips) 
Seat 6: $-Twackle-$ ($606 in chips) 
Ratatuj: posts small blind $3
ZarubaNT: posts big blind $6
*** HOLE CARDS ***
Sir_Fuj1: folds 
klenius: raises $6 to $12
$-Twackle-$: raises $36 to $48
Ratatuj: folds 
ZarubaNT: folds 
klenius: raises $102 to $150
$-Twackle-$: calls $102
*** FLOP *** [8h 6h 6d]
klenius: bets $192
Hristo008 joins the table at seat #1 
Hristo008 leaves the table
$-Twackle-$: raises $264 to $456 and is all-in
klenius: calls $264
*** TURN *** [8h 6h 6d] [Kd]
*** RIVER *** [8h 6h 6d Kd] [Th]
*** SHOW DOWN ***
klenius: shows [8s Ts] (two pair, Tens and Eights)
$-Twackle-$: shows [Jd Jc] (two pair, Jacks and Sixes)
$-Twackle-$ collected $1218.20 from pot
*** SUMMARY ***
Total pot $1221 | Rake $2.80 
Board [8h 6h 6d Kd Th]
Seat 2: Ratatuj (small blind) folded before Flop
Seat 3: ZarubaNT (big blind) folded before Flop
Seat 4: Sir_Fuj1 folded before Flop (didn't bet)
Seat 5: klenius showed [8s Ts] and lost with two pair, Tens and Eights
Seat 6: $-Twackle-$ (button) showed [Jd Jc] and won ($1218.20) with two pair, Jacks and Sixes


PokerStars Game #102600460175:  Hold'em No Limit ($3/$6 USD) - 2013/08/11 7:33:13 ET
Table 'Lorcia IV 40-100 bb' 6-max Seat #2 is the button
Seat 2: Ratatuj ($218.58 in chips) 
Seat 3: ZarubaNT ($1382.65 in chips) 
Seat 5: klenius ($83.01 in chips) 
Seat 6: $-Twackle-$ ($1218.20 in chips) 
ZarubaNT: posts small blind $3
Sir_Fuj1: is sitting out 
klenius: posts big blind $6
*** HOLE CARDS ***
Sir_Fuj1 leaves the table
$-Twackle-$: raises $10.20 to $16.20
Ratatuj: calls $16.20
ZarubaNT: calls $13.20
klenius: folds 
*** FLOP *** [Kh Qs 5c]
ZarubaNT: checks 
$-Twackle-$: checks 
Ratatuj: bets $35.04
ZarubaNT: folds 
$-Twackle-$: folds 
Uncalled bet ($35.04) returned to Ratatuj
Ratatuj collected $53.10 from pot
Ratatuj: doesn't show hand 
*** SUMMARY ***
Total pot $54.60 | Rake $1.50 
Board [Kh Qs 5c]
Seat 2: Ratatuj (button) collected ($53.10)
Seat 3: ZarubaNT (small blind) folded on the Flop
Seat 5: klenius (big blind) folded before Flop
Seat 6: $-Twackle-$ folded on the Flop


PokerStars Game #102600481616:  Hold'em No Limit ($3/$6 USD) - 2013/08/11 7:33:57 ET
Table 'Lorcia IV 40-100 bb' 6-max Seat #3 is the button
Seat 2: Ratatuj ($255.48 in chips) 
Seat 3: ZarubaNT ($1366.45 in chips) 
Seat 5: klenius ($600 in chips) 
Seat 6: $-Twackle-$ ($1202 in chips) 
klenius: posts small blind $3
$-Twackle-$: posts big blind $6
*** HOLE CARDS ***
Ratatuj: raises $6 to $12
ZarubaNT: folds 
klenius: raises $24 to $36
$-Twackle-$: folds 
Ratatuj: folds 
Uncalled bet ($24) returned to klenius
klenius collected $30 from pot
*** SUMMARY ***
Total pot $30 | Rake $0 
Seat 2: Ratatuj folded before Flop
Seat 3: ZarubaNT (button) folded before Flop (didn't bet)
Seat 5: klenius (small blind) collected ($30)
Seat 6: $-Twackle-$ (big blind) folded before Flop


PokerStars Game #102600491454:  Hold'em No Limit ($3/$6 USD) - 2013/08/11 7:34:17 ET
Table 'Lorcia IV 40-100 bb' 6-max Seat #5 is the button
Seat 2: Ratatuj ($243.48 in chips) 
Seat 3: ZarubaNT ($1366.45 in chips) 
Seat 5: klenius ($618 in chips) 
Seat 6: $-Twackle-$ ($1196 in chips) 
$-Twackle-$: posts small blind $3
Ratatuj: posts big blind $6
*** HOLE CARDS ***
ZarubaNT: raises $9 to $15
Scarface.VLT joins the table at seat #1 
klenius: calls $15
$-Twackle-$: folds 
Ratatuj: folds 
*** FLOP *** [5h 7h 9d]
ZarubaNT: bets $24
onez69 joins the table at seat #4 
klenius: calls $24
*** TURN *** [5h 7h 9d] [9c]
ZarubaNT: checks 
klenius: bets $54
ZarubaNT: folds 
Uncalled bet ($54) returned to klenius
klenius collected $85.50 from pot
*** SUMMARY ***
Total pot $87 | Rake $1.50 
Board [5h 7h 9d 9c]
Seat 2: Ratatuj (big blind) folded before Flop
Seat 3: ZarubaNT folded on the Turn
Seat 5: klenius (button) collected ($85.50)
Seat 6: $-Twackle-$ (small blind) folded before Flop


PokerStars Game #102600508542:  Hold'em No Limit ($3/$6 USD) - 2013/08/11 7:34:53 ET
Table 'Lorcia IV 40-100 bb' 6-max Seat #6 is the button
Seat 2: Ratatuj ($237.48 in chips) 
Seat 3: ZarubaNT ($1327.45 in chips) 
Seat 5: klenius ($664.50 in chips) 
Seat 6: $-Twackle-$ ($1193 in chips) 
Scarface.VLT will be allowed to play after the button
Ratatuj: posts small blind $3
ZarubaNT: posts big blind $6
onez69: sits out 
*** HOLE CARDS ***
klenius: folds 
$-Twackle-$: folds 
Ratatuj: raises $7.80 to $13.80
ZarubaNT: folds 
Uncalled bet ($7.80) returned to Ratatuj
Ratatuj collected $12 from pot
Ratatuj: doesn't show hand 
*** SUMMARY ***
Total pot $12 | Rake $0 
Seat 2: Ratatuj (small blind) collected ($12)
Seat 3: ZarubaNT (big blind) folded before Flop
Seat 5: klenius folded before Flop (didn't bet)
Seat 6: $-Twackle-$ (button) folded before Flop (didn't bet)


PokerStars Game #102600515897:  Hold'em No Limit ($3/$6 USD) - 2013/08/11 7:35:08 ET
Table 'Lorcia IV 40-100 bb' 6-max Seat #2 is the button
Seat 2: Ratatuj ($243.48 in chips) 
Seat 3: ZarubaNT ($1321.45 in chips) 
Seat 4: onez69 ($240 in chips) 
Seat 5: klenius ($664.50 in chips) 
Seat 6: $-Twackle-$ ($1193 in chips) 
ZarubaNT: posts small blind $3
onez69: posts big blind $6
Scarface.VLT: sits out 
*** HOLE CARDS ***
klenius: folds 
$-Twackle-$: folds 
Ratatuj: raises $6.42 to $12.42
ZarubaNT: folds 
onez69: folds 
Uncalled bet ($6.42) returned to Ratatuj
Ratatuj collected $15 from pot
Ratatuj: doesn't show hand 
*** SUMMARY ***
Total pot $15 | Rake $0 
Seat 2: Ratatuj (button) collected ($15)
Seat 3: ZarubaNT (small blind) folded before Flop
Seat 4: onez69 (big blind) folded before Flop
Seat 5: klenius folded before Flop (didn't bet)
Seat 6: $-Twackle-$ folded before Flop (didn't bet)


PokerStars Game #102600534641:  Hold'em No Limit ($3/$6 USD) - 2013/08/11 7:35:47 ET
Table 'Lorcia IV 40-100 bb' 6-max Seat #3 is the button
Seat 2: Ratatuj ($252.48 in chips) 
Seat 3: ZarubaNT ($1318.45 in chips) 
Seat 4: onez69 ($234 in chips) 
Seat 5: klenius ($664.50 in chips) 
Seat 6: $-Twackle-$ ($1193 in chips) 
onez69: posts small blind $3
klenius: posts big blind $6
Scarface.VLT: sits out 
*** HOLE CARDS ***
$-Twackle-$: folds 
Ratatuj: folds 
ZarubaNT: raises $6 to $12
onez69: raises $18 to $30
klenius: calls $24
ZarubaNT: raises $60 to $90
onez69: folds 
klenius: folds 
Uncalled bet ($60) returned to ZarubaNT
ZarubaNT collected $90 from pot
ZarubaNT: doesn't show hand 
*** SUMMARY ***
Total pot $90 | Rake $0 
Seat 2: Ratatuj folded before Flop (didn't bet)
Seat 3: ZarubaNT (button) collected ($90)
Seat 4: onez69 (small blind) folded before Flop
Seat 5: klenius (big blind) folded before Flop
Seat 6: $-Twackle-$ folded before Flop (didn't bet)


PokerStars Game #102600557069:  Hold'em No Limit ($3/$6 USD) - 2013/08/11 7:36:33 ET
Table 'Lorcia IV 40-100 bb' 6-max Seat #4 is the button
Seat 2: Ratatuj ($252.48 in chips) 
Seat 3: ZarubaNT ($1378.45 in chips) 
Seat 4: onez69 ($204 in chips) 
Seat 5: klenius ($634.50 in chips) 
Seat 6: $-Twackle-$ ($1193 in chips) 
klenius: posts small blind $3
$-Twackle-$: posts big blind $6
Scarface.VLT: sits out 
*** HOLE CARDS ***
Ratatuj: folds 
ZarubaNT: folds 
onez69: folds 
klenius: raises $6 to $12
$-Twackle-$: folds 
Uncalled bet ($6) returned to klenius
klenius collected $12 from pot
*** SUMMARY ***
Total pot $12 | Rake $0 
Seat 2: Ratatuj folded before Flop (didn't bet)
Seat 3: ZarubaNT folded before Flop (didn't bet)
Seat 4: onez69 (button) folded before Flop (didn't bet)
Seat 5: klenius (small blind) collected ($12)
Seat 6: $-Twackle-$ (big blind) folded before Flop


PokerStars Game #102600567289:  Hold'em No Limit ($3/$6 USD) - 2013/08/11 7:36:54 ET
Table 'Lorcia IV 40-100 bb' 6-max Seat #5 is the button
Seat 1: Scarface.VLT ($600 in chips) 
Seat 2: Ratatuj ($252.48 in chips) 
Seat 3: ZarubaNT ($1378.45 in chips) 
Seat 4: onez69 ($204 in chips) 
Seat 5: klenius ($640.50 in chips) 
Seat 6: $-Twackle-$ ($1187 in chips) 
$-Twackle-$: posts small blind $3
Scarface.VLT: posts big blind $6
*** HOLE CARDS ***
Ratatuj: folds 
ZarubaNT: folds 
onez69: folds 
klenius: raises $6 to $12
$-Twackle-$: folds 
Scarface.VLT: folds 
Uncalled bet ($6) returned to klenius
klenius collected $15 from pot
*** SUMMARY ***
Total pot $15 | Rake $0 
Seat 1: Scarface.VLT (big blind) folded before Flop
Seat 2: Ratatuj folded before Flop (didn't bet)
Seat 3: ZarubaNT folded before Flop (didn't bet)
Seat 4: onez69 folded before Flop (didn't bet)
Seat 5: klenius (button) collected ($15)
Seat 6: $-Twackle-$ (small blind) folded before Flop


PokerStars Game #102600582705:  Hold'em No Limit ($3/$6 USD) - 2013/08/11 7:37:26 ET
Table 'Lorcia IV 40-100 bb' 6-max Seat #6 is the button
Seat 1: Scarface.VLT ($600 in chips) 
Seat 2: Ratatuj ($252.48 in chips) 
Seat 3: ZarubaNT ($1378.45 in chips) 
Seat 4: onez69 ($204 in chips) 
Seat 5: klenius ($649.50 in chips) 
Seat 6: $-Twackle-$ ($1184 in chips) 
Scarface.VLT: posts small blind $3
Ratatuj: posts big blind $6
*** HOLE CARDS ***
ZarubaNT: raises $12 to $18
onez69: folds 
klenius: raises $30 to $48
$-Twackle-$: folds 
Scarface.VLT: folds 
Ratatuj: folds 
ZarubaNT: folds 
Uncalled bet ($30) returned to klenius
klenius collected $45 from pot
*** SUMMARY ***
Total pot $45 | Rake $0 
Seat 1: Scarface.VLT (small blind) folded before Flop
Seat 2: Ratatuj (big blind) folded before Flop
Seat 3: ZarubaNT folded before Flop
Seat 4: onez69 folded before Flop (didn't bet)
Seat 5: klenius collected ($45)
Seat 6: $-Twackle-$ (button) folded before Flop (didn't bet)


PokerStars Game #102600599966:  Hold'em No Limit ($3/$6 USD) - 2013/08/11 7:38:01 ET
Table 'Lorcia IV 40-100 bb' 6-max Seat #1 is the button
Seat 1: Scarface.VLT ($600 in chips) 
Seat 2: Ratatuj ($246.48 in chips) 
Seat 3: ZarubaNT ($1360.45 in chips) 
Seat 4: onez69 ($204 in chips) 
Seat 5: klenius ($676.50 in chips) 
Seat 6: $-Twackle-$ ($1184 in chips) 
Ratatuj: posts small blind $3
ZarubaNT: posts big blind $6
*** HOLE CARDS ***
onez69: folds 
klenius: folds 
$-Twackle-$: raises $10.20 to $16.20
Scarface.VLT: folds 
Ratatuj: raises $24.30 to $40.50
ZarubaNT: folds 
$-Twackle-$: folds 
Uncalled bet ($24.30) returned to Ratatuj
Ratatuj collected $38.40 from pot
Ratatuj: doesn't show hand 
*** SUMMARY ***
Total pot $38.40 | Rake $0 
Seat 1: Scarface.VLT (button) folded before Flop (didn't bet)
Seat 2: Ratatuj (small blind) collected ($38.40)
Seat 3: ZarubaNT (big blind) folded before Flop
Seat 4: onez69 folded before Flop (didn't bet)
Seat 5: klenius folded before Flop (didn't bet)
Seat 6: $-Twackle-$ folded before Flop


PokerStars Game #102600611762:  Hold'em No Limit ($3/$6 USD) - 2013/08/11 7:38:25 ET
Table 'Lorcia IV 40-100 bb' 6-max Seat #2 is the button
Seat 1: Scarface.VLT ($600 in chips) 
Seat 2: Ratatuj ($268.68 in chips) 
Seat 3: ZarubaNT ($1354.45 in chips) 
Seat 4: onez69 ($204 in chips) 
Seat 5: klenius ($676.50 in chips) 
Seat 6: $-Twackle-$ ($1167.80 in chips) 
ZarubaNT: posts small blind $3
onez69: posts big blind $6
*** HOLE CARDS ***
klenius: folds 
$-Twackle-$: folds 
Scarface.VLT: raises $6 to $12
Ratatuj: folds 
ZarubaNT: folds 
onez69: raises $18 to $30
Scarface.VLT: folds 
Uncalled bet ($18) returned to onez69
onez69 collected $27 from pot
onez69: doesn't show hand 
*** SUMMARY ***
Total pot $27 | Rake $0 
Seat 1: Scarface.VLT folded before Flop
Seat 2: Ratatuj (button) folded before Flop (didn't bet)
Seat 3: ZarubaNT (small blind) folded before Flop
Seat 4: onez69 (big blind) collected ($27)
Seat 5: klenius folded before Flop (didn't bet)
Seat 6: $-Twackle-$ folded before Flop (didn't bet)


PokerStars Game #102600627784:  Hold'em No Limit ($3/$6 USD) - 2013/08/11 7:38:58 ET
Table 'Lorcia IV 40-100 bb' 6-max Seat #3 is the button
Seat 1: Scarface.VLT ($600 in chips) 
Seat 2: Ratatuj ($268.68 in chips) 
Seat 3: ZarubaNT ($1351.45 in chips) 
Seat 4: onez69 ($219 in chips) 
Seat 5: klenius ($676.50 in chips) 
Seat 6: $-Twackle-$ ($1167.80 in chips) 
onez69: posts small blind $3
klenius: posts big blind $6
*** HOLE CARDS ***
$-Twackle-$: folds 
Scarface.VLT: folds 
Ratatuj: folds 
ZarubaNT: folds 
onez69: folds 
Uncalled bet ($3) returned to klenius
klenius collected $6 from pot
*** SUMMARY ***
Total pot $6 | Rake $0 
Seat 1: Scarface.VLT folded before Flop (didn't bet)
Seat 2: Ratatuj folded before Flop (didn't bet)
Seat 3: ZarubaNT (button) folded before Flop (didn't bet)
Seat 4: onez69 (small blind) folded before Flop
Seat 5: klenius (big blind) collected ($6)
Seat 6: $-Twackle-$ folded before Flop (didn't bet)


PokerStars Game #102600636255:  Hold'em No Limit ($3/$6 USD) - 2013/08/11 7:39:15 ET
Table 'Lorcia IV 40-100 bb' 6-max Seat #4 is the button
Seat 1: Scarface.VLT ($600 in chips) 
Seat 2: Ratatuj ($268.68 in chips) 
Seat 3: ZarubaNT ($1351.45 in chips) 
Seat 4: onez69 ($216 in chips) 
Seat 5: klenius ($679.50 in chips) 
Seat 6: $-Twackle-$ ($1167.80 in chips) 
klenius: posts small blind $3
$-Twackle-$: posts big blind $6
*** HOLE CARDS ***
Scarface.VLT: folds 
Ratatuj: folds 
ZarubaNT: raises $9 to $15
onez69: folds 
klenius: raises $27 to $42
$-Twackle-$: folds 
ZarubaNT: raises $63 to $105
klenius: calls $63
*** FLOP *** [Th 7s Qh]
klenius: checks 
ZarubaNT: checks 
*** TURN *** [Th 7s Qh] [Jd]
klenius: bets $114
ZarubaNT: folds 
Uncalled bet ($114) returned to klenius
klenius collected $213.20 from pot
*** SUMMARY ***
Total pot $216 | Rake $2.80 
Board [Th 7s Qh Jd]
Seat 1: Scarface.VLT folded before Flop (didn't bet)
Seat 2: Ratatuj folded before Flop (didn't bet)
Seat 3: ZarubaNT folded on the Turn
Seat 4: onez69 (button) folded before Flop (didn't bet)
Seat 5: klenius (small blind) collected ($213.20)
Seat 6: $-Twackle-$ (big blind) folded before Flop


PokerStars Game #102600662007:  Hold'em No Limit ($3/$6 USD) - 2013/08/11 7:40:08 ET
Table 'Lorcia IV 40-100 bb' 6-max Seat #5 is the button
Seat 1: Scarface.VLT ($600 in chips) 
Seat 2: Ratatuj ($268.68 in chips) 
Seat 3: ZarubaNT ($1246.45 in chips) 
Seat 4: onez69 ($216 in chips) 
Seat 5: klenius ($787.70 in chips) 
Seat 6: $-Twackle-$ ($1161.80 in chips) 
$-Twackle-$: posts small blind $3
Scarface.VLT: posts big blind $6
*** HOLE CARDS ***
Ratatuj: folds 
ZarubaNT: folds 
onez69: folds 
klenius: folds 
$-Twackle-$: folds 
Uncalled bet ($3) returned to Scarface.VLT
Scarface.VLT collected $6 from pot
Scarface.VLT: doesn't show hand 
*** SUMMARY ***
Total pot $6 | Rake $0 
Seat 1: Scarface.VLT (big blind) collected ($6)
Seat 2: Ratatuj folded before Flop (didn't bet)
Seat 3: ZarubaNT folded before Flop (didn't bet)
Seat 4: onez69 folded before Flop (didn't bet)
Seat 5: klenius (button) folded before Flop (didn't bet)
Seat 6: $-Twackle-$ (small blind) folded before Flop


PokerStars Game #102600675971:  Hold'em No Limit ($3/$6 USD) - 2013/08/11 7:40:36 ET
Table 'Lorcia IV 40-100 bb' 6-max Seat #6 is the button
Seat 1: Scarface.VLT ($603 in chips) 
Seat 2: Ratatuj ($268.68 in chips) 
Seat 3: ZarubaNT ($1246.45 in chips) 
Seat 4: onez69 ($216 in chips) 
Seat 5: klenius ($787.70 in chips) 
Seat 6: $-Twackle-$ ($1158.80 in chips) 
Scarface.VLT: posts small blind $3
Ratatuj: posts big blind $6
*** HOLE CARDS ***
ZarubaNT: folds 
onez69: raises $9 to $15
klenius: folds 
$-Twackle-$: folds 
Scarface.VLT: folds 
Ratatuj: folds 
Uncalled bet ($9) returned to onez69
onez69 collected $15 from pot
onez69: doesn't show hand 
*** SUMMARY ***
Total pot $15 | Rake $0 
Seat 1: Scarface.VLT (small blind) folded before Flop
Seat 2: Ratatuj (big blind) folded before Flop
Seat 3: ZarubaNT folded before Flop (didn't bet)
Seat 4: onez69 collected ($15)
Seat 5: klenius folded before Flop (didn't bet)
Seat 6: $-Twackle-$ (button) folded before Flop (didn't bet)


PokerStars Game #102600690122:  Hold'em No Limit ($3/$6 USD) - 2013/08/11 7:41:05 ET
Table 'Lorcia IV 40-100 bb' 6-max Seat #1 is the button
Seat 1: Scarface.VLT ($600 in chips) 
Seat 2: Ratatuj ($262.68 in chips) 
Seat 3: ZarubaNT ($1246.45 in chips) 
Seat 4: onez69 ($225 in chips) 
Seat 5: klenius ($787.70 in chips) 
Seat 6: $-Twackle-$ ($1158.80 in chips) 
Ratatuj: posts small blind $3
ZarubaNT: posts big blind $6
*** HOLE CARDS ***
onez69: folds 
klenius: folds 
$-Twackle-$: folds 
Scarface.VLT: folds 
Ratatuj: raises $7.80 to $13.80
ZarubaNT: calls $7.80
*** FLOP *** [6d 5d Jh]
Ratatuj: bets $17.39
ZarubaNT: folds 
Uncalled bet ($17.39) returned to Ratatuj
Ratatuj collected $26.36 from pot
Ratatuj: doesn't show hand 
*** SUMMARY ***
Total pot $27.60 | Rake $1.24 
Board [6d 5d Jh]
Seat 1: Scarface.VLT (button) folded before Flop (didn't bet)
Seat 2: Ratatuj (small blind) collected ($26.36)
Seat 3: ZarubaNT (big blind) folded on the Flop
Seat 4: onez69 folded before Flop (didn't bet)
Seat 5: klenius folded before Flop (didn't bet)
Seat 6: $-Twackle-$ folded before Flop (didn't bet)


PokerStars Game #102600713789:  Hold'em No Limit ($3/$6 USD) - 2013/08/11 7:41:54 ET
Table 'Lorcia IV 40-100 bb' 6-max Seat #2 is the button
Seat 1: Scarface.VLT ($600 in chips) 
Seat 2: Ratatuj ($275.24 in chips) 
Seat 3: ZarubaNT ($1232.65 in chips) 
Seat 4: onez69 ($225 in chips) 
Seat 5: klenius ($787.70 in chips) 
Seat 6: $-Twackle-$ ($1158.80 in chips) 
ZarubaNT: posts small blind $3
onez69: posts big blind $6
*** HOLE CARDS ***
klenius: raises $6 to $12
$-Twackle-$: folds 
Scarface.VLT: raises $30 to $42
Ratatuj: folds 
ZarubaNT: folds 
onez69: folds 
klenius: calls $30
*** FLOP *** [2s Td Qc]
klenius: checks 
Scarface.VLT: bets $63.14
klenius: calls $63.14
*** TURN *** [2s Td Qc] [4h]
klenius: checks 
Scarface.VLT: bets $151.53
klenius: folds 
Uncalled bet ($151.53) returned to Scarface.VLT
Scarface.VLT collected $216.48 from pot
Scarface.VLT: doesn't show hand 
*** SUMMARY ***
Total pot $219.28 | Rake $2.80 
Board [2s Td Qc 4h]
Seat 1: Scarface.VLT collected ($216.48)
Seat 2: Ratatuj (button) folded before Flop (didn't bet)
Seat 3: ZarubaNT (small blind) folded before Flop
Seat 4: onez69 (big blind) folded before Flop
Seat 5: klenius folded on the Turn
Seat 6: $-Twackle-$ folded before Flop (didn't bet)


PokerStars Game #102600767085:  Hold'em No Limit ($3/$6 USD) - 2013/08/11 7:43:42 ET
Table 'Lorcia IV 40-100 bb' 6-max Seat #3 is the button
Seat 1: Scarface.VLT ($711.34 in chips) 
Seat 2: Ratatuj ($275.24 in chips) 
Seat 3: ZarubaNT ($1229.65 in chips) 
Seat 4: onez69 ($219 in chips) 
Seat 5: klenius ($682.56 in chips) 
Seat 6: $-Twackle-$ ($1158.80 in chips) 
onez69: posts small blind $3
klenius: posts big blind $6
*** HOLE CARDS ***
$-Twackle-$: folds 
Scarface.VLT: folds 
Ratatuj: folds 
ZarubaNT: raises $6 to $12
onez69: folds 
klenius: folds 
Uncalled bet ($6) returned to ZarubaNT
ZarubaNT collected $15 from pot
ZarubaNT: doesn't show hand 
*** SUMMARY ***
Total pot $15 | Rake $0 
Seat 1: Scarface.VLT folded before Flop (didn't bet)
Seat 2: Ratatuj folded before Flop (didn't bet)
Seat 3: ZarubaNT (button) collected ($15)
Seat 4: onez69 (small blind) folded before Flop
Seat 5: klenius (big blind) folded before Flop
Seat 6: $-Twackle-$ folded before Flop (didn't bet)


PokerStars Game #102600779128:  Hold'em No Limit ($3/$6 USD) - 2013/08/11 7:44:07 ET
Table 'Lorcia IV 40-100 bb' 6-max Seat #4 is the button
Seat 1: Scarface.VLT ($711.34 in chips) 
Seat 2: Ratatuj ($275.24 in chips) 
Seat 3: ZarubaNT ($1238.65 in chips) 
Seat 4: onez69 ($216 in chips) 
Seat 5: klenius ($676.56 in chips) 
Seat 6: $-Twackle-$ ($1158.80 in chips) 
klenius: posts small blind $3
$-Twackle-$: posts big blind $6
*** HOLE CARDS ***
Scarface.VLT: folds 
Ratatuj: folds 
ZarubaNT: raises $9 to $15
onez69: folds 
klenius: folds 
$-Twackle-$: folds 
Uncalled bet ($9) returned to ZarubaNT
ZarubaNT collected $15 from pot
ZarubaNT: doesn't show hand 
*** SUMMARY ***
Total pot $15 | Rake $0 
Seat 1: Scarface.VLT folded before Flop (didn't bet)
Seat 2: Ratatuj folded before Flop (didn't bet)
Seat 3: ZarubaNT collected ($15)
Seat 4: onez69 (button) folded before Flop (didn't bet)
Seat 5: klenius (small blind) folded before Flop
Seat 6: $-Twackle-$ (big blind) folded before Flop


PokerStars Game #102600791208:  Hold'em No Limit ($3/$6 USD) - 2013/08/11 7:44:32 ET
Table 'Lorcia IV 40-100 bb' 6-max Seat #5 is the button
Seat 1: Scarface.VLT ($711.34 in chips) 
Seat 2: Ratatuj ($275.24 in chips) 
Seat 3: ZarubaNT ($1247.65 in chips) 
Seat 4: onez69 ($216 in chips) 
Seat 5: klenius ($673.56 in chips) 
Seat 6: $-Twackle-$ ($1152.80 in chips) 
$-Twackle-$: posts small blind $3
Scarface.VLT: posts big blind $6
*** HOLE CARDS ***
Ratatuj: folds 
ZarubaNT: folds 
onez69: raises $9 to $15
klenius: calls $15
$-Twackle-$: folds 
Scarface.VLT: folds 
*** FLOP *** [9c 3h 7s]
onez69: bets $24
klenius: raises $30 to $54
onez69: raises $147 to $201 and is all-in
klenius: folds 
Uncalled bet ($147) returned to onez69
onez69 collected $144.20 from pot
onez69: doesn't show hand 
*** SUMMARY ***
Total pot $147 | Rake $2.80 
Board [9c 3h 7s]
Seat 1: Scarface.VLT (big blind) folded before Flop
Seat 2: Ratatuj folded before Flop (didn't bet)
Seat 3: ZarubaNT folded before Flop (didn't bet)
Seat 4: onez69 collected ($144.20)
Seat 5: klenius (button) folded on the Flop
Seat 6: $-Twackle-$ (small blind) folded before Flop


PokerStars Game #102600824642:  Hold'em No Limit ($3/$6 USD) - 2013/08/11 7:45:39 ET
Table 'Lorcia IV 40-100 bb' 6-max Seat #6 is the button
Seat 1: Scarface.VLT ($705.34 in chips) 
Seat 2: Ratatuj ($275.24 in chips) 
Seat 3: ZarubaNT ($1247.65 in chips) 
Seat 4: onez69 ($291.20 in chips) 
Seat 5: klenius ($604.56 in chips) 
Seat 6: $-Twackle-$ ($1149.80 in chips) 
Scarface.VLT: posts small blind $3
Ratatuj: posts big blind $6
*** HOLE CARDS ***
ZarubaNT: folds 
onez69: folds 
klenius: folds 
$-Twackle-$: folds 
Scarface.VLT: folds 
Uncalled bet ($3) returned to Ratatuj
Ratatuj collected $6 from pot
*** SUMMARY ***
Total pot $6 | Rake $0 
Seat 1: Scarface.VLT (small blind) folded before Flop
Seat 2: Ratatuj (big blind) collected ($6)
Seat 3: ZarubaNT folded before Flop (didn't bet)
Seat 4: onez69 folded before Flop (didn't bet)
Seat 5: klenius folded before Flop (didn't bet)
Seat 6: $-Twackle-$ (button) folded before Flop (didn't bet)


PokerStars Game #102600836576:  Hold'em No Limit ($3/$6 USD) - 2013/08/11 7:46:04 ET
Table 'Lorcia IV 40-100 bb' 6-max Seat #1 is the button
Seat 1: Scarface.VLT ($702.34 in chips) 
Seat 2: Ratatuj ($278.24 in chips) 
Seat 3: ZarubaNT ($1247.65 in chips) 
Seat 4: onez69 ($291.20 in chips) 
Seat 5: klenius ($604.56 in chips) 
Seat 6: $-Twackle-$ ($1149.80 in chips) 
Ratatuj: posts small blind $3
ZarubaNT: posts big blind $6
*** HOLE CARDS ***
onez69: raises $9 to $15
klenius: raises $33 to $48
$-Twackle-$: folds 
Scarface.VLT: folds 
Ratatuj: folds 
ZarubaNT: folds 
onez69: folds 
Uncalled bet ($33) returned to klenius
klenius collected $39 from pot
*** SUMMARY ***
Total pot $39 | Rake $0 
Seat 1: Scarface.VLT (button) folded before Flop (didn't bet)
Seat 2: Ratatuj (small blind) folded before Flop
Seat 3: ZarubaNT (big blind) folded before Flop
Seat 4: onez69 folded before Flop
Seat 5: klenius collected ($39)
Seat 6: $-Twackle-$ folded before Flop (didn't bet)


PokerStars Game #102600857766:  Hold'em No Limit ($3/$6 USD) - 2013/08/11 7:46:47 ET
Table 'Lorcia IV 40-100 bb' 6-max Seat #2 is the button
Seat 1: Scarface.VLT ($702.34 in chips) 
Seat 2: Ratatuj ($275.24 in chips) 
Seat 3: ZarubaNT ($1241.65 in chips) 
Seat 5: klenius ($628.56 in chips) 
Seat 6: $-Twackle-$ ($1149.80 in chips) 
ZarubaNT: posts small blind $3
onez69: is sitting out 
klenius: posts big blind $6
*** HOLE CARDS ***
$-Twackle-$: folds 
Scarface.VLT: raises $6 to $12
Ratatuj: folds 
ZarubaNT: calls $9
klenius: folds 
*** FLOP *** [3c 7d 4h]
ZarubaNT: checks 
onez69 leaves the table
Scarface.VLT: bets $20.05
ZarubaNT: folds 
Uncalled bet ($20.05) returned to Scarface.VLT
Scarface.VLT collected $28.65 from pot
Scarface.VLT: doesn't show hand 
*** SUMMARY ***
Total pot $30 | Rake $1.35 
Board [3c 7d 4h]
Seat 1: Scarface.VLT collected ($28.65)
Seat 2: Ratatuj (button) folded before Flop (didn't bet)
Seat 3: ZarubaNT (small blind) folded on the Flop
Seat 5: klenius (big blind) folded before Flop
Seat 6: $-Twackle-$ folded before Flop (didn't bet)


PokerStars Game #102600886040:  Hold'em No Limit ($3/$6 USD) - 2013/08/11 7:47:44 ET
Table 'Lorcia IV 40-100 bb' 6-max Seat #3 is the button
Seat 1: Scarface.VLT ($718.99 in chips) 
Seat 2: Ratatuj ($275.24 in chips) 
Seat 3: ZarubaNT ($1229.65 in chips) 
Seat 5: klenius ($622.56 in chips) 
Seat 6: $-Twackle-$ ($1149.80 in chips) 
klenius: posts small blind $3
$-Twackle-$: posts big blind $6
*** HOLE CARDS ***
Scarface.VLT: folds 
Ratatuj: raises $6 to $12
ZarubaNT: calls $12
klenius: folds 
$-Twackle-$: folds 
*** FLOP *** [4h 7d 5h]
Ratatuj: bets $20.80
ZarubaNT: raises $27.20 to $48
Ratatuj: calls $27.20
*** TURN *** [4h 7d 5h] [6d]
Ratatuj: checks 
ZarubaNT: bets $69
Ratatuj: folds 
Uncalled bet ($69) returned to ZarubaNT
ZarubaNT collected $126.20 from pot
ZarubaNT: doesn't show hand 
*** SUMMARY ***
Total pot $129 | Rake $2.80 
Board [4h 7d 5h 6d]
Seat 1: Scarface.VLT folded before Flop (didn't bet)
Seat 2: Ratatuj folded on the Turn
Seat 3: ZarubaNT (button) collected ($126.20)
Seat 5: klenius (small blind) folded before Flop
Seat 6: $-Twackle-$ (big blind) folded before Flop


PokerStars Game #102600921239:  Hold'em No Limit ($3/$6 USD) - 2013/08/11 7:48:56 ET
Table 'Lorcia IV 40-100 bb' 6-max Seat #5 is the button
Seat 1: Scarface.VLT ($718.99 in chips) 
Seat 2: Ratatuj ($215.24 in chips) 
Seat 3: ZarubaNT ($1295.85 in chips) 
Seat 5: klenius ($619.56 in chips) 
Seat 6: $-Twackle-$ ($1143.80 in chips) 
$-Twackle-$: posts small blind $3
Scarface.VLT: posts big blind $6
*** HOLE CARDS ***
Ratatuj: raises $7.32 to $13.32
ZarubaNT: folds 
klenius: folds 
$-Twackle-$: folds 
Scarface.VLT: raises $19.68 to $33
Ratatuj: folds 
Uncalled bet ($19.68) returned to Scarface.VLT
Scarface.VLT collected $29.64 from pot
Scarface.VLT: doesn't show hand 
*** SUMMARY ***
Total pot $29.64 | Rake $0 
Seat 1: Scarface.VLT (big blind) collected ($29.64)
Seat 2: Ratatuj folded before Flop
Seat 3: ZarubaNT folded before Flop (didn't bet)
Seat 5: klenius (button) folded before Flop (didn't bet)
Seat 6: $-Twackle-$ (small blind) folded before Flop


PokerStars Game #102600938193:  Hold'em No Limit ($3/$6 USD) - 2013/08/11 7:49:31 ET
Table 'Lorcia IV 40-100 bb' 6-max Seat #6 is the button
Seat 1: Scarface.VLT ($735.31 in chips) 
Seat 2: Ratatuj ($201.92 in chips) 
Seat 3: ZarubaNT ($1295.85 in chips) 
Seat 5: klenius ($619.56 in chips) 
Seat 6: $-Twackle-$ ($1140.80 in chips) 
Scarface.VLT: posts small blind $3
Ratatuj: posts big blind $6
*** HOLE CARDS ***
ZarubaNT: folds 
GERAKLmeat joins the table at seat #4 
klenius: folds 
$-Twackle-$: raises $7.20 to $13.20
Scarface.VLT: raises $28.80 to $42
Ratatuj: folds 
$-Twackle-$: folds 
Uncalled bet ($28.80) returned to Scarface.VLT
Scarface.VLT collected $32.40 from pot
Scarface.VLT: doesn't show hand 
*** SUMMARY ***
Total pot $32.40 | Rake $0 
Seat 1: Scarface.VLT (small blind) collected ($32.40)
Seat 2: Ratatuj (big blind) folded before Flop
Seat 3: ZarubaNT folded before Flop (didn't bet)
Seat 5: klenius folded before Flop (didn't bet)
Seat 6: $-Twackle-$ (button) folded before Flop


PokerStars Game #102600958580:  Hold'em No Limit ($3/$6 USD) - 2013/08/11 7:50:12 ET
Table 'Lorcia IV 40-100 bb' 6-max Seat #1 is the button
Seat 1: Scarface.VLT ($754.51 in chips) 
Seat 2: Ratatuj ($195.92 in chips) 
Seat 3: ZarubaNT ($1295.85 in chips) 
Seat 5: klenius ($619.56 in chips) 
Seat 6: $-Twackle-$ ($1127.60 in chips) 
Ratatuj: posts small blind $3
ZarubaNT: posts big blind $6
GERAKLmeat: sits out 
*** HOLE CARDS ***
klenius: folds 
$-Twackle-$: folds 
Scarface.VLT: folds 
Ratatuj: raises $7.80 to $13.80
ZarubaNT: calls $7.80
*** FLOP *** [7c 3d Kh]
Ratatuj: bets $17.39
ZarubaNT: folds 
Uncalled bet ($17.39) returned to Ratatuj
Ratatuj collected $26.36 from pot
Ratatuj: doesn't show hand 
*** SUMMARY ***
Total pot $27.60 | Rake $1.24 
Board [7c 3d Kh]
Seat 1: Scarface.VLT (button) folded before Flop (didn't bet)
Seat 2: Ratatuj (small blind) collected ($26.36)
Seat 3: ZarubaNT (big blind) folded on the Flop
Seat 5: klenius folded before Flop (didn't bet)
Seat 6: $-Twackle-$ folded before Flop (didn't bet)


PokerStars Game #102600979389:  Hold'em No Limit ($3/$6 USD) - 2013/08/11 7:50:54 ET
Table 'Lorcia IV 40-100 bb' 6-max Seat #2 is the button
Seat 1: Scarface.VLT ($754.51 in chips) 
Seat 2: Ratatuj ($208.48 in chips) 
Seat 3: ZarubaNT ($1282.05 in chips) 
Seat 4: GERAKLmeat ($283.03 in chips) 
Seat 5: klenius ($619.56 in chips) 
Seat 6: $-Twackle-$ ($1127.60 in chips) 
ZarubaNT: posts small blind $3
GERAKLmeat: posts big blind $6
*** HOLE CARDS ***
klenius: folds 
$-Twackle-$: folds 
Scarface.VLT: folds 
Ratatuj: folds 
ZarubaNT: folds 
Uncalled bet ($3) returned to GERAKLmeat
GERAKLmeat collected $6 from pot
GERAKLmeat: doesn't show hand 
*** SUMMARY ***
Total pot $6 | Rake $0 
Seat 1: Scarface.VLT folded before Flop (didn't bet)
Seat 2: Ratatuj (button) folded before Flop (didn't bet)
Seat 3: ZarubaNT (small blind) folded before Flop
Seat 4: GERAKLmeat (big blind) collected ($6)
Seat 5: klenius folded before Flop (didn't bet)
Seat 6: $-Twackle-$ folded before Flop (didn't bet)


PokerStars Game #102600991775:  Hold'em No Limit ($3/$6 USD) - 2013/08/11 7:51:19 ET
Table 'Lorcia IV 40-100 bb' 6-max Seat #3 is the button
Seat 1: Scarface.VLT ($754.51 in chips) 
Seat 2: Ratatuj ($208.48 in chips) 
Seat 3: ZarubaNT ($1279.05 in chips) 
Seat 4: GERAKLmeat ($286.03 in chips) 
Seat 5: klenius ($619.56 in chips) 
Seat 6: $-Twackle-$ ($1127.60 in chips) 
GERAKLmeat: posts small blind $3
klenius: posts big blind $6
*** HOLE CARDS ***
$-Twackle-$: folds 
Scarface.VLT: folds 
Ratatuj: raises $6 to $12
ZarubaNT: folds 
GERAKLmeat: raises $18 to $30
klenius: folds 
Ratatuj: raises $177 to $207
GERAKLmeat: folds 
Uncalled bet ($177) returned to Ratatuj
Ratatuj collected $66 from pot
Ratatuj: doesn't show hand 
*** SUMMARY ***
Total pot $66 | Rake $0 
Seat 1: Scarface.VLT folded before Flop (didn't bet)
Seat 2: Ratatuj collected ($66)
Seat 3: ZarubaNT (button) folded before Flop (didn't bet)
Seat 4: GERAKLmeat (small blind) folded before Flop
Seat 5: klenius (big blind) folded before Flop
Seat 6: $-Twackle-$ folded before Flop (didn't bet)


PokerStars Game #102601006274:  Hold'em No Limit ($3/$6 USD) - 2013/08/11 7:51:49 ET
Table 'Lorcia IV 40-100 bb' 6-max Seat #4 is the button
Seat 1: Scarface.VLT ($754.51 in chips) 
Seat 2: Ratatuj ($244.48 in chips) 
Seat 3: ZarubaNT ($1279.05 in chips) 
Seat 4: GERAKLmeat ($256.03 in chips) 
Seat 5: klenius ($613.56 in chips) 
Seat 6: $-Twackle-$ ($1127.60 in chips) 
klenius: posts small blind $3
$-Twackle-$: posts big blind $6
*** HOLE CARDS ***
Scarface.VLT: folds 
Ratatuj: folds 
ZarubaNT: raises $9 to $15
GERAKLmeat: folds 
klenius: calls $12
$-Twackle-$: folds 
*** FLOP *** [Qc Ah Th]
klenius: checks 
ZarubaNT: checks 
*** TURN *** [Qc Ah Th] [Kc]
klenius: bets $18
ZarubaNT: folds 
Uncalled bet ($18) returned to klenius
klenius collected $34.38 from pot
*** SUMMARY ***
Total pot $36 | Rake $1.62 
Board [Qc Ah Th Kc]
Seat 1: Scarface.VLT folded before Flop (didn't bet)
Seat 2: Ratatuj folded before Flop (didn't bet)
Seat 3: ZarubaNT folded on the Turn
Seat 4: GERAKLmeat (button) folded before Flop (didn't bet)
Seat 5: klenius (small blind) collected ($34.38)
Seat 6: $-Twackle-$ (big blind) folded before Flop


PokerStars Game #102601023093:  Hold'em No Limit ($3/$6 USD) - 2013/08/11 7:52:23 ET
Table 'Lorcia IV 40-100 bb' 6-max Seat #5 is the button
Seat 1: Scarface.VLT ($754.51 in chips) 
Seat 2: Ratatuj ($244.48 in chips) 
Seat 3: ZarubaNT ($1264.05 in chips) 
Seat 4: GERAKLmeat ($256.03 in chips) 
Seat 5: klenius ($632.94 in chips) 
Seat 6: $-Twackle-$ ($1121.60 in chips) 
$-Twackle-$: posts small blind $3
Scarface.VLT: posts big blind $6
*** HOLE CARDS ***
Ratatuj: raises $7.38 to $13.38
ZarubaNT: folds 
GERAKLmeat: folds 
klenius: folds 
$-Twackle-$: folds 
Scarface.VLT: folds 
Uncalled bet ($7.38) returned to Ratatuj
Ratatuj collected $15 from pot
Ratatuj: doesn't show hand 
*** SUMMARY ***
Total pot $15 | Rake $0 
Seat 1: Scarface.VLT (big blind) folded before Flop
Seat 2: Ratatuj collected ($15)
Seat 3: ZarubaNT folded before Flop (didn't bet)
Seat 4: GERAKLmeat folded before Flop (didn't bet)
Seat 5: klenius (button) folded before Flop (didn't bet)
Seat 6: $-Twackle-$ (small blind) folded before Flop


PokerStars Game #102601032413:  Hold'em No Limit ($3/$6 USD) - 2013/08/11 7:52:42 ET
Table 'Lorcia IV 40-100 bb' 6-max Seat #6 is the button
Seat 1: Scarface.VLT ($748.51 in chips) 
Seat 2: Ratatuj ($253.48 in chips) 
Seat 3: ZarubaNT ($1264.05 in chips) 
Seat 4: GERAKLmeat ($256.03 in chips) 
Seat 5: klenius ($632.94 in chips) 
Seat 6: $-Twackle-$ ($1118.60 in chips) 
Scarface.VLT: posts small blind $3
Ratatuj: posts big blind $6
*** HOLE CARDS ***
ZarubaNT: folds 
GERAKLmeat: folds 
klenius: folds 
$-Twackle-$: raises $7.20 to $13.20
Scarface.VLT: raises $28.80 to $42
Ratatuj: folds 
$-Twackle-$: folds 
Uncalled bet ($28.80) returned to Scarface.VLT
Scarface.VLT collected $32.40 from pot
Scarface.VLT: doesn't show hand 
*** SUMMARY ***
Total pot $32.40 | Rake $0 
Seat 1: Scarface.VLT (small blind) collected ($32.40)
Seat 2: Ratatuj (big blind) folded before Flop
Seat 3: ZarubaNT folded before Flop (didn't bet)
Seat 4: GERAKLmeat folded before Flop (didn't bet)
Seat 5: klenius folded before Flop (didn't bet)
Seat 6: $-Twackle-$ (button) folded before Flop


PokerStars Game #102601045205:  Hold'em No Limit ($3/$6 USD) - 2013/08/11 7:53:08 ET
Table 'Lorcia IV 40-100 bb' 6-max Seat #1 is the button
Seat 1: Scarface.VLT ($767.71 in chips) 
Seat 2: Ratatuj ($247.48 in chips) 
Seat 3: ZarubaNT ($1264.05 in chips) 
Seat 4: GERAKLmeat ($256.03 in chips) 
Seat 5: klenius ($632.94 in chips) 
Seat 6: $-Twackle-$ ($1105.40 in chips) 
Ratatuj: posts small blind $3
ZarubaNT: posts big blind $6
*** HOLE CARDS ***
GERAKLmeat: folds 
klenius: raises $6 to $12
$-Twackle-$: folds 
Scarface.VLT: raises $30 to $42
Ratatuj: folds 
ZarubaNT: folds 
klenius: calls $30
*** FLOP *** [Jc 4h 7c]
klenius: checks 
Scarface.VLT: checks 
*** TURN *** [Jc 4h 7c] [4d]
klenius: bets $78
Scarface.VLT: folds 
Uncalled bet ($78) returned to klenius
klenius collected $90.20 from pot
*** SUMMARY ***
Total pot $93 | Rake $2.80 
Board [Jc 4h 7c 4d]
Seat 1: Scarface.VLT (button) folded on the Turn
Seat 2: Ratatuj (small blind) folded before Flop
Seat 3: ZarubaNT (big blind) folded before Flop
Seat 4: GERAKLmeat folded before Flop (didn't bet)
Seat 5: klenius collected ($90.20)
Seat 6: $-Twackle-$ folded before Flop (didn't bet)


PokerStars Game #102601067473:  Hold'em No Limit ($3/$6 USD) - 2013/08/11 7:53:54 ET
Table 'Lorcia IV 40-100 bb' 6-max Seat #2 is the button
Seat 1: Scarface.VLT ($725.71 in chips) 
Seat 2: Ratatuj ($244.48 in chips) 
Seat 3: ZarubaNT ($1258.05 in chips) 
Seat 4: GERAKLmeat ($256.03 in chips) 
Seat 5: klenius ($681.14 in chips) 
Seat 6: $-Twackle-$ ($1105.40 in chips) 
ZarubaNT: posts small blind $3
GERAKLmeat: posts big blind $6
*** HOLE CARDS ***
klenius: folds 
$-Twackle-$: folds 
Scarface.VLT: raises $6 to $12
Ratatuj: raises $18 to $30
ZarubaNT: folds 
GERAKLmeat: folds 
Scarface.VLT: folds 
Uncalled bet ($18) returned to Ratatuj
Ratatuj collected $33 from pot
Ratatuj: doesn't show hand 
*** SUMMARY ***
Total pot $33 | Rake $0 
Seat 1: Scarface.VLT folded before Flop
Seat 2: Ratatuj (button) collected ($33)
Seat 3: ZarubaNT (small blind) folded before Flop
Seat 4: GERAKLmeat (big blind) folded before Flop
Seat 5: klenius folded before Flop (didn't bet)
Seat 6: $-Twackle-$ folded before Flop (didn't bet)


PokerStars Game #102601086262:  Hold'em No Limit ($3/$6 USD) - 2013/08/11 7:54:32 ET
Table 'Lorcia IV 40-100 bb' 6-max Seat #3 is the button
Seat 1: Scarface.VLT ($713.71 in chips) 
Seat 2: Ratatuj ($265.48 in chips) 
Seat 3: ZarubaNT ($1255.05 in chips) 
Seat 4: GERAKLmeat ($250.03 in chips) 
Seat 5: klenius ($681.14 in chips) 
Seat 6: $-Twackle-$ ($1105.40 in chips) 
GERAKLmeat: posts small blind $3
klenius: posts big blind $6
*** HOLE CARDS ***
$-Twackle-$: folds 
Scarface.VLT: folds 
Ratatuj: folds 
ZarubaNT: folds 
GERAKLmeat: raises $6 to $12
klenius: folds 
Uncalled bet ($6) returned to GERAKLmeat
GERAKLmeat collected $12 from pot
GERAKLmeat: doesn't show hand 
*** SUMMARY ***
Total pot $12 | Rake $0 
Seat 1: Scarface.VLT folded before Flop (didn't bet)
Seat 2: Ratatuj folded before Flop (didn't bet)
Seat 3: ZarubaNT (button) folded before Flop (didn't bet)
Seat 4: GERAKLmeat (small blind) collected ($12)
Seat 5: klenius (big blind) folded before Flop
Seat 6: $-Twackle-$ folded before Flop (didn't bet)


PokerStars Game #102601096164:  Hold'em No Limit ($3/$6 USD) - 2013/08/11 7:54:53 ET
Table 'Lorcia IV 40-100 bb' 6-max Seat #4 is the button
Seat 1: Scarface.VLT ($713.71 in chips) 
Seat 2: Ratatuj ($265.48 in chips) 
Seat 3: ZarubaNT ($1255.05 in chips) 
Seat 4: GERAKLmeat ($256.03 in chips) 
Seat 5: klenius ($675.14 in chips) 
Seat 6: $-Twackle-$ ($1105.40 in chips) 
klenius: posts small blind $3
$-Twackle-$: posts big blind $6
*** HOLE CARDS ***
Scarface.VLT: folds 
Ratatuj: raises $7.32 to $13.32
ZarubaNT: folds 
GERAKLmeat: folds 
klenius: folds 
$-Twackle-$: folds 
Uncalled bet ($7.32) returned to Ratatuj
Ratatuj collected $15 from pot
Ratatuj: doesn't show hand 
*** SUMMARY ***
Total pot $15 | Rake $0 
Seat 1: Scarface.VLT folded before Flop (didn't bet)
Seat 2: Ratatuj collected ($15)
Seat 3: ZarubaNT folded before Flop (didn't bet)
Seat 4: GERAKLmeat (button) folded before Flop (didn't bet)
Seat 5: klenius (small blind) folded before Flop
Seat 6: $-Twackle-$ (big blind) folded before Flop


PokerStars Game #102600130815:  Hold'em No Limit ($3/$6 USD) - 2013/08/11 7:21:40 ET
Table 'Lorcia IV 40-100 bb' 6-max Seat #5 is the button
Seat 1: WhatA298 ($600 in chips) 
Seat 5: klenius ($600 in chips) 
Seat 6: $-Twackle-$ ($600 in chips) 
$-Twackle-$: posts small blind $3
WhatA298: posts big blind $6
*** HOLE CARDS ***
klenius: folds 
$-Twackle-$: folds 
Uncalled bet ($3) returned to WhatA298
WhatA298 collected $6 from pot
WhatA298: doesn't show hand 
*** SUMMARY ***
Total pot $6 | Rake $0 
Seat 1: WhatA298 (big blind) collected ($6)
Seat 5: klenius (button) folded before Flop (didn't bet)
Seat 6: $-Twackle-$ (small blind) folded before Flop


PokerStars Game #102600169491:  Hold'em No Limit ($3/$6 USD) - 2013/08/11 7:23:03 ET
Table 'Lorcia IV 40-100 bb' 6-max Seat #6 is the button
Seat 1: WhatA298 ($618.22 in chips) 
Seat 2: Nahar ($240 in chips) 
Seat 6: $-Twackle-$ ($600 in chips) 
WhatA298: posts small blind $3
Nahar: posts big blind $6
Sir_Fuj1: sits out 
klenius: sits out 
*** HOLE CARDS ***
$-Twackle-$: raises $7.20 to $13.20
WhatA298: folds 
Nahar: raises $22.80 to $36
$-Twackle-$: folds 
Uncalled bet ($22.80) returned to Nahar
Nahar collected $29.40 from pot
*** SUMMARY ***
Total pot $29.40 | Rake $0 
Seat 1: WhatA298 (small blind) folded before Flop
Seat 2: Nahar (big blind) collected ($29.40)
Seat 6: $-Twackle-$ (button) folded before Flop


PokerStars Game #102600186958:  Hold'em No Limit ($3/$6 USD) - 2013/08/11 7:23:40 ET
Table 'Lorcia IV 40-100 bb' 6-max Seat #1 is the button
Seat 1: WhatA298 ($615.22 in chips) 
Seat 2: Nahar ($256.20 in chips) 
Seat 4: Sir_Fuj1 ($240 in chips) 
Seat 6: $-Twackle-$ ($600 in chips) 
Nahar: posts small blind $3
Sir_Fuj1: posts big blind $6
klenius: sits out 
*** HOLE CARDS ***
$-Twackle-$: raises $10.20 to $16.20
WhatA298: folds 
Nahar: folds 
Sir_Fuj1: raises $25.80 to $42
$-Twackle-$: folds 
Uncalled bet ($25.80) returned to Sir_Fuj1
Sir_Fuj1 collected $35.40 from pot
Sir_Fuj1: doesn't show hand 
*** SUMMARY ***
Total pot $35.40 | Rake $0 
Seat 1: WhatA298 (button) folded before Flop (didn't bet)
Seat 2: Nahar (small blind) folded before Flop
Seat 4: Sir_Fuj1 (big blind) collected ($35.40)
Seat 6: $-Twackle-$ folded before Flop


PokerStars Game #102600203761:  Hold'em No Limit ($3/$6 USD) - 2013/08/11 7:24:16 ET
Table 'Lorcia IV 40-100 bb' 6-max Seat #2 is the button
Seat 1: WhatA298 ($615.22 in chips) 
Seat 2: Nahar ($253.20 in chips) 
Seat 4: Sir_Fuj1 ($259.20 in chips) 
Seat 5: klenius ($600 in chips) 
Seat 6: $-Twackle-$ ($600 in chips) 
Sir_Fuj1: posts small blind $3
klenius: posts big blind $6
*** HOLE CARDS ***
$-Twackle-$: folds 
WhatA298: raises $6.72 to $12.72
Nahar: folds 
Sir_Fuj1: folds 
klenius: raises $29.28 to $42
WhatA298: folds 
Uncalled bet ($29.28) returned to klenius
klenius collected $28.44 from pot
*** SUMMARY ***
Total pot $28.44 | Rake $0 
Seat 1: WhatA298 folded before Flop
Seat 2: Nahar (button) folded before Flop (didn't bet)
Seat 4: Sir_Fuj1 (small blind) folded before Flop
Seat 5: klenius (big blind) collected ($28.44)
Seat 6: $-Twackle-$ folded before Flop (didn't bet)


PokerStars Game #102600218757:  Hold'em No Limit ($3/$6 USD) - 2013/08/11 7:24:48 ET
Table 'Lorcia IV 40-100 bb' 6-max Seat #4 is the button
Seat 1: WhatA298 ($602.50 in chips) 
Seat 2: Nahar ($253.20 in chips) 
Seat 4: Sir_Fuj1 ($256.20 in chips) 
Seat 5: klenius ($615.72 in chips) 
Seat 6: $-Twackle-$ ($600 in chips) 
klenius: posts small blind $3
$-Twackle-$: posts big blind $6
*** HOLE CARDS ***
WhatA298: folds 
Nahar: folds 
Sir_Fuj1: raises $9 to $15
klenius: folds 
$-Twackle-$: folds 
Uncalled bet ($9) returned to Sir_Fuj1
Sir_Fuj1 collected $15 from pot
Sir_Fuj1: doesn't show hand 
*** SUMMARY ***
Total pot $15 | Rake $0 
Seat 1: WhatA298 folded before Flop (didn't bet)
Seat 2: Nahar folded before Flop (didn't bet)
Seat 4: Sir_Fuj1 (button) collected ($15)
Seat 5: klenius (small blind) folded before Flop
Seat 6: $-Twackle-$ (big blind) folded before Flop


PokerStars Game #102600225840:  Hold'em No Limit ($3/$6 USD) - 2013/08/11 7:25:03 ET
Table 'Lorcia IV 40-100 bb' 6-max Seat #5 is the button
Seat 1: WhatA298 ($602.50 in chips) 
Seat 2: Nahar ($253.20 in chips) 
Seat 4: Sir_Fuj1 ($265.20 in chips) 
Seat 5: klenius ($612.72 in chips) 
Seat 6: $-Twackle-$ ($600 in chips) 
$-Twackle-$: posts small blind $3
WhatA298: posts big blind $6
*** HOLE CARDS ***
Nahar: raises $9 to $15
Sir_Fuj1: folds 
klenius: folds 
$-Twackle-$: folds 
WhatA298: folds 
Uncalled bet ($9) returned to Nahar
Nahar collected $15 from pot
*** SUMMARY ***
Total pot $15 | Rake $0 
Seat 1: WhatA298 (big blind) folded before Flop
Seat 2: Nahar collected ($15)
Seat 4: Sir_Fuj1 folded before Flop (didn't bet)
Seat 5: klenius (button) folded before Flop (didn't bet)
Seat 6: $-Twackle-$ (small blind) folded before Flop


PokerStars Game #102600241784:  Hold'em No Limit ($3/$6 USD) - 2013/08/11 7:25:36 ET
Table 'Lorcia IV 40-100 bb' 6-max Seat #6 is the button
Seat 1: WhatA298 ($600 in chips) 
Seat 4: Sir_Fuj1 ($265.20 in chips) 
Seat 5: klenius ($612.72 in chips) 
Seat 6: $-Twackle-$ ($600 in chips) 
WhatA298: posts small blind $3
Nahar: is sitting out 
Sir_Fuj1: posts big blind $6
*** HOLE CARDS ***
Nahar leaves the table
klenius: raises $6 to $12
$-Twackle-$: folds 
WhatA298: calls $9
Sir_Fuj1: folds 
*** FLOP *** [4c Qc 7d]
WhatA298: checks 
klenius: bets $18
WhatA298: folds 
Uncalled bet ($18) returned to klenius
klenius collected $28.65 from pot
*** SUMMARY ***
Total pot $30 | Rake $1.35 
Board [4c Qc 7d]
Seat 1: WhatA298 (small blind) folded on the Flop
Seat 4: Sir_Fuj1 (big blind) folded before Flop
Seat 5: klenius collected ($28.65)
Seat 6: $-Twackle-$ (button) folded before Flop (didn't bet)


PokerStars Game #102600276155:  Hold'em No Limit ($3/$6 USD) - 2013/08/11 7:26:50 ET
Table 'Lorcia IV 40-100 bb' 6-max Seat #1 is the button
Seat 1: WhatA298 ($600 in chips) 
Seat 4: Sir_Fuj1 ($259.20 in chips) 
Seat 5: klenius ($629.37 in chips) 
Seat 6: $-Twackle-$ ($600 in chips) 
Sir_Fuj1: posts small blind $3
klenius: posts big blind $6
*** HOLE CARDS ***
$-Twackle-$: folds 
WhatA298: raises $6.72 to $12.72
Sir_Fuj1: folds 
klenius: raises $29.28 to $42
WhatA298: folds 
Uncalled bet ($29.28) returned to klenius
klenius collected $28.44 from pot
*** SUMMARY ***
Total pot $28.44 | Rake $0 
Seat 1: WhatA298 (button) folded before Flop
Seat 4: Sir_Fuj1 (small blind) folded before Flop
Seat 5: klenius (big blind) collected ($28.44)
Seat 6: $-Twackle-$ folded before Flop (didn't bet)


PokerStars Game #102600299162:  Hold'em No Limit ($3/$6 USD) - 2013/08/11 7:27:39 ET
Table 'Lorcia IV 40-100 bb' 6-max Seat #4 is the button
Seat 1: WhatA298 ($600 in chips) 
Seat 4: Sir_Fuj1 ($256.20 in chips) 
Seat 5: klenius ($645.09 in chips) 
Seat 6: $-Twackle-$ ($600 in chips) 
klenius: posts small blind $3
$-Twackle-$: posts big blind $6
*** HOLE CARDS ***
WhatA298: folds 
Nahar joins the table at seat #2 
Nahar leaves the table
Sir_Fuj1: raises $9 to $15
klenius: folds 
$-Twackle-$: folds 
Uncalled bet ($9) returned to Sir_Fuj1
Sir_Fuj1 collected $15 from pot
Sir_Fuj1: doesn't show hand 
*** SUMMARY ***
Total pot $15 | Rake $0 
Seat 1: WhatA298 folded before Flop (didn't bet)
Seat 4: Sir_Fuj1 (button) collected ($15)
Seat 5: klenius (small blind) folded before Flop
Seat 6: $-Twackle-$ (big blind) folded before Flop


PokerStars Game #102600312668:  Hold'em No Limit ($3/$6 USD) - 2013/08/11 7:28:08 ET
Table 'Lorcia IV 40-100 bb' 6-max Seat #5 is the button
Seat 4: Sir_Fuj1 ($265.20 in chips) 
Seat 5: klenius ($642.09 in chips) 
Seat 6: $-Twackle-$ ($600 in chips) 
$-Twackle-$: posts small blind $3
WhatA298: is sitting out 
WhatA298 leaves the table
Sir_Fuj1: posts big blind $6
*** HOLE CARDS ***
klenius: folds 
$-Twackle-$: folds 
Uncalled bet ($3) returned to Sir_Fuj1
Sir_Fuj1 collected $6 from pot
Sir_Fuj1: doesn't show hand 
*** SUMMARY ***
Total pot $6 | Rake $0 
Seat 4: Sir_Fuj1 (big blind) collected ($6)
Seat 5: klenius (button) folded before Flop (didn't bet)
Seat 6: $-Twackle-$ (small blind) folded before Flop


PokerStars Game #102600317224:  Hold'em No Limit ($3/$6 USD) - 2013/08/11 7:28:17 ET
Table 'Lorcia IV 40-100 bb' 6-max Seat #6 is the button
Seat 4: Sir_Fuj1 ($268.20 in chips) 
Seat 5: klenius ($642.09 in chips) 
Seat 6: $-Twackle-$ ($600 in chips) 
Sir_Fuj1: posts small blind $3
klenius: posts big blind $6
*** HOLE CARDS ***
$-Twackle-$: folds 
Sir_Fuj1: raises $9 to $15
klenius: calls $9
*** FLOP *** [7s Ad Qd]
Sir_Fuj1: bets $15
klenius: raises $39 to $54
Sir_Fuj1: folds 
Uncalled bet ($39) returned to klenius
klenius collected $58.50 from pot
*** SUMMARY ***
Total pot $60 | Rake $1.50 
Board [7s Ad Qd]
Seat 4: Sir_Fuj1 (small blind) folded on the Flop
Seat 5: klenius (big blind) collected ($58.50)
Seat 6: $-Twackle-$ (button) folded before Flop (didn't bet)


PokerStars Game #102600332761:  Hold'em No Limit ($3/$6 USD) - 2013/08/11 7:28:50 ET
Table 'Lorcia IV 40-100 bb' 6-max Seat #4 is the button
Seat 4: Sir_Fuj1 ($238.20 in chips) 
Seat 5: klenius ($670.59 in chips) 
Seat 6: $-Twackle-$ ($600 in chips) 
klenius: posts small blind $3
$-Twackle-$: posts big blind $6
kakagun: sits out 
*** HOLE CARDS ***
Sir_Fuj1: raises $9 to $15
klenius: folds 
Nahar joins the table at seat #1 
Ratatuj joins the table at seat #2 
$-Twackle-$: folds 
Uncalled bet ($9) returned to Sir_Fuj1
Sir_Fuj1 collected $15 from pot
Sir_Fuj1: doesn't show hand 
*** SUMMARY ***
Total pot $15 | Rake $0 
Seat 4: Sir_Fuj1 (button) collected ($15)
Seat 5: klenius (small blind) folded before Flop
Seat 6: $-Twackle-$ (big blind) folded before Flop


PokerStars Game #102600345206:  Hold'em No Limit ($3/$6 USD) - 2013/08/11 7:29:16 ET
Table 'Lorcia IV 40-100 bb' 6-max Seat #5 is the button
Seat 1: Nahar ($262.20 in chips) 
Seat 4: Sir_Fuj1 ($247.20 in chips) 
Seat 5: klenius ($667.59 in chips) 
Seat 6: $-Twackle-$ ($600 in chips) 
$-Twackle-$: posts small blind $3
Nahar: posts big blind $6
Ratatuj: sits out 
kakagun: sits out 
*** HOLE CARDS ***
Sir_Fuj1: folds 
klenius: folds 
$-Twackle-$: raises $9 to $15
kakagun leaves the table
Nahar: folds 
Uncalled bet ($9) returned to $-Twackle-$
$-Twackle-$ collected $12 from pot
$-Twackle-$: doesn't show hand 
*** SUMMARY ***
Total pot $12 | Rake $0 
Seat 1: Nahar (big blind) folded before Flop
Seat 4: Sir_Fuj1 folded before Flop (didn't bet)
Seat 5: klenius (button) folded before Flop (didn't bet)
Seat 6: $-Twackle-$ (small blind) collected ($12)


PokerStars Game #102600357574:  Hold'em No Limit ($3/$6 USD) - 2013/08/11 7:29:42 ET
Table 'Lorcia IV 40-100 bb' 6-max Seat #6 is the button
Seat 1: Nahar ($256.20 in chips) 
Seat 2: Ratatuj ($240 in chips) 
Seat 4: Sir_Fuj1 ($247.20 in chips) 
Seat 5: klenius ($667.59 in chips) 
Seat 6: $-Twackle-$ ($606 in chips) 
Nahar: posts small blind $3
Ratatuj: posts big blind $6
*** HOLE CARDS ***
Sir_Fuj1: folds 
klenius: folds 
$-Twackle-$: folds 
Nahar: raises $9 to $15
Ratatuj: folds 
Uncalled bet ($9) returned to Nahar
Nahar collected $12 from pot
*** SUMMARY ***
Total pot $12 | Rake $0 
Seat 1: Nahar (small blind) collected ($12)
Seat 2: Ratatuj (big blind) folded before Flop
Seat 4: Sir_Fuj1 folded before Flop (didn't bet)
Seat 5: klenius folded before Flop (didn't bet)
Seat 6: $-Twackle-$ (button) folded before Flop (didn't bet)


PokerStars Game #102600137198:  Hold'em No Limit ($3/$6 USD) - 2013/08/11 7:21:54 ET
Table 'Lorcia IV 40-100 bb' 6-max Seat #1 is the button
Seat 1: WhatA298 ($603 in chips) 
Seat 6: $-Twackle-$ ($600 in chips) 
WhatA298: posts small blind $3
$-Twackle-$: posts big blind $6
*** HOLE CARDS ***
WhatA298: raises $6.72 to $12.72
$-Twackle-$: calls $6.72
*** FLOP *** [4c 2h 6d]
$-Twackle-$: checks 
kakagun joins the table at seat #3 
Nahar joins the table at seat #2 
Sir_Fuj1 joins the table at seat #4 
WhatA298: bets $16.46
$-Twackle-$: folds 
Uncalled bet ($16.46) returned to WhatA298
WhatA298 collected $24.94 from pot
WhatA298: doesn't show hand 
*** SUMMARY ***
Total pot $25.44 | Rake $0.50 
Board [4c 2h 6d]
Seat 1: WhatA298 (button) (small blind) collected ($24.94)
Seat 6: $-Twackle-$ (big blind) folded on the Flop


PokerStars Game #102600163721:  Hold'em No Limit ($3/$6 USD) - 2013/08/11 7:22:50 ET
Table 'Lorcia IV 40-100 bb' 6-max Seat #6 is the button
Seat 1: WhatA298 ($615.22 in chips) 
Seat 6: $-Twackle-$ ($600 in chips) 
$-Twackle-$: posts small blind $3
WhatA298: posts big blind $6
*** HOLE CARDS ***
$-Twackle-$: folds 
Uncalled bet ($3) returned to WhatA298
WhatA298 collected $6 from pot
WhatA298: doesn't show hand 
*** SUMMARY ***
Total pot $6 | Rake $0 
Seat 1: WhatA298 (big blind) collected ($6)
Seat 6: $-Twackle-$ (button) (small blind) folded before Flop


PokerStars Game #102602828843:  Hold'em No Limit ($3/$6 USD) - 2013/08/11 8:50:06 ET
Table 'Lorcia IV 40-100 bb' 6-max Seat #5 is the button
Seat 1: Scarface.VLT ($836.88 in chips) 
Seat 2: patapong ($833 in chips) 
Seat 3: ZarubaNT ($600 in chips) 
Seat 4: floriiiiider ($1245.20 in chips) 
Seat 5: klenius ($1507.66 in chips) 
Seat 6: Chappolini ($867.20 in chips) 
Chappolini: posts small blind $3
Scarface.VLT: posts big blind $6
*** HOLE CARDS ***
patapong: folds 
ZarubaNT: folds 
floriiiiider: folds 
klenius: raises $6 to $12
Chappolini: folds 
Scarface.VLT: calls $6
*** FLOP *** [5d 8d Qc]
Scarface.VLT: checks 
klenius: bets $18
Scarface.VLT: calls $18
*** TURN *** [5d 8d Qc] [9h]
Scarface.VLT: checks 
klenius: bets $48
Scarface.VLT: calls $48
*** RIVER *** [5d 8d Qc 9h] [3d]
Scarface.VLT: checks 
klenius: bets $96
Scarface.VLT: folds 
Uncalled bet ($96) returned to klenius
klenius collected $156.20 from pot
*** SUMMARY ***
Total pot $159 | Rake $2.80 
Board [5d 8d Qc 9h 3d]
Seat 1: Scarface.VLT (big blind) folded on the River
Seat 2: patapong folded before Flop (didn't bet)
Seat 3: ZarubaNT folded before Flop (didn't bet)
Seat 4: floriiiiider folded before Flop (didn't bet)
Seat 5: klenius (button) collected ($156.20)
Seat 6: Chappolini (small blind) folded before Flop


PokerStars Game #102602878044:  Hold'em No Limit ($3/$6 USD) - 2013/08/11 8:51:36 ET
Table 'Lorcia IV 40-100 bb' 6-max Seat #6 is the button
Seat 1: Scarface.VLT ($758.88 in chips) 
Seat 2: patapong ($833 in chips) 
Seat 3: ZarubaNT ($600 in chips) 
Seat 4: floriiiiider ($1245.20 in chips) 
Seat 5: klenius ($1585.86 in chips) 
Seat 6: Chappolini ($864.20 in chips) 
Scarface.VLT: posts small blind $3
patapong: posts big blind $6
*** HOLE CARDS ***
ZarubaNT: folds 
floriiiiider: folds 
klenius: folds 
Chappolini: folds 
Scarface.VLT: raises $12 to $18
patapong: calls $12
*** FLOP *** [Tc As 5c]
Scarface.VLT: bets $24.06
patapong: calls $24.06
*** TURN *** [Tc As 5c] [9c]
Scarface.VLT: checks 
patapong: bets $52.86
Scarface.VLT: folds 
Uncalled bet ($52.86) returned to patapong
patapong collected $81.32 from pot
*** SUMMARY ***
Total pot $84.12 | Rake $2.80 
Board [Tc As 5c 9c]
Seat 1: Scarface.VLT (small blind) folded on the Turn
Seat 2: patapong (big blind) collected ($81.32)
Seat 3: ZarubaNT folded before Flop (didn't bet)
Seat 4: floriiiiider folded before Flop (didn't bet)
Seat 5: klenius folded before Flop (didn't bet)
Seat 6: Chappolini (button) folded before Flop (didn't bet)


PokerStars Game #102602931819:  Hold'em No Limit ($3/$6 USD) - 2013/08/11 8:53:15 ET
Table 'Lorcia IV 40-100 bb' 6-max Seat #1 is the button
Seat 1: Scarface.VLT ($716.82 in chips) 
Seat 2: patapong ($872.26 in chips) 
Seat 4: floriiiiider ($1245.20 in chips) 
Seat 5: klenius ($1585.86 in chips) 
Seat 6: Chappolini ($864.20 in chips) 
patapong: posts small blind $3
ZarubaNT: is sitting out 
floriiiiider: posts big blind $6
*** HOLE CARDS ***
ZarubaNT leaves the table
klenius: folds 
Chappolini: raises $9 to $15
Scarface.VLT: raises $21 to $36
patapong: folds 
floriiiiider: folds 
Chappolini: raises $54 to $90
VegasMidas joins the table at seat #3 
Scarface.VLT: folds 
Uncalled bet ($54) returned to Chappolini
Chappolini collected $81 from pot
Chappolini: doesn't show hand 
*** SUMMARY ***
Total pot $81 | Rake $0 
Seat 1: Scarface.VLT (button) folded before Flop
Seat 2: patapong (small blind) folded before Flop
Seat 4: floriiiiider (big blind) folded before Flop
Seat 5: klenius folded before Flop (didn't bet)
Seat 6: Chappolini collected ($81)


PokerStars Game #102602979514:  Hold'em No Limit ($3/$6 USD) - 2013/08/11 8:54:43 ET
Table 'Lorcia IV 40-100 bb' 6-max Seat #2 is the button
Seat 1: Scarface.VLT ($680.82 in chips) 
Seat 2: patapong ($869.26 in chips) 
Seat 4: floriiiiider ($1239.20 in chips) 
Seat 5: klenius ($1585.86 in chips) 
Seat 6: Chappolini ($909.20 in chips) 
VegasMidas will be allowed to play after the button
floriiiiider: posts small blind $3
klenius: posts big blind $6
*** HOLE CARDS ***
Chappolini: folds 
Scarface.VLT: folds 
patapong: raises $6 to $12
floriiiiider: folds 
klenius: folds 
Uncalled bet ($6) returned to patapong
patapong collected $15 from pot
*** SUMMARY ***
Total pot $15 | Rake $0 
Seat 1: Scarface.VLT folded before Flop (didn't bet)
Seat 2: patapong (button) collected ($15)
Seat 4: floriiiiider (small blind) folded before Flop
Seat 5: klenius (big blind) folded before Flop
Seat 6: Chappolini folded before Flop (didn't bet)


PokerStars Game #102602416670:  Hold'em No Limit ($3/$6 USD) - 2013/08/11 8:37:37 ET
Table 'Lorcia IV 40-100 bb' 6-max Seat #5 is the button
Seat 1: Scarface.VLT ($862.10 in chips) 
Seat 2: patapong ($984.16 in chips) 
Seat 3: ZarubaNT ($830.53 in chips) 
Seat 5: klenius ($1456.26 in chips) 
Seat 6: Chappolini ($765 in chips) 
Chappolini: posts small blind $3
Scarface.VLT: posts big blind $6
*** HOLE CARDS ***
patapong: raises $9 to $15
ZarubaNT: folds 
klenius: calls $15
floriiiiider joins the table at seat #4 
Chappolini: folds 
Scarface.VLT: folds 
*** FLOP *** [3s Kd 8s]
patapong: bets $24
klenius: raises $48 to $72
patapong: folds 
Uncalled bet ($48) returned to klenius
klenius collected $84.20 from pot
*** SUMMARY ***
Total pot $87 | Rake $2.80 
Board [3s Kd 8s]
Seat 1: Scarface.VLT (big blind) folded before Flop
Seat 2: patapong folded on the Flop
Seat 3: ZarubaNT folded before Flop (didn't bet)
Seat 5: klenius (button) collected ($84.20)
Seat 6: Chappolini (small blind) folded before Flop


PokerStars Game #102602445741:  Hold'em No Limit ($3/$6 USD) - 2013/08/11 8:38:29 ET
Table 'Lorcia IV 40-100 bb' 6-max Seat #6 is the button
Seat 1: Scarface.VLT ($856.10 in chips) 
Seat 2: patapong ($945.16 in chips) 
Seat 3: ZarubaNT ($830.53 in chips) 
Seat 5: klenius ($1501.46 in chips) 
Seat 6: Chappolini ($762 in chips) 
Scarface.VLT: posts small blind $3
patapong: posts big blind $6
floriiiiider: sits out 
*** HOLE CARDS ***
ZarubaNT: folds 
klenius: folds 
Chappolini: folds 
Scarface.VLT: raises $12 to $18
patapong: folds 
Uncalled bet ($12) returned to Scarface.VLT
Scarface.VLT collected $12 from pot
Scarface.VLT: doesn't show hand 
*** SUMMARY ***
Total pot $12 | Rake $0 
Seat 1: Scarface.VLT (small blind) collected ($12)
Seat 2: patapong (big blind) folded before Flop
Seat 3: ZarubaNT folded before Flop (didn't bet)
Seat 5: klenius folded before Flop (didn't bet)
Seat 6: Chappolini (button) folded before Flop (didn't bet)


PokerStars Game #102602465466:  Hold'em No Limit ($3/$6 USD) - 2013/08/11 8:39:04 ET
Table 'Lorcia IV 40-100 bb' 6-max Seat #1 is the button
Seat 1: Scarface.VLT ($862.10 in chips) 
Seat 2: patapong ($939.16 in chips) 
Seat 3: ZarubaNT ($830.53 in chips) 
Seat 5: klenius ($1501.46 in chips) 
Seat 6: Chappolini ($762 in chips) 
patapong: posts small blind $3
ZarubaNT: posts big blind $6
floriiiiider: sits out 
*** HOLE CARDS ***
klenius: folds 
Chappolini: folds 
Scarface.VLT: raises $6 to $12
patapong: raises $39 to $51
ZarubaNT: folds 
Scarface.VLT: folds 
Uncalled bet ($39) returned to patapong
patapong collected $30 from pot
*** SUMMARY ***
Total pot $30 | Rake $0 
Seat 1: Scarface.VLT (button) folded before Flop
Seat 2: patapong (small blind) collected ($30)
Seat 3: ZarubaNT (big blind) folded before Flop
Seat 5: klenius folded before Flop (didn't bet)
Seat 6: Chappolini folded before Flop (didn't bet)


PokerStars Game #102602486301:  Hold'em No Limit ($3/$6 USD) - 2013/08/11 8:39:42 ET
Table 'Lorcia IV 40-100 bb' 6-max Seat #2 is the button
Seat 1: Scarface.VLT ($850.10 in chips) 
Seat 2: patapong ($957.16 in chips) 
Seat 3: ZarubaNT ($824.53 in chips) 
Seat 4: floriiiiider ($600 in chips) 
Seat 5: klenius ($1501.46 in chips) 
Seat 6: Chappolini ($762 in chips) 
ZarubaNT: posts small blind $3
floriiiiider: posts big blind $6
*** HOLE CARDS ***
klenius: folds 
Chappolini: folds 
Scarface.VLT: folds 
patapong: raises $6 to $12
ZarubaNT: folds 
floriiiiider: calls $6
*** FLOP *** [Qc 7s 9h]
floriiiiider: checks 
patapong: bets $18.05
floriiiiider: calls $18.05
*** TURN *** [Qc 7s 9h] [Jc]
floriiiiider: checks 
patapong: checks 
*** RIVER *** [Qc 7s 9h Jc] [2h]
floriiiiider: bets $45
patapong: folds 
Uncalled bet ($45) returned to floriiiiider
floriiiiider collected $60.30 from pot
floriiiiider: doesn't show hand 
*** SUMMARY ***
Total pot $63.10 | Rake $2.80 
Board [Qc 7s 9h Jc 2h]
Seat 1: Scarface.VLT folded before Flop (didn't bet)
Seat 2: patapong (button) folded on the River
Seat 3: ZarubaNT (small blind) folded before Flop
Seat 4: floriiiiider (big blind) collected ($60.30)
Seat 5: klenius folded before Flop (didn't bet)
Seat 6: Chappolini folded before Flop (didn't bet)


PokerStars Game #102602526706:  Hold'em No Limit ($3/$6 USD) - 2013/08/11 8:40:55 ET
Table 'Lorcia IV 40-100 bb' 6-max Seat #3 is the button
Seat 1: Scarface.VLT ($850.10 in chips) 
Seat 2: patapong ($927.11 in chips) 
Seat 3: ZarubaNT ($821.53 in chips) 
Seat 4: floriiiiider ($630.25 in chips) 
Seat 5: klenius ($1501.46 in chips) 
Seat 6: Chappolini ($762 in chips) 
floriiiiider: posts small blind $3
klenius: posts big blind $6
*** HOLE CARDS ***
Chappolini: folds 
Scarface.VLT: raises $12 to $18
patapong: calls $18
ZarubaNT: folds 
floriiiiider: calls $15
klenius: folds 
*** FLOP *** [4c 5c 8d]
floriiiiider: checks 
Scarface.VLT: checks 
patapong: bets $40.11
floriiiiider: raises $97.89 to $138
Scarface.VLT: folds 
patapong: folds 
Uncalled bet ($97.89) returned to floriiiiider
floriiiiider collected $137.42 from pot
floriiiiider: doesn't show hand 
*** SUMMARY ***
Total pot $140.22 | Rake $2.80 
Board [4c 5c 8d]
Seat 1: Scarface.VLT folded on the Flop
Seat 2: patapong folded on the Flop
Seat 3: ZarubaNT (button) folded before Flop (didn't bet)
Seat 4: floriiiiider (small blind) collected ($137.42)
Seat 5: klenius (big blind) folded before Flop
Seat 6: Chappolini folded before Flop (didn't bet)


PokerStars Game #102602566668:  Hold'em No Limit ($3/$6 USD) - 2013/08/11 8:42:07 ET
Table 'Lorcia IV 40-100 bb' 6-max Seat #4 is the button
Seat 1: Scarface.VLT ($832.10 in chips) 
Seat 2: patapong ($869 in chips) 
Seat 3: ZarubaNT ($821.53 in chips) 
Seat 4: floriiiiider ($709.56 in chips) 
Seat 5: klenius ($1495.46 in chips) 
Seat 6: Chappolini ($762 in chips) 
klenius: posts small blind $3
Chappolini: posts big blind $6
*** HOLE CARDS ***
Scarface.VLT: folds 
patapong: raises $9 to $15
ZarubaNT: folds 
floriiiiider: raises $33 to $48
klenius: calls $45
Chappolini: folds 
patapong: folds 
*** FLOP *** [8d 4d Kd]
klenius: checks 
floriiiiider: bets $69
klenius: calls $69
*** TURN *** [8d 4d Kd] [Qh]
klenius: checks 
floriiiiider: checks 
*** RIVER *** [8d 4d Kd Qh] [Jc]
klenius: bets $198
floriiiiider: folds 
Uncalled bet ($198) returned to klenius
klenius collected $252.20 from pot
*** SUMMARY ***
Total pot $255 | Rake $2.80 
Board [8d 4d Kd Qh Jc]
Seat 1: Scarface.VLT folded before Flop (didn't bet)
Seat 2: patapong folded before Flop
Seat 3: ZarubaNT folded before Flop (didn't bet)
Seat 4: floriiiiider (button) folded on the River
Seat 5: klenius (small blind) collected ($252.20)
Seat 6: Chappolini (big blind) folded before Flop


PokerStars Game #102602629508:  Hold'em No Limit ($3/$6 USD) - 2013/08/11 8:44:02 ET
Table 'Lorcia IV 40-100 bb' 6-max Seat #5 is the button
Seat 1: Scarface.VLT ($832.10 in chips) 
Seat 2: patapong ($854 in chips) 
Seat 3: ZarubaNT ($821.53 in chips) 
Seat 4: floriiiiider ($600 in chips) 
Seat 5: klenius ($1630.66 in chips) 
Seat 6: Chappolini ($756 in chips) 
Chappolini: posts small blind $3
Scarface.VLT: posts big blind $6
*** HOLE CARDS ***
patapong: folds 
ZarubaNT: folds 
floriiiiider: raises $9 to $15
klenius: folds 
Chappolini: folds 
Scarface.VLT: folds 
Uncalled bet ($9) returned to floriiiiider
floriiiiider collected $15 from pot
floriiiiider: doesn't show hand 
*** SUMMARY ***
Total pot $15 | Rake $0 
Seat 1: Scarface.VLT (big blind) folded before Flop
Seat 2: patapong folded before Flop (didn't bet)
Seat 3: ZarubaNT folded before Flop (didn't bet)
Seat 4: floriiiiider collected ($15)
Seat 5: klenius (button) folded before Flop (didn't bet)
Seat 6: Chappolini (small blind) folded before Flop


PokerStars Game #102602643763:  Hold'em No Limit ($3/$6 USD) - 2013/08/11 8:44:28 ET
Table 'Lorcia IV 40-100 bb' 6-max Seat #6 is the button
Seat 1: Scarface.VLT ($826.10 in chips) 
Seat 2: patapong ($854 in chips) 
Seat 3: ZarubaNT ($821.53 in chips) 
Seat 4: floriiiiider ($609 in chips) 
Seat 5: klenius ($1630.66 in chips) 
Seat 6: Chappolini ($753 in chips) 
Scarface.VLT: posts small blind $3
patapong: posts big blind $6
*** HOLE CARDS ***
ZarubaNT: raises $12 to $18
floriiiiider: calls $18
klenius: folds 
Chappolini: folds 
Scarface.VLT: folds 
patapong: folds 
*** FLOP *** [2c Qs Js]
ZarubaNT: bets $27
floriiiiider: calls $27
*** TURN *** [2c Qs Js] [5d]
ZarubaNT: bets $72
floriiiiider: raises $99 to $171
ZarubaNT: calls $99
*** RIVER *** [2c Qs Js 5d] [7d]
ZarubaNT: checks 
floriiiiider: bets $393 and is all-in
ZarubaNT: calls $393
*** SHOW DOWN ***
floriiiiider: shows [Jc Qc] (two pair, Queens and Jacks)
ZarubaNT: shows [Ad Ac] (a pair of Aces)
floriiiiider collected $1224.20 from pot
*** SUMMARY ***
Total pot $1227 | Rake $2.80 
Board [2c Qs Js 5d 7d]
Seat 1: Scarface.VLT (small blind) folded before Flop
Seat 2: patapong (big blind) folded before Flop
Seat 3: ZarubaNT showed [Ad Ac] and lost with a pair of Aces
Seat 4: floriiiiider showed [Jc Qc] and won ($1224.20) with two pair, Queens and Jacks
Seat 5: klenius folded before Flop (didn't bet)
Seat 6: Chappolini (button) folded before Flop (didn't bet)


PokerStars Game #102602704320:  Hold'em No Limit ($3/$6 USD) - 2013/08/11 8:46:18 ET
Table 'Lorcia IV 40-100 bb' 6-max Seat #1 is the button
Seat 1: Scarface.VLT ($823.10 in chips) 
Seat 2: patapong ($848 in chips) 
Seat 3: ZarubaNT ($600 in chips) 
Seat 4: floriiiiider ($1224.20 in chips) 
Seat 5: klenius ($1630.66 in chips) 
Seat 6: Chappolini ($753 in chips) 
patapong: posts small blind $3
ZarubaNT: posts big blind $6
*** HOLE CARDS ***
floriiiiider: folds 
klenius: folds 
Chappolini: folds 
Scarface.VLT: raises $6 to $12
patapong: folds 
ZarubaNT: calls $6
*** FLOP *** [2s 4c Qs]
ZarubaNT: checks 
Scarface.VLT: bets $18.04
ZarubaNT: folds 
Uncalled bet ($18.04) returned to Scarface.VLT
Scarface.VLT collected $25.78 from pot
Scarface.VLT: doesn't show hand 
*** SUMMARY ***
Total pot $27 | Rake $1.22 
Board [2s 4c Qs]
Seat 1: Scarface.VLT (button) collected ($25.78)
Seat 2: patapong (small blind) folded before Flop
Seat 3: ZarubaNT (big blind) folded on the Flop
Seat 4: floriiiiider folded before Flop (didn't bet)
Seat 5: klenius folded before Flop (didn't bet)
Seat 6: Chappolini folded before Flop (didn't bet)


PokerStars Game #102602726594:  Hold'em No Limit ($3/$6 USD) - 2013/08/11 8:46:59 ET
Table 'Lorcia IV 40-100 bb' 6-max Seat #2 is the button
Seat 1: Scarface.VLT ($836.88 in chips) 
Seat 2: patapong ($845 in chips) 
Seat 3: ZarubaNT ($600 in chips) 
Seat 4: floriiiiider ($1224.20 in chips) 
Seat 5: klenius ($1630.66 in chips) 
Seat 6: Chappolini ($753 in chips) 
ZarubaNT: posts small blind $3
floriiiiider: posts big blind $6
*** HOLE CARDS ***
klenius: folds 
Chappolini: folds 
Scarface.VLT: folds 
patapong: raises $6 to $12
ZarubaNT: folds 
floriiiiider: raises $33 to $45
patapong: folds 
Uncalled bet ($33) returned to floriiiiider
floriiiiider collected $27 from pot
floriiiiider: doesn't show hand 
*** SUMMARY ***
Total pot $27 | Rake $0 
Seat 1: Scarface.VLT folded before Flop (didn't bet)
Seat 2: patapong (button) folded before Flop
Seat 3: ZarubaNT (small blind) folded before Flop
Seat 4: floriiiiider (big blind) collected ($27)
Seat 5: klenius folded before Flop (didn't bet)
Seat 6: Chappolini folded before Flop (didn't bet)


PokerStars Game #102602752505:  Hold'em No Limit ($3/$6 USD) - 2013/08/11 8:47:46 ET
Table 'Lorcia IV 40-100 bb' 6-max Seat #3 is the button
Seat 1: Scarface.VLT ($836.88 in chips) 
Seat 2: patapong ($833 in chips) 
Seat 3: ZarubaNT ($600 in chips) 
Seat 4: floriiiiider ($1239.20 in chips) 
Seat 5: klenius ($1630.66 in chips) 
Seat 6: Chappolini ($753 in chips) 
floriiiiider: posts small blind $3
klenius: posts big blind $6
*** HOLE CARDS ***
Chappolini: raises $12 to $18
Scarface.VLT: folds 
patapong: folds 
ZarubaNT: folds 
floriiiiider: folds 
klenius: calls $12
*** FLOP *** [Qc 5s 2d]
klenius: checks 
Chappolini: checks 
*** TURN *** [Qc 5s 2d] [6c]
klenius: bets $24
Chappolini: calls $24
*** RIVER *** [Qc 5s 2d 6c] [8d]
klenius: bets $78
Chappolini: calls $78
*** SHOW DOWN ***
klenius: shows [8s Ac] (a pair of Eights)
Chappolini: shows [Jc Jd] (a pair of Jacks)
Chappolini collected $240.20 from pot
*** SUMMARY ***
Total pot $243 | Rake $2.80 
Board [Qc 5s 2d 6c 8d]
Seat 1: Scarface.VLT folded before Flop (didn't bet)
Seat 2: patapong folded before Flop (didn't bet)
Seat 3: ZarubaNT (button) folded before Flop (didn't bet)
Seat 4: floriiiiider (small blind) folded before Flop
Seat 5: klenius (big blind) showed [8s Ac] and lost with a pair of Eights
Seat 6: Chappolini showed [Jc Jd] and won ($240.20) with a pair of Jacks


PokerStars Game #102602819501:  Hold'em No Limit ($3/$6 USD) - 2013/08/11 8:49:49 ET
Table 'Lorcia IV 40-100 bb' 6-max Seat #4 is the button
Seat 1: Scarface.VLT ($836.88 in chips) 
Seat 2: patapong ($833 in chips) 
Seat 3: ZarubaNT ($600 in chips) 
Seat 4: floriiiiider ($1236.20 in chips) 
Seat 5: klenius ($1510.66 in chips) 
Seat 6: Chappolini ($873.20 in chips) 
klenius: posts small blind $3
Chappolini: posts big blind $6
*** HOLE CARDS ***
Scarface.VLT: folds 
patapong: folds 
ZarubaNT: folds 
floriiiiider: raises $6 to $12
klenius: folds 
Chappolini: folds 
Uncalled bet ($6) returned to floriiiiider
floriiiiider collected $15 from pot
floriiiiider: doesn't show hand 
*** SUMMARY ***
Total pot $15 | Rake $0 
Seat 1: Scarface.VLT folded before Flop (didn't bet)
Seat 2: patapong folded before Flop (didn't bet)
Seat 3: ZarubaNT folded before Flop (didn't bet)
Seat 4: floriiiiider (button) collected ($15)
Seat 5: klenius (small blind) folded before Flop
Seat 6: Chappolini (big blind) folded before Flop


PokerStars Game #102602183869:  Hold'em No Limit ($3/$6 USD) - 2013/08/11 8:30:32 ET
Table 'Lorcia IV 40-100 bb' 6-max Seat #6 is the button
Seat 1: Scarface.VLT ($813.90 in chips) 
Seat 2: patapong ($1108.58 in chips) 
Seat 3: ZarubaNT ($866.53 in chips) 
Seat 4: GERAKLmeat ($256.57 in chips) 
Seat 5: klenius ($1474.06 in chips) 
Seat 6: Chappolini ($600 in chips) 
Scarface.VLT: posts small blind $3
patapong: posts big blind $6
*** HOLE CARDS ***
ZarubaNT: folds 
GERAKLmeat: folds 
klenius: folds 
Chappolini: raises $6 to $12
Scarface.VLT: folds 
patapong: calls $6
*** FLOP *** [8d Qd 6c]
patapong: checks 
Chappolini: bets $18
patapong: calls $18
*** TURN *** [8d Qd 6c] [3d]
patapong: bets $39.13
Chappolini: folds 
Uncalled bet ($39.13) returned to patapong
patapong collected $60.20 from pot
*** SUMMARY ***
Total pot $63 | Rake $2.80 
Board [8d Qd 6c 3d]
Seat 1: Scarface.VLT (small blind) folded before Flop
Seat 2: patapong (big blind) collected ($60.20)
Seat 3: ZarubaNT folded before Flop (didn't bet)
Seat 4: GERAKLmeat folded before Flop (didn't bet)
Seat 5: klenius folded before Flop (didn't bet)
Seat 6: Chappolini (button) folded on the Turn


PokerStars Game #102602219148:  Hold'em No Limit ($3/$6 USD) - 2013/08/11 8:31:38 ET
Table 'Lorcia IV 40-100 bb' 6-max Seat #1 is the button
Seat 1: Scarface.VLT ($810.90 in chips) 
Seat 2: patapong ($1138.78 in chips) 
Seat 3: ZarubaNT ($866.53 in chips) 
Seat 4: GERAKLmeat ($256.57 in chips) 
Seat 5: klenius ($1474.06 in chips) 
Seat 6: Chappolini ($600 in chips) 
patapong: posts small blind $3
ZarubaNT: posts big blind $6
*** HOLE CARDS ***
GERAKLmeat: folds 
klenius: folds 
Chappolini: raises $9 to $15
Scarface.VLT: folds 
patapong: calls $12
ZarubaNT: folds 
*** FLOP *** [Qs 4s 2h]
patapong: checks 
Chappolini: checks 
*** TURN *** [Qs 4s 2h] [Ad]
patapong: checks 
Chappolini: checks 
*** RIVER *** [Qs 4s 2h Ad] [8s]
patapong: checks 
Chappolini: checks 
*** SHOW DOWN ***
patapong: shows [6c 6h] (a pair of Sixes)
Chappolini: mucks hand 
patapong collected $34.38 from pot
*** SUMMARY ***
Total pot $36 | Rake $1.62 
Board [Qs 4s 2h Ad 8s]
Seat 1: Scarface.VLT (button) folded before Flop (didn't bet)
Seat 2: patapong (small blind) showed [6c 6h] and won ($34.38) with a pair of Sixes
Seat 3: ZarubaNT (big blind) folded before Flop
Seat 4: GERAKLmeat folded before Flop (didn't bet)
Seat 5: klenius folded before Flop (didn't bet)
Seat 6: Chappolini mucked


PokerStars Game #102602267981:  Hold'em No Limit ($3/$6 USD) - 2013/08/11 8:33:07 ET
Table 'Lorcia IV 40-100 bb' 6-max Seat #2 is the button
Seat 1: Scarface.VLT ($810.90 in chips) 
Seat 2: patapong ($1158.16 in chips) 
Seat 3: ZarubaNT ($860.53 in chips) 
Seat 5: klenius ($1474.06 in chips) 
Seat 6: Chappolini ($600 in chips) 
ZarubaNT: posts small blind $3
GERAKLmeat: is sitting out 
klenius: posts big blind $6
*** HOLE CARDS ***
Chappolini: folds 
Scarface.VLT: folds 
patapong: raises $6 to $12
ZarubaNT: folds 
klenius: folds 
Uncalled bet ($6) returned to patapong
patapong collected $15 from pot
*** SUMMARY ***
Total pot $15 | Rake $0 
Seat 1: Scarface.VLT folded before Flop (didn't bet)
Seat 2: patapong (button) collected ($15)
Seat 3: ZarubaNT (small blind) folded before Flop
Seat 5: klenius (big blind) folded before Flop
Seat 6: Chappolini folded before Flop (didn't bet)


PokerStars Game #102602279021:  Hold'em No Limit ($3/$6 USD) - 2013/08/11 8:33:28 ET
Table 'Lorcia IV 40-100 bb' 6-max Seat #3 is the button
Seat 1: Scarface.VLT ($810.90 in chips) 
Seat 2: patapong ($1167.16 in chips) 
Seat 3: ZarubaNT ($857.53 in chips) 
Seat 5: klenius ($1468.06 in chips) 
Seat 6: Chappolini ($600 in chips) 
klenius: posts small blind $3
Chappolini: posts big blind $6
*** HOLE CARDS ***
Scarface.VLT: raises $12 to $18
patapong: calls $18
ZarubaNT: calls $18
klenius: folds 
Chappolini: raises $54 to $72
Scarface.VLT: folds 
GERAKLmeat leaves the table
patapong: raises $54 to $126
ZarubaNT: folds 
Chappolini: raises $474 to $600 and is all-in
patapong: folds 
Uncalled bet ($474) returned to Chappolini
Chappolini collected $291 from pot
Chappolini: doesn't show hand 
*** SUMMARY ***
Total pot $291 | Rake $0 
Seat 1: Scarface.VLT folded before Flop
Seat 2: patapong folded before Flop
Seat 3: ZarubaNT (button) folded before Flop
Seat 5: klenius (small blind) folded before Flop
Seat 6: Chappolini (big blind) collected ($291)


PokerStars Game #102602312814:  Hold'em No Limit ($3/$6 USD) - 2013/08/11 8:34:29 ET
Table 'Lorcia IV 40-100 bb' 6-max Seat #5 is the button
Seat 1: Scarface.VLT ($792.90 in chips) 
Seat 2: patapong ($1041.16 in chips) 
Seat 3: ZarubaNT ($839.53 in chips) 
Seat 5: klenius ($1465.06 in chips) 
Seat 6: Chappolini ($765 in chips) 
Chappolini: posts small blind $3
Scarface.VLT: posts big blind $6
*** HOLE CARDS ***
patapong: folds 
ZarubaNT: folds 
klenius: raises $6 to $12
Chappolini: folds 
Scarface.VLT: raises $30 to $42
klenius: calls $30
*** FLOP *** [3d Jh Th]
Scarface.VLT: bets $42
klenius: calls $42
*** TURN *** [3d Jh Th] [Kh]
Scarface.VLT: bets $96
klenius: folds 
Uncalled bet ($96) returned to Scarface.VLT
Scarface.VLT collected $168.20 from pot
Scarface.VLT: doesn't show hand 
*** SUMMARY ***
Total pot $171 | Rake $2.80 
Board [3d Jh Th Kh]
Seat 1: Scarface.VLT (big blind) collected ($168.20)
Seat 2: patapong folded before Flop (didn't bet)
Seat 3: ZarubaNT folded before Flop (didn't bet)
Seat 5: klenius (button) folded on the Turn
Seat 6: Chappolini (small blind) folded before Flop


PokerStars Game #102602349490:  Hold'em No Limit ($3/$6 USD) - 2013/08/11 8:35:36 ET
Table 'Lorcia IV 40-100 bb' 6-max Seat #6 is the button
Seat 1: Scarface.VLT ($877.10 in chips) 
Seat 2: patapong ($1041.16 in chips) 
Seat 3: ZarubaNT ($839.53 in chips) 
Seat 5: klenius ($1381.06 in chips) 
Seat 6: Chappolini ($762 in chips) 
Scarface.VLT: posts small blind $3
patapong: posts big blind $6
*** HOLE CARDS ***
ZarubaNT: folds 
klenius: folds 
Chappolini: raises $6 to $12
Scarface.VLT: folds 
patapong: folds 
Uncalled bet ($6) returned to Chappolini
Chappolini collected $15 from pot
Chappolini: doesn't show hand 
*** SUMMARY ***
Total pot $15 | Rake $0 
Seat 1: Scarface.VLT (small blind) folded before Flop
Seat 2: patapong (big blind) folded before Flop
Seat 3: ZarubaNT folded before Flop (didn't bet)
Seat 5: klenius folded before Flop (didn't bet)
Seat 6: Chappolini (button) collected ($15)


PokerStars Game #102602360046:  Hold'em No Limit ($3/$6 USD) - 2013/08/11 8:35:55 ET
Table 'Lorcia IV 40-100 bb' 6-max Seat #1 is the button
Seat 1: Scarface.VLT ($874.10 in chips) 
Seat 2: patapong ($1035.16 in chips) 
Seat 3: ZarubaNT ($839.53 in chips) 
Seat 5: klenius ($1381.06 in chips) 
Seat 6: Chappolini ($771 in chips) 
patapong: posts small blind $3
ZarubaNT: posts big blind $6
*** HOLE CARDS ***
klenius: raises $6 to $12
Chappolini: folds 
Scarface.VLT: folds 
patapong: folds 
ZarubaNT: folds 
Uncalled bet ($6) returned to klenius
klenius collected $15 from pot
*** SUMMARY ***
Total pot $15 | Rake $0 
Seat 1: Scarface.VLT (button) folded before Flop (didn't bet)
Seat 2: patapong (small blind) folded before Flop
Seat 3: ZarubaNT (big blind) folded before Flop
Seat 5: klenius collected ($15)
Seat 6: Chappolini folded before Flop (didn't bet)


PokerStars Game #102602368611:  Hold'em No Limit ($3/$6 USD) - 2013/08/11 8:36:10 ET
Table 'Lorcia IV 40-100 bb' 6-max Seat #2 is the button
Seat 1: Scarface.VLT ($874.10 in chips) 
Seat 2: patapong ($1032.16 in chips) 
Seat 3: ZarubaNT ($833.53 in chips) 
Seat 5: klenius ($1390.06 in chips) 
Seat 6: Chappolini ($771 in chips) 
ZarubaNT: posts small blind $3
klenius: posts big blind $6
*** HOLE CARDS ***
Chappolini: folds 
Scarface.VLT: raises $6 to $12
patapong: folds 
ZarubaNT: folds 
klenius: raises $30 to $42
Scarface.VLT: folds 
Uncalled bet ($30) returned to klenius
klenius collected $27 from pot
*** SUMMARY ***
Total pot $27 | Rake $0 
Seat 1: Scarface.VLT folded before Flop
Seat 2: patapong (button) folded before Flop (didn't bet)
Seat 3: ZarubaNT (small blind) folded before Flop
Seat 5: klenius (big blind) collected ($27)
Seat 6: Chappolini folded before Flop (didn't bet)


PokerStars Game #102602387395:  Hold'em No Limit ($3/$6 USD) - 2013/08/11 8:36:44 ET
Table 'Lorcia IV 40-100 bb' 6-max Seat #3 is the button
Seat 1: Scarface.VLT ($862.10 in chips) 
Seat 2: patapong ($1032.16 in chips) 
Seat 3: ZarubaNT ($830.53 in chips) 
Seat 5: klenius ($1405.06 in chips) 
Seat 6: Chappolini ($771 in chips) 
klenius: posts small blind $3
Chappolini: posts big blind $6
*** HOLE CARDS ***
Scarface.VLT: folds 
patapong: raises $9 to $15
ZarubaNT: folds 
klenius: raises $33 to $48
Chappolini: folds 
patapong: calls $33
*** FLOP *** [5c Js 3c]
klenius: bets $66
patapong: folds 
Uncalled bet ($66) returned to klenius
klenius collected $99.20 from pot
*** SUMMARY ***
Total pot $102 | Rake $2.80 
Board [5c Js 3c]
Seat 1: Scarface.VLT folded before Flop (didn't bet)
Seat 2: patapong folded on the Flop
Seat 3: ZarubaNT (button) folded before Flop (didn't bet)
Seat 5: klenius (small blind) collected ($99.20)
Seat 6: Chappolini (big blind) folded before Flop


PokerStars Game #102601691121:  Hold'em No Limit ($3/$6 USD) - 2013/08/11 8:15:05 ET
Table 'Lorcia IV 40-100 bb' 6-max Seat #5 is the button
Seat 1: Scarface.VLT ($636.20 in chips) 
Seat 2: patapong ($1128.20 in chips) 
Seat 3: ZarubaNT ($1346.43 in chips) 
Seat 4: GERAKLmeat ($264 in chips) 
Seat 5: klenius ($855.51 in chips) 
Seat 6: LukaschenkoA ($600 in chips) 
LukaschenkoA: posts small blind $3
Scarface.VLT: posts big blind $6
*** HOLE CARDS ***
patapong: folds 
ZarubaNT: raises $12 to $18
GERAKLmeat: folds 
klenius: folds 
LukaschenkoA: folds 
Scarface.VLT: folds 
Uncalled bet ($12) returned to ZarubaNT
ZarubaNT collected $15 from pot
ZarubaNT: doesn't show hand 
*** SUMMARY ***
Total pot $15 | Rake $0 
Seat 1: Scarface.VLT (big blind) folded before Flop
Seat 2: patapong folded before Flop (didn't bet)
Seat 3: ZarubaNT collected ($15)
Seat 4: GERAKLmeat folded before Flop (didn't bet)
Seat 5: klenius (button) folded before Flop (didn't bet)
Seat 6: LukaschenkoA (small blind) folded before Flop


PokerStars Game #102601706523:  Hold'em No Limit ($3/$6 USD) - 2013/08/11 8:15:34 ET
Table 'Lorcia IV 40-100 bb' 6-max Seat #6 is the button
Seat 1: Scarface.VLT ($630.20 in chips) 
Seat 2: patapong ($1128.20 in chips) 
Seat 3: ZarubaNT ($1355.43 in chips) 
Seat 4: GERAKLmeat ($264 in chips) 
Seat 5: klenius ($855.51 in chips) 
Seat 6: LukaschenkoA ($600 in chips) 
Scarface.VLT: posts small blind $3
patapong: posts big blind $6
*** HOLE CARDS ***
ZarubaNT: folds 
GERAKLmeat: folds 
klenius: folds 
LukaschenkoA: raises $6 to $12
Scarface.VLT: folds 
patapong: folds 
Uncalled bet ($6) returned to LukaschenkoA
LukaschenkoA collected $15 from pot
LukaschenkoA: doesn't show hand 
*** SUMMARY ***
Total pot $15 | Rake $0 
Seat 1: Scarface.VLT (small blind) folded before Flop
Seat 2: patapong (big blind) folded before Flop
Seat 3: ZarubaNT folded before Flop (didn't bet)
Seat 4: GERAKLmeat folded before Flop (didn't bet)
Seat 5: klenius folded before Flop (didn't bet)
Seat 6: LukaschenkoA (button) collected ($15)


PokerStars Game #102601718895:  Hold'em No Limit ($3/$6 USD) - 2013/08/11 8:15:58 ET
Table 'Lorcia IV 40-100 bb' 6-max Seat #1 is the button
Seat 1: Scarface.VLT ($627.20 in chips) 
Seat 2: patapong ($1122.20 in chips) 
Seat 3: ZarubaNT ($1355.43 in chips) 
Seat 4: GERAKLmeat ($264 in chips) 
Seat 5: klenius ($855.51 in chips) 
Seat 6: LukaschenkoA ($609 in chips) 
patapong: posts small blind $3
ZarubaNT: posts big blind $6
*** HOLE CARDS ***
GERAKLmeat: folds 
klenius: folds 
LukaschenkoA: raises $12 to $18
Scarface.VLT: raises $18 to $36
patapong: folds 
ZarubaNT: folds 
LukaschenkoA: calls $18
*** FLOP *** [Jc 9h 8c]
LukaschenkoA: checks 
Scarface.VLT: bets $54.74
LukaschenkoA: folds 
Uncalled bet ($54.74) returned to Scarface.VLT
Scarface.VLT collected $78.20 from pot
Scarface.VLT: doesn't show hand 
*** SUMMARY ***
Total pot $81 | Rake $2.80 
Board [Jc 9h 8c]
Seat 1: Scarface.VLT (button) collected ($78.20)
Seat 2: patapong (small blind) folded before Flop
Seat 3: ZarubaNT (big blind) folded before Flop
Seat 4: GERAKLmeat folded before Flop (didn't bet)
Seat 5: klenius folded before Flop (didn't bet)
Seat 6: LukaschenkoA folded on the Flop


PokerStars Game #102601752784:  Hold'em No Limit ($3/$6 USD) - 2013/08/11 8:17:01 ET
Table 'Lorcia IV 40-100 bb' 6-max Seat #2 is the button
Seat 1: Scarface.VLT ($669.40 in chips) 
Seat 2: patapong ($1119.20 in chips) 
Seat 3: ZarubaNT ($1349.43 in chips) 
Seat 4: GERAKLmeat ($264 in chips) 
Seat 5: klenius ($855.51 in chips) 
Seat 6: LukaschenkoA ($600 in chips) 
ZarubaNT: posts small blind $3
GERAKLmeat: posts big blind $6
*** HOLE CARDS ***
klenius: raises $6 to $12
LukaschenkoA: folds 
Scarface.VLT: folds 
patapong: folds 
ZarubaNT: folds 
GERAKLmeat: calls $6
*** FLOP *** [9h Tc Kh]
GERAKLmeat: checks 
klenius: bets $18
GERAKLmeat: raises $24 to $42
klenius: folds 
Uncalled bet ($24) returned to GERAKLmeat
GERAKLmeat collected $60.20 from pot
GERAKLmeat: doesn't show hand 
*** SUMMARY ***
Total pot $63 | Rake $2.80 
Board [9h Tc Kh]
Seat 1: Scarface.VLT folded before Flop (didn't bet)
Seat 2: patapong (button) folded before Flop (didn't bet)
Seat 3: ZarubaNT (small blind) folded before Flop
Seat 4: GERAKLmeat (big blind) collected ($60.20)
Seat 5: klenius folded on the Flop
Seat 6: LukaschenkoA folded before Flop (didn't bet)


PokerStars Game #102601770957:  Hold'em No Limit ($3/$6 USD) - 2013/08/11 8:17:36 ET
Table 'Lorcia IV 40-100 bb' 6-max Seat #3 is the button
Seat 1: Scarface.VLT ($669.40 in chips) 
Seat 2: patapong ($1119.20 in chips) 
Seat 3: ZarubaNT ($1346.43 in chips) 
Seat 4: GERAKLmeat ($294.20 in chips) 
Seat 5: klenius ($825.51 in chips) 
Seat 6: LukaschenkoA ($600 in chips) 
GERAKLmeat: posts small blind $3
klenius: posts big blind $6
*** HOLE CARDS ***
LukaschenkoA: folds 
Scarface.VLT: folds 
patapong: raises $9 to $15
ZarubaNT: folds 
GERAKLmeat: folds 
klenius: folds 
Uncalled bet ($9) returned to patapong
patapong collected $15 from pot
*** SUMMARY ***
Total pot $15 | Rake $0 
Seat 1: Scarface.VLT folded before Flop (didn't bet)
Seat 2: patapong collected ($15)
Seat 3: ZarubaNT (button) folded before Flop (didn't bet)
Seat 4: GERAKLmeat (small blind) folded before Flop
Seat 5: klenius (big blind) folded before Flop
Seat 6: LukaschenkoA folded before Flop (didn't bet)


PokerStars Game #102601782746:  Hold'em No Limit ($3/$6 USD) - 2013/08/11 8:17:58 ET
Table 'Lorcia IV 40-100 bb' 6-max Seat #4 is the button
Seat 1: Scarface.VLT ($669.40 in chips) 
Seat 2: patapong ($1128.20 in chips) 
Seat 3: ZarubaNT ($1346.43 in chips) 
Seat 4: GERAKLmeat ($291.20 in chips) 
Seat 5: klenius ($819.51 in chips) 
Seat 6: LukaschenkoA ($600 in chips) 
klenius: posts small blind $3
LukaschenkoA: posts big blind $6
*** HOLE CARDS ***
Scarface.VLT: raises $12 to $18
patapong: folds 
ZarubaNT: raises $30 to $48
GERAKLmeat: folds 
klenius: folds 
LukaschenkoA: folds 
Scarface.VLT: folds 
Uncalled bet ($30) returned to ZarubaNT
ZarubaNT collected $45 from pot
ZarubaNT: doesn't show hand 
*** SUMMARY ***
Total pot $45 | Rake $0 
Seat 1: Scarface.VLT folded before Flop
Seat 2: patapong folded before Flop (didn't bet)
Seat 3: ZarubaNT collected ($45)
Seat 4: GERAKLmeat (button) folded before Flop (didn't bet)
Seat 5: klenius (small blind) folded before Flop
Seat 6: LukaschenkoA (big blind) folded before Flop


PokerStars Game #102601796813:  Hold'em No Limit ($3/$6 USD) - 2013/08/11 8:18:24 ET
Table 'Lorcia IV 40-100 bb' 6-max Seat #5 is the button
Seat 1: Scarface.VLT ($651.40 in chips) 
Seat 2: patapong ($1128.20 in chips) 
Seat 3: ZarubaNT ($1373.43 in chips) 
Seat 4: GERAKLmeat ($291.20 in chips) 
Seat 5: klenius ($816.51 in chips) 
Seat 6: LukaschenkoA ($600 in chips) 
LukaschenkoA: posts small blind $3
Scarface.VLT: posts big blind $6
*** HOLE CARDS ***
patapong: folds 
ZarubaNT: raises $12 to $18
GERAKLmeat: folds 
klenius: folds 
LukaschenkoA: folds 
Scarface.VLT: folds 
Uncalled bet ($12) returned to ZarubaNT
ZarubaNT collected $15 from pot
ZarubaNT: doesn't show hand 
*** SUMMARY ***
Total pot $15 | Rake $0 
Seat 1: Scarface.VLT (big blind) folded before Flop
Seat 2: patapong folded before Flop (didn't bet)
Seat 3: ZarubaNT collected ($15)
Seat 4: GERAKLmeat folded before Flop (didn't bet)
Seat 5: klenius (button) folded before Flop (didn't bet)
Seat 6: LukaschenkoA (small blind) folded before Flop


PokerStars Game #102601810656:  Hold'em No Limit ($3/$6 USD) - 2013/08/11 8:18:51 ET
Table 'Lorcia IV 40-100 bb' 6-max Seat #6 is the button
Seat 1: Scarface.VLT ($645.40 in chips) 
Seat 2: patapong ($1128.20 in chips) 
Seat 3: ZarubaNT ($1382.43 in chips) 
Seat 4: GERAKLmeat ($291.20 in chips) 
Seat 5: klenius ($816.51 in chips) 
Seat 6: LukaschenkoA ($600 in chips) 
Scarface.VLT: posts small blind $3
patapong: posts big blind $6
*** HOLE CARDS ***
ZarubaNT: folds 
GERAKLmeat: folds 
klenius: raises $6 to $12
LukaschenkoA: calls $12
Scarface.VLT: folds 
patapong: folds 
*** FLOP *** [Td Tc Ah]
klenius: bets $18
LukaschenkoA: folds 
Uncalled bet ($18) returned to klenius
klenius collected $31.52 from pot
*** SUMMARY ***
Total pot $33 | Rake $1.48 
Board [Td Tc Ah]
Seat 1: Scarface.VLT (small blind) folded before Flop
Seat 2: patapong (big blind) folded before Flop
Seat 3: ZarubaNT folded before Flop (didn't bet)
Seat 4: GERAKLmeat folded before Flop (didn't bet)
Seat 5: klenius collected ($31.52)
Seat 6: LukaschenkoA (button) folded on the Flop


PokerStars Game #102601831006:  Hold'em No Limit ($3/$6 USD) - 2013/08/11 8:19:29 ET
Table 'Lorcia IV 40-100 bb' 6-max Seat #1 is the button
Seat 1: Scarface.VLT ($642.40 in chips) 
Seat 2: patapong ($1122.20 in chips) 
Seat 3: ZarubaNT ($1382.43 in chips) 
Seat 4: GERAKLmeat ($291.20 in chips) 
Seat 5: klenius ($836.03 in chips) 
Seat 6: LukaschenkoA ($600 in chips) 
patapong: posts small blind $3
ZarubaNT: posts big blind $6
*** HOLE CARDS ***
GERAKLmeat: folds 
klenius: folds 
LukaschenkoA: folds 
Scarface.VLT: folds 
patapong: raises $12 to $18
ZarubaNT: calls $12
*** FLOP *** [2h Kh Qs]
patapong: bets $24.07
ZarubaNT: folds 
Uncalled bet ($24.07) returned to patapong
patapong collected $34.38 from pot
*** SUMMARY ***
Total pot $36 | Rake $1.62 
Board [2h Kh Qs]
Seat 1: Scarface.VLT (button) folded before Flop (didn't bet)
Seat 2: patapong (small blind) collected ($34.38)
Seat 3: ZarubaNT (big blind) folded on the Flop
Seat 4: GERAKLmeat folded before Flop (didn't bet)
Seat 5: klenius folded before Flop (didn't bet)
Seat 6: LukaschenkoA folded before Flop (didn't bet)


PokerStars Game #102602003240:  Hold'em No Limit ($3/$6 USD) - 2013/08/11 8:24:53 ET
Table 'Lorcia IV 40-100 bb' 6-max Seat #5 is the button
Seat 1: Scarface.VLT ($819.80 in chips) 
Seat 2: patapong ($1129.58 in chips) 
Seat 4: GERAKLmeat ($272.64 in chips) 
Seat 5: klenius ($878.39 in chips) 
Seat 6: Chappolini ($600 in chips) 
Chappolini: posts small blind $3
Scarface.VLT: posts big blind $6
ZarubaNT: sits out 
*** HOLE CARDS ***
patapong: folds 
GERAKLmeat: raises $6 to $12
klenius: calls $12
Chappolini: folds 
Scarface.VLT: folds 
*** FLOP *** [7s 6s 4h]
GERAKLmeat: bets $16.07
klenius: calls $16.07
*** TURN *** [7s 6s 4h] [6d]
GERAKLmeat: checks 
klenius: checks 
*** RIVER *** [7s 6s 4h 6d] [7h]
GERAKLmeat: checks 
klenius: bets $48
GERAKLmeat: folds 
Uncalled bet ($48) returned to klenius
klenius collected $62.34 from pot
*** SUMMARY ***
Total pot $65.14 | Rake $2.80 
Board [7s 6s 4h 6d 7h]
Seat 1: Scarface.VLT (big blind) folded before Flop
Seat 2: patapong folded before Flop (didn't bet)
Seat 4: GERAKLmeat folded on the River
Seat 5: klenius (button) collected ($62.34)
Seat 6: Chappolini (small blind) folded before Flop


PokerStars Game #102601853440:  Hold'em No Limit ($3/$6 USD) - 2013/08/11 8:20:12 ET
Table 'Lorcia IV 40-100 bb' 6-max Seat #2 is the button
Seat 1: Scarface.VLT ($642.40 in chips) 
Seat 2: patapong ($1138.58 in chips) 
Seat 3: ZarubaNT ($1364.43 in chips) 
Seat 4: GERAKLmeat ($291.20 in chips) 
Seat 5: klenius ($836.03 in chips) 
Seat 6: LukaschenkoA ($600 in chips) 
ZarubaNT: posts small blind $3
GERAKLmeat: posts big blind $6
*** HOLE CARDS ***
klenius: folds 
LukaschenkoA: folds 
Scarface.VLT: raises $6 to $12
patapong: folds 
ZarubaNT: raises $33 to $45
GERAKLmeat: folds 
Scarface.VLT: folds 
Uncalled bet ($33) returned to ZarubaNT
ZarubaNT collected $30 from pot
ZarubaNT: doesn't show hand 
*** SUMMARY ***
Total pot $30 | Rake $0 
Seat 1: Scarface.VLT folded before Flop
Seat 2: patapong (button) folded before Flop (didn't bet)
Seat 3: ZarubaNT (small blind) collected ($30)
Seat 4: GERAKLmeat (big blind) folded before Flop
Seat 5: klenius folded before Flop (didn't bet)
Seat 6: LukaschenkoA folded before Flop (didn't bet)


PokerStars Game #102601874490:  Hold'em No Limit ($3/$6 USD) - 2013/08/11 8:20:51 ET
Table 'Lorcia IV 40-100 bb' 6-max Seat #3 is the button
Seat 1: Scarface.VLT ($630.40 in chips) 
Seat 2: patapong ($1138.58 in chips) 
Seat 3: ZarubaNT ($1382.43 in chips) 
Seat 4: GERAKLmeat ($285.20 in chips) 
Seat 5: klenius ($836.03 in chips) 
Seat 6: LukaschenkoA ($600 in chips) 
GERAKLmeat: posts small blind $3
klenius: posts big blind $6
*** HOLE CARDS ***
LukaschenkoA: raises $12 to $18
Scarface.VLT: folds 
patapong: folds 
ZarubaNT: folds 
GERAKLmeat: folds 
klenius: calls $12
*** FLOP *** [2d Jd Qc]
klenius: checks 
LukaschenkoA: checks 
*** TURN *** [2d Jd Qc] [8c]
klenius: checks 
LukaschenkoA: checks 
*** RIVER *** [2d Jd Qc 8c] [Kh]
klenius: checks 
LukaschenkoA: bets $30
klenius: folds 
Uncalled bet ($30) returned to LukaschenkoA
LukaschenkoA collected $37.24 from pot
LukaschenkoA: doesn't show hand 
*** SUMMARY ***
Total pot $39 | Rake $1.76 
Board [2d Jd Qc 8c Kh]
Seat 1: Scarface.VLT folded before Flop (didn't bet)
Seat 2: patapong folded before Flop (didn't bet)
Seat 3: ZarubaNT (button) folded before Flop (didn't bet)
Seat 4: GERAKLmeat (small blind) folded before Flop
Seat 5: klenius (big blind) folded on the River
Seat 6: LukaschenkoA collected ($37.24)


PokerStars Game #102601895479:  Hold'em No Limit ($3/$6 USD) - 2013/08/11 8:21:30 ET
Table 'Lorcia IV 40-100 bb' 6-max Seat #4 is the button
Seat 1: Scarface.VLT ($630.40 in chips) 
Seat 2: patapong ($1138.58 in chips) 
Seat 3: ZarubaNT ($1382.43 in chips) 
Seat 4: GERAKLmeat ($282.20 in chips) 
Seat 5: klenius ($818.03 in chips) 
klenius: posts small blind $3
LukaschenkoA: is sitting out 
Scarface.VLT: posts big blind $6
*** HOLE CARDS ***
LukaschenkoA leaves the table
patapong: folds 
ZarubaNT: raises $9 to $15
GERAKLmeat: folds 
klenius: folds 
Scarface.VLT: folds 
Uncalled bet ($9) returned to ZarubaNT
ZarubaNT collected $15 from pot
ZarubaNT: doesn't show hand 
*** SUMMARY ***
Total pot $15 | Rake $0 
Seat 1: Scarface.VLT (big blind) folded before Flop
Seat 2: patapong folded before Flop (didn't bet)
Seat 3: ZarubaNT collected ($15)
Seat 4: GERAKLmeat (button) folded before Flop (didn't bet)
Seat 5: klenius (small blind) folded before Flop


PokerStars Game #102601908775:  Hold'em No Limit ($3/$6 USD) - 2013/08/11 8:21:55 ET
Table 'Lorcia IV 40-100 bb' 6-max Seat #5 is the button
Seat 1: Scarface.VLT ($624.40 in chips) 
Seat 2: patapong ($1138.58 in chips) 
Seat 3: ZarubaNT ($1391.43 in chips) 
Seat 4: GERAKLmeat ($282.20 in chips) 
Seat 5: klenius ($815.03 in chips) 
Scarface.VLT: posts small blind $3
patapong: posts big blind $6
*** HOLE CARDS ***
ZarubaNT: folds 
GERAKLmeat: raises $6 to $12
klenius: folds 
Scarface.VLT: raises $24 to $36
patapong: folds 
GERAKLmeat: raises $246.20 to $282.20 and is all-in
Scarface.VLT: calls $246.20
*** FLOP *** [Jc 4s Ac]
*** TURN *** [Jc 4s Ac] [6d]
*** RIVER *** [Jc 4s Ac 6d] [Qh]
*** SHOW DOWN ***
Scarface.VLT: shows [Qd Ad] (two pair, Aces and Queens)
GERAKLmeat: shows [8s 8d] (a pair of Eights)
Scarface.VLT collected $567.60 from pot
*** SUMMARY ***
Total pot $570.40 | Rake $2.80 
Board [Jc 4s Ac 6d Qh]
Seat 1: Scarface.VLT (small blind) showed [Qd Ad] and won ($567.60) with two pair, Aces and Queens
Seat 2: patapong (big blind) folded before Flop
Seat 3: ZarubaNT folded before Flop (didn't bet)
Seat 4: GERAKLmeat showed [8s 8d] and lost with a pair of Eights
Seat 5: klenius (button) folded before Flop (didn't bet)


PokerStars Game #102601929638:  Hold'em No Limit ($3/$6 USD) - 2013/08/11 8:22:34 ET
Table 'Lorcia IV 40-100 bb' 6-max Seat #1 is the button
Seat 1: Scarface.VLT ($909.80 in chips) 
Seat 2: patapong ($1132.58 in chips) 
Seat 4: GERAKLmeat ($240 in chips) 
Seat 5: klenius ($815.03 in chips) 
patapong: posts small blind $3
ZarubaNT: is sitting out 
GERAKLmeat: posts big blind $6
*** HOLE CARDS ***
Chappolini joins the table at seat #6 
klenius: raises $6 to $12
Scarface.VLT: folds 
patapong: folds 
GERAKLmeat: calls $6
*** FLOP *** [7d 7s Qh]
GERAKLmeat: checks 
klenius: checks 
*** TURN *** [7d 7s Qh] [5c]
GERAKLmeat: bets $13.14
klenius: calls $13.14
*** RIVER *** [7d 7s Qh 5c] [9d]
GERAKLmeat: checks 
klenius: checks 
*** SHOW DOWN ***
GERAKLmeat: shows [As 5d] (two pair, Sevens and Fives)
klenius: mucks hand 
GERAKLmeat collected $51.78 from pot
*** SUMMARY ***
Total pot $53.28 | Rake $1.50 
Board [7d 7s Qh 5c 9d]
Seat 1: Scarface.VLT (button) folded before Flop (didn't bet)
Seat 2: patapong (small blind) folded before Flop
Seat 4: GERAKLmeat (big blind) showed [As 5d] and won ($51.78) with two pair, Sevens and Fives
Seat 5: klenius mucked


PokerStars Game #102601951702:  Hold'em No Limit ($3/$6 USD) - 2013/08/11 8:23:16 ET
Table 'Lorcia IV 40-100 bb' 6-max Seat #2 is the button
Seat 1: Scarface.VLT ($909.80 in chips) 
Seat 2: patapong ($1129.58 in chips) 
Seat 4: GERAKLmeat ($266.64 in chips) 
Seat 5: klenius ($789.89 in chips) 
GERAKLmeat: posts small blind $3
klenius: posts big blind $6
Chappolini: sits out 
*** HOLE CARDS ***
Scarface.VLT: raises $6 to $12
patapong: folds 
GERAKLmeat: folds 
klenius: raises $30 to $42
Scarface.VLT: calls $30
*** FLOP *** [6c 6s 5d]
klenius: bets $48
Scarface.VLT: calls $48
*** TURN *** [6c 6s 5d] [9h]
klenius: bets $144
Scarface.VLT: folds 
Uncalled bet ($144) returned to klenius
klenius collected $181.50 from pot
*** SUMMARY ***
Total pot $183 | Rake $1.50 
Board [6c 6s 5d 9h]
Seat 1: Scarface.VLT folded on the Turn
Seat 2: patapong (button) folded before Flop (didn't bet)
Seat 4: GERAKLmeat (small blind) folded before Flop
Seat 5: klenius (big blind) collected ($181.50)


PokerStars Game #102601996347:  Hold'em No Limit ($3/$6 USD) - 2013/08/11 8:24:40 ET
Table 'Lorcia IV 40-100 bb' 6-max Seat #4 is the button
Seat 1: Scarface.VLT ($819.80 in chips) 
Seat 2: patapong ($1129.58 in chips) 
Seat 4: GERAKLmeat ($263.64 in chips) 
Seat 5: klenius ($881.39 in chips) 
Seat 6: Chappolini ($600 in chips) 
klenius: posts small blind $3
Chappolini: posts big blind $6
ZarubaNT: sits out 
*** HOLE CARDS ***
Scarface.VLT: folds 
patapong: folds 
GERAKLmeat: raises $6 to $12
klenius: folds 
Chappolini: folds 
Uncalled bet ($6) returned to GERAKLmeat
GERAKLmeat collected $15 from pot
GERAKLmeat: doesn't show hand 
*** SUMMARY ***
Total pot $15 | Rake $0 
Seat 1: Scarface.VLT folded before Flop (didn't bet)
Seat 2: patapong folded before Flop (didn't bet)
Seat 4: GERAKLmeat (button) collected ($15)
Seat 5: klenius (small blind) folded before Flop
Seat 6: Chappolini (big blind) folded before Flop


PokerStars Game #102602029779:  Hold'em No Limit ($3/$6 USD) - 2013/08/11 8:25:43 ET
Table 'Lorcia IV 40-100 bb' 6-max Seat #6 is the button
Seat 1: Scarface.VLT ($813.80 in chips) 
Seat 2: patapong ($1129.58 in chips) 
Seat 4: GERAKLmeat ($244.57 in chips) 
Seat 5: klenius ($912.66 in chips) 
Seat 6: Chappolini ($600 in chips) 
Scarface.VLT: posts small blind $3
patapong: posts big blind $6
ZarubaNT: sits out 
*** HOLE CARDS ***
GERAKLmeat: folds 
klenius: raises $6 to $12
Chappolini: folds 
Scarface.VLT: folds 
patapong: folds 
Uncalled bet ($6) returned to klenius
klenius collected $15 from pot
*** SUMMARY ***
Total pot $15 | Rake $0 
Seat 1: Scarface.VLT (small blind) folded before Flop
Seat 2: patapong (big blind) folded before Flop
Seat 4: GERAKLmeat folded before Flop (didn't bet)
Seat 5: klenius collected ($15)
Seat 6: Chappolini (button) folded before Flop (didn't bet)


PokerStars Game #102602039972:  Hold'em No Limit ($3/$6 USD) - 2013/08/11 8:26:02 ET
Table 'Lorcia IV 40-100 bb' 6-max Seat #1 is the button
Seat 1: Scarface.VLT ($810.80 in chips) 
Seat 2: patapong ($1123.58 in chips) 
Seat 3: ZarubaNT ($1391.43 in chips) 
Seat 4: GERAKLmeat ($244.57 in chips) 
Seat 5: klenius ($921.66 in chips) 
Seat 6: Chappolini ($600 in chips) 
patapong: posts small blind $3
ZarubaNT: posts big blind $6
*** HOLE CARDS ***
GERAKLmeat: folds 
klenius: folds 
Chappolini: folds 
Scarface.VLT: raises $6 to $12
patapong: folds 
ZarubaNT: calls $6
*** FLOP *** [2s Qc 7d]
ZarubaNT: checks 
Scarface.VLT: bets $18.04
ZarubaNT: calls $18.04
*** TURN *** [2s Qc 7d] [6s]
ZarubaNT: checks 
Scarface.VLT: bets $42.19
ZarubaNT: calls $42.19
*** RIVER *** [2s Qc 7d 6s] [8s]
ZarubaNT: checks 
Scarface.VLT: checks 
*** SHOW DOWN ***
ZarubaNT: shows [Tc Qh] (a pair of Queens)
Scarface.VLT: shows [Qd Ts] (a pair of Queens)
ZarubaNT collected $72.33 from pot
Scarface.VLT collected $72.33 from pot
*** SUMMARY ***
Total pot $147.46 | Rake $2.80 
Board [2s Qc 7d 6s 8s]
Seat 1: Scarface.VLT (button) showed [Qd Ts] and won ($72.33) with a pair of Queens
Seat 2: patapong (small blind) folded before Flop
Seat 3: ZarubaNT (big blind) showed [Tc Qh] and won ($72.33) with a pair of Queens
Seat 4: GERAKLmeat folded before Flop (didn't bet)
Seat 5: klenius folded before Flop (didn't bet)
Seat 6: Chappolini folded before Flop (didn't bet)


PokerStars Game #102602081197:  Hold'em No Limit ($3/$6 USD) - 2013/08/11 8:27:20 ET
Table 'Lorcia IV 40-100 bb' 6-max Seat #2 is the button
Seat 1: Scarface.VLT ($810.90 in chips) 
Seat 2: patapong ($1120.58 in chips) 
Seat 3: ZarubaNT ($1391.53 in chips) 
Seat 4: GERAKLmeat ($244.57 in chips) 
Seat 5: klenius ($921.66 in chips) 
Seat 6: Chappolini ($600 in chips) 
ZarubaNT: posts small blind $3
GERAKLmeat: posts big blind $6
*** HOLE CARDS ***
klenius: folds 
Chappolini: folds 
Scarface.VLT: folds 
patapong: raises $6 to $12
ZarubaNT: folds 
GERAKLmeat: raises $18 to $30
patapong: folds 
Uncalled bet ($18) returned to GERAKLmeat
GERAKLmeat collected $27 from pot
GERAKLmeat: doesn't show hand 
*** SUMMARY ***
Total pot $27 | Rake $0 
Seat 1: Scarface.VLT folded before Flop (didn't bet)
Seat 2: patapong (button) folded before Flop
Seat 3: ZarubaNT (small blind) folded before Flop
Seat 4: GERAKLmeat (big blind) collected ($27)
Seat 5: klenius folded before Flop (didn't bet)
Seat 6: Chappolini folded before Flop (didn't bet)


PokerStars Game #102602101033:  Hold'em No Limit ($3/$6 USD) - 2013/08/11 8:27:57 ET
Table 'Lorcia IV 40-100 bb' 6-max Seat #3 is the button
Seat 1: Scarface.VLT ($810.90 in chips) 
Seat 2: patapong ($1108.58 in chips) 
Seat 3: ZarubaNT ($1388.53 in chips) 
Seat 4: GERAKLmeat ($259.57 in chips) 
Seat 5: klenius ($921.66 in chips) 
Seat 6: Chappolini ($600 in chips) 
GERAKLmeat: posts small blind $3
klenius: posts big blind $6
*** HOLE CARDS ***
Chappolini: folds 
Scarface.VLT: folds 
patapong: folds 
ZarubaNT: raises $6 to $12
GERAKLmeat: folds 
klenius: calls $6
*** FLOP *** [9s Ac 5d]
klenius: checks 
ZarubaNT: bets $18
klenius: raises $36 to $54
ZarubaNT: calls $36
*** TURN *** [9s Ac 5d] [2c]
klenius: bets $120
ZarubaNT: calls $120
*** RIVER *** [9s Ac 5d 2c] [2d]
klenius: bets $336
ZarubaNT: calls $336
*** SHOW DOWN ***
klenius: shows [5s 5c] (a full house, Fives full of Deuces)
ZarubaNT: mucks hand 
klenius collected $1044.20 from pot
*** SUMMARY ***
Total pot $1047 | Rake $2.80 
Board [9s Ac 5d 2c 2d]
Seat 1: Scarface.VLT folded before Flop (didn't bet)
Seat 2: patapong folded before Flop (didn't bet)
Seat 3: ZarubaNT (button) mucked
Seat 4: GERAKLmeat (small blind) folded before Flop
Seat 5: klenius (big blind) showed [5s 5c] and won ($1044.20) with a full house, Fives full of Deuces
Seat 6: Chappolini folded before Flop (didn't bet)


PokerStars Game #102602140001:  Hold'em No Limit ($3/$6 USD) - 2013/08/11 8:29:10 ET
Table 'Lorcia IV 40-100 bb' 6-max Seat #4 is the button
Seat 1: Scarface.VLT ($810.90 in chips) 
Seat 2: patapong ($1108.58 in chips) 
Seat 3: ZarubaNT ($866.53 in chips) 
Seat 4: GERAKLmeat ($256.57 in chips) 
Seat 5: klenius ($1443.86 in chips) 
Seat 6: Chappolini ($600 in chips) 
klenius: posts small blind $3
Chappolini: posts big blind $6
*** HOLE CARDS ***
Scarface.VLT: raises $12 to $18
patapong: folds 
ZarubaNT: folds 
GERAKLmeat: folds 
klenius: folds 
Chappolini: folds 
Uncalled bet ($12) returned to Scarface.VLT
Scarface.VLT collected $15 from pot
Scarface.VLT: doesn't show hand 
*** SUMMARY ***
Total pot $15 | Rake $0 
Seat 1: Scarface.VLT collected ($15)
Seat 2: patapong folded before Flop (didn't bet)
Seat 3: ZarubaNT folded before Flop (didn't bet)
Seat 4: GERAKLmeat (button) folded before Flop (didn't bet)
Seat 5: klenius (small blind) folded before Flop
Seat 6: Chappolini (big blind) folded before Flop


PokerStars Game #102602152130:  Hold'em No Limit ($3/$6 USD) - 2013/08/11 8:29:33 ET
Table 'Lorcia IV 40-100 bb' 6-max Seat #5 is the button
Seat 1: Scarface.VLT ($819.90 in chips) 
Seat 2: patapong ($1108.58 in chips) 
Seat 3: ZarubaNT ($866.53 in chips) 
Seat 4: GERAKLmeat ($256.57 in chips) 
Seat 5: klenius ($1440.86 in chips) 
Seat 6: Chappolini ($600 in chips) 
Chappolini: posts small blind $3
Scarface.VLT: posts big blind $6
*** HOLE CARDS ***
patapong: folds 
ZarubaNT: folds 
GERAKLmeat: folds 
klenius: raises $6 to $12
Chappolini: calls $9
Scarface.VLT: folds 
*** FLOP *** [9c 6h 4s]
Chappolini: checks 
klenius: bets $18
Chappolini: calls $18
*** TURN *** [9c 6h 4s] [9d]
Chappolini: checks 
klenius: bets $54
Chappolini: folds 
Uncalled bet ($54) returned to klenius
klenius collected $63.20 from pot
*** SUMMARY ***
Total pot $66 | Rake $2.80 
Board [9c 6h 4s 9d]
Seat 1: Scarface.VLT (big blind) folded before Flop
Seat 2: patapong folded before Flop (didn't bet)
Seat 3: ZarubaNT folded before Flop (didn't bet)
Seat 4: GERAKLmeat folded before Flop (didn't bet)
Seat 5: klenius (button) collected ($63.20)
Seat 6: Chappolini (small blind) folded on the Turn


PokerStars Game #102601222334:  Hold'em No Limit ($3/$6 USD) - 2013/08/11 8:00:05 ET
Table 'Lorcia IV 40-100 bb' 6-max Seat #3 is the button
Seat 1: Scarface.VLT ($656.71 in chips) 
Seat 2: Ratatuj ($249 in chips) 
Seat 3: ZarubaNT ($1268.03 in chips) 
Seat 4: GERAKLmeat ($452.31 in chips) 
Seat 5: klenius ($741.14 in chips) 
GERAKLmeat: posts small blind $3
klenius: posts big blind $6
LukaschenkoA: sits out 
*** HOLE CARDS ***
Scarface.VLT: folds 
Ratatuj: folds 
ZarubaNT: raises $6 to $12
GERAKLmeat: folds 
klenius: raises $36 to $48
ZarubaNT: folds 
Uncalled bet ($36) returned to klenius
klenius collected $27 from pot
*** SUMMARY ***
Total pot $27 | Rake $0 
Seat 1: Scarface.VLT folded before Flop (didn't bet)
Seat 2: Ratatuj folded before Flop (didn't bet)
Seat 3: ZarubaNT (button) folded before Flop
Seat 4: GERAKLmeat (small blind) folded before Flop
Seat 5: klenius (big blind) collected ($27)


PokerStars Game #102601234444:  Hold'em No Limit ($3/$6 USD) - 2013/08/11 8:00:35 ET
Table 'Lorcia IV 40-100 bb' 6-max Seat #4 is the button
Seat 1: Scarface.VLT ($656.71 in chips) 
Seat 2: Ratatuj ($249 in chips) 
Seat 3: ZarubaNT ($1256.03 in chips) 
Seat 4: GERAKLmeat ($449.31 in chips) 
Seat 5: klenius ($756.14 in chips) 
Seat 6: LukaschenkoA ($600 in chips) 
klenius: posts small blind $3
LukaschenkoA: posts big blind $6
*** HOLE CARDS ***
Scarface.VLT: raises $12 to $18
Ratatuj: folds 
ZarubaNT: raises $30 to $48
GERAKLmeat: folds 
klenius: folds 
LukaschenkoA: folds 
Scarface.VLT: raises $30 to $78
ZarubaNT: raises $66 to $144
Scarface.VLT: calls $66
*** FLOP *** [Tc 7h 5h]
Scarface.VLT: checks 
ZarubaNT: bets $96
Scarface.VLT: folds 
Uncalled bet ($96) returned to ZarubaNT
ZarubaNT collected $294.20 from pot
ZarubaNT: doesn't show hand 
*** SUMMARY ***
Total pot $297 | Rake $2.80 
Board [Tc 7h 5h]
Seat 1: Scarface.VLT folded on the Flop
Seat 2: Ratatuj folded before Flop (didn't bet)
Seat 3: ZarubaNT collected ($294.20)
Seat 4: GERAKLmeat (button) folded before Flop (didn't bet)
Seat 5: klenius (small blind) folded before Flop
Seat 6: LukaschenkoA (big blind) folded before Flop


PokerStars Game #102601295587:  Hold'em No Limit ($3/$6 USD) - 2013/08/11 8:02:41 ET
Table 'Lorcia IV 40-100 bb' 6-max Seat #5 is the button
Seat 3: ZarubaNT ($1406.23 in chips) 
Seat 4: GERAKLmeat ($449.31 in chips) 
Seat 5: klenius ($753.14 in chips) 
Seat 6: LukaschenkoA ($600 in chips) 
LukaschenkoA: posts small blind $3
Scarface.VLT: is sitting out 
Ratatuj: is sitting out 
ZarubaNT: posts big blind $6
*** HOLE CARDS ***
Ratatuj leaves the table
GERAKLmeat: folds 
klenius: raises $6 to $12
LukaschenkoA: folds 
ZarubaNT: folds 
Uncalled bet ($6) returned to klenius
redon1 joins the table at seat #2 
klenius collected $15 from pot
*** SUMMARY ***
Total pot $15 | Rake $0 
Seat 3: ZarubaNT (big blind) folded before Flop
Seat 4: GERAKLmeat folded before Flop (didn't bet)
Seat 5: klenius (button) collected ($15)
Seat 6: LukaschenkoA (small blind) folded before Flop


PokerStars Game #102601300857:  Hold'em No Limit ($3/$6 USD) - 2013/08/11 8:02:51 ET
Table 'Lorcia IV 40-100 bb' 6-max Seat #6 is the button
Seat 3: ZarubaNT ($1400.23 in chips) 
Seat 4: GERAKLmeat ($449.31 in chips) 
Seat 5: klenius ($762.14 in chips) 
Seat 6: LukaschenkoA ($600 in chips) 
ZarubaNT: posts small blind $3
GERAKLmeat: posts big blind $6
*** HOLE CARDS ***
klenius: raises $6 to $12
LukaschenkoA: folds 
ZarubaNT: folds 
GERAKLmeat: folds 
Uncalled bet ($6) returned to klenius
klenius collected $15 from pot
*** SUMMARY ***
Total pot $15 | Rake $0 
Seat 3: ZarubaNT (small blind) folded before Flop
Seat 4: GERAKLmeat (big blind) folded before Flop
Seat 5: klenius collected ($15)
Seat 6: LukaschenkoA (button) folded before Flop (didn't bet)


PokerStars Game #102601305978:  Hold'em No Limit ($3/$6 USD) - 2013/08/11 8:03:01 ET
Table 'Lorcia IV 40-100 bb' 6-max Seat #3 is the button
Seat 3: ZarubaNT ($1397.23 in chips) 
Seat 4: GERAKLmeat ($443.31 in chips) 
Seat 5: klenius ($771.14 in chips) 
Seat 6: LukaschenkoA ($600 in chips) 
GERAKLmeat: posts small blind $3
klenius: posts big blind $6
*** HOLE CARDS ***
redon1 leaves the table
LukaschenkoA: folds 
ZarubaNT: folds 
Scarface.VLT said, "brb ladies and ****s"
GERAKLmeat: raises $6 to $12
Scarface.VLT said, "p1mps"
klenius: raises $30 to $42
GERAKLmeat: raises $42 to $84
klenius: raises $60 to $144
GERAKLmeat: raises $299.31 to $443.31 and is all-in
klenius: calls $299.31
*** FLOP *** [3h 8c 7c]
*** TURN *** [3h 8c 7c] [6c]
*** RIVER *** [3h 8c 7c 6c] [Qc]
*** SHOW DOWN ***
GERAKLmeat: shows [Ad Kc] (a flush, King high)
klenius: shows [Qd Jd] (a pair of Queens)
GERAKLmeat collected $885.12 from pot
*** SUMMARY ***
Total pot $886.62 | Rake $1.50 
Board [3h 8c 7c 6c Qc]
Seat 3: ZarubaNT (button) folded before Flop (didn't bet)
Seat 4: GERAKLmeat (small blind) showed [Ad Kc] and won ($885.12) with a flush, King high
Seat 5: klenius (big blind) showed [Qd Jd] and lost with a pair of Queens
Seat 6: LukaschenkoA folded before Flop (didn't bet)


PokerStars Game #102601327284:  Hold'em No Limit ($3/$6 USD) - 2013/08/11 8:03:42 ET
Table 'Lorcia IV 40-100 bb' 6-max Seat #4 is the button
Seat 3: ZarubaNT ($1397.23 in chips) 
Seat 4: GERAKLmeat ($885.12 in chips) 
Seat 5: klenius ($327.83 in chips) 
Seat 6: LukaschenkoA ($600 in chips) 
klenius: posts small blind $3
LukaschenkoA: posts big blind $6
*** HOLE CARDS ***
ZarubaNT: folds 
GERAKLmeat: raises $6 to $12
klenius: raises $30 to $42
LukaschenkoA: folds 
GERAKLmeat: calls $30
*** FLOP *** [7d 2s 7s]
klenius: bets $72
GERAKLmeat: folds 
Uncalled bet ($72) returned to klenius
klenius collected $88.50 from pot
*** SUMMARY ***
Total pot $90 | Rake $1.50 
Board [7d 2s 7s]
Seat 3: ZarubaNT folded before Flop (didn't bet)
Seat 4: GERAKLmeat (button) folded on the Flop
Seat 5: klenius (small blind) collected ($88.50)
Seat 6: LukaschenkoA (big blind) folded before Flop


PokerStars Game #102601338976:  Hold'em No Limit ($3/$6 USD) - 2013/08/11 8:04:04 ET
Table 'Lorcia IV 40-100 bb' 6-max Seat #5 is the button
Seat 3: ZarubaNT ($1397.23 in chips) 
Seat 4: GERAKLmeat ($843.12 in chips) 
Seat 5: klenius ($374.33 in chips) 
Seat 6: LukaschenkoA ($600 in chips) 
LukaschenkoA: posts small blind $3
ZarubaNT: posts big blind $6
*** HOLE CARDS ***
GERAKLmeat: folds 
klenius: raises $6 to $12
LukaschenkoA: calls $9
ZarubaNT: calls $6
*** FLOP *** [3c Qs Qc]
LukaschenkoA: checks 
ZarubaNT: checks 
klenius: bets $30
LukaschenkoA: calls $30
ZarubaNT: folds 
*** TURN *** [3c Qs Qc] [Th]
LukaschenkoA: checks 
klenius: bets $90
LukaschenkoA: calls $90
*** RIVER *** [3c Qs Qc Th] [7d]
LukaschenkoA: checks 
klenius: bets $242.33 and is all-in
LukaschenkoA: calls $242.33
*** SHOW DOWN ***
klenius: shows [Qd 3h] (a full house, Queens full of Threes)
LukaschenkoA: shows [Ts Ks] (two pair, Queens and Tens)
klenius collected $759.16 from pot
*** SUMMARY ***
Total pot $760.66 | Rake $1.50 
Board [3c Qs Qc Th 7d]
Seat 3: ZarubaNT (big blind) folded on the Flop
Seat 4: GERAKLmeat folded before Flop (didn't bet)
Seat 5: klenius (button) showed [Qd 3h] and won ($759.16) with a full house, Queens full of Threes
Seat 6: LukaschenkoA (small blind) showed [Ts Ks] and lost with two pair, Queens and Tens


PokerStars Game #102601394677:  Hold'em No Limit ($3/$6 USD) - 2013/08/11 8:05:49 ET
Table 'Lorcia IV 40-100 bb' 6-max Seat #6 is the button
Seat 3: ZarubaNT ($1385.23 in chips) 
Seat 4: GERAKLmeat ($843.12 in chips) 
Seat 5: klenius ($759.16 in chips) 
Seat 6: LukaschenkoA ($600 in chips) 
ZarubaNT: posts small blind $3
GERAKLmeat: posts big blind $6
*** HOLE CARDS ***
klenius: folds 
LukaschenkoA: raises $6 to $12
ZarubaNT: folds 
GERAKLmeat: calls $6
*** FLOP *** [Ad Kh 4c]
GERAKLmeat: checks 
LukaschenkoA: checks 
*** TURN *** [Ad Kh 4c] [Qd]
GERAKLmeat: checks 
LukaschenkoA: bets $18
GERAKLmeat: folds 
Uncalled bet ($18) returned to LukaschenkoA
LukaschenkoA collected $25.78 from pot
LukaschenkoA: doesn't show hand 
*** SUMMARY ***
Total pot $27 | Rake $1.22 
Board [Ad Kh 4c Qd]
Seat 3: ZarubaNT (small blind) folded before Flop
Seat 4: GERAKLmeat (big blind) folded on the Turn
Seat 5: klenius folded before Flop (didn't bet)
Seat 6: LukaschenkoA (button) collected ($25.78)


PokerStars Game #102601408589:  Hold'em No Limit ($3/$6 USD) - 2013/08/11 8:06:15 ET
Table 'Lorcia IV 40-100 bb' 6-max Seat #3 is the button
Seat 3: ZarubaNT ($1382.23 in chips) 
Seat 4: GERAKLmeat ($831.12 in chips) 
Seat 5: klenius ($759.16 in chips) 
Seat 6: LukaschenkoA ($613.78 in chips) 
GERAKLmeat: posts small blind $3
klenius: posts big blind $6
*** HOLE CARDS ***
LukaschenkoA: folds 
ZarubaNT: raises $6 to $12
GERAKLmeat: raises $18 to $30
klenius: raises $60 to $90
ZarubaNT: folds 
GERAKLmeat: calls $60
*** FLOP *** [5h 4d 2h]
GERAKLmeat: checks 
klenius: bets $150
GERAKLmeat: folds 
Uncalled bet ($150) returned to klenius
klenius collected $190.50 from pot
*** SUMMARY ***
Total pot $192 | Rake $1.50 
Board [5h 4d 2h]
Seat 3: ZarubaNT (button) folded before Flop
Seat 4: GERAKLmeat (small blind) folded on the Flop
Seat 5: klenius (big blind) collected ($190.50)
Seat 6: LukaschenkoA folded before Flop (didn't bet)


PokerStars Game #102601428184:  Hold'em No Limit ($3/$6 USD) - 2013/08/11 8:06:51 ET
Table 'Lorcia IV 40-100 bb' 6-max Seat #4 is the button
Seat 3: ZarubaNT ($1370.23 in chips) 
Seat 4: GERAKLmeat ($741.12 in chips) 
Seat 5: klenius ($859.66 in chips) 
Seat 6: LukaschenkoA ($613.78 in chips) 
klenius: posts small blind $3
LukaschenkoA: posts big blind $6
Scarface.VLT: sits out 
*** HOLE CARDS ***
ZarubaNT: folds 
GERAKLmeat: raises $6 to $12
klenius: folds 
LukaschenkoA: calls $6
*** FLOP *** [9d 2h Th]
LukaschenkoA: checks 
GERAKLmeat: bets $13.14
LukaschenkoA: calls $13.14
*** TURN *** [9d 2h Th] [8h]
DavetheDawg joins the table at seat #2 
LukaschenkoA: checks 
GERAKLmeat: checks 
*** RIVER *** [9d 2h Th 8h] [5d]
DavetheDawg leaves the table
LukaschenkoA: checks 
GERAKLmeat: bets $100
LukaschenkoA: folds 
Uncalled bet ($100) returned to GERAKLmeat
GERAKLmeat collected $51.78 from pot
GERAKLmeat: doesn't show hand 
*** SUMMARY ***
Total pot $53.28 | Rake $1.50 
Board [9d 2h Th 8h 5d]
Seat 3: ZarubaNT folded before Flop (didn't bet)
Seat 4: GERAKLmeat (button) collected ($51.78)
Seat 5: klenius (small blind) folded before Flop
Seat 6: LukaschenkoA (big blind) folded on the River


PokerStars Game #102601459762:  Hold'em No Limit ($3/$6 USD) - 2013/08/11 8:07:50 ET
Table 'Lorcia IV 40-100 bb' 6-max Seat #5 is the button
Seat 1: Scarface.VLT ($600 in chips) 
Seat 3: ZarubaNT ($1370.23 in chips) 
Seat 4: GERAKLmeat ($767.76 in chips) 
Seat 5: klenius ($856.66 in chips) 
Seat 6: LukaschenkoA ($600 in chips) 
LukaschenkoA: posts small blind $3
Scarface.VLT: posts big blind $6
*** HOLE CARDS ***
ZarubaNT: folds 
GERAKLmeat: folds 
klenius has timed out
klenius: folds 
LukaschenkoA: folds 
Uncalled bet ($3) returned to Scarface.VLT
Scarface.VLT collected $6 from pot
Scarface.VLT: doesn't show hand 
*** SUMMARY ***
Total pot $6 | Rake $0 
Seat 1: Scarface.VLT (big blind) collected ($6)
Seat 3: ZarubaNT folded before Flop (didn't bet)
Seat 4: GERAKLmeat folded before Flop (didn't bet)
Seat 5: klenius (button) folded before Flop (didn't bet)
Seat 6: LukaschenkoA (small blind) folded before Flop


PokerStars Game #102601472863:  Hold'em No Limit ($3/$6 USD) - 2013/08/11 8:08:15 ET
Table 'Lorcia IV 40-100 bb' 6-max Seat #6 is the button
Seat 1: Scarface.VLT ($603 in chips) 
Seat 3: ZarubaNT ($1370.23 in chips) 
Seat 4: GERAKLmeat ($767.76 in chips) 
Seat 5: klenius ($856.66 in chips) 
Seat 6: LukaschenkoA ($600 in chips) 
Scarface.VLT: posts small blind $3
ZarubaNT: posts big blind $6
*** HOLE CARDS ***
GERAKLmeat: folds 
klenius: raises $6 to $12
LukaschenkoA: folds 
Scarface.VLT: folds 
ZarubaNT: folds 
Uncalled bet ($6) returned to klenius
klenius collected $15 from pot
*** SUMMARY ***
Total pot $15 | Rake $0 
Seat 1: Scarface.VLT (small blind) folded before Flop
Seat 3: ZarubaNT (big blind) folded before Flop
Seat 4: GERAKLmeat folded before Flop (didn't bet)
Seat 5: klenius collected ($15)
Seat 6: LukaschenkoA (button) folded before Flop (didn't bet)


PokerStars Game #102601482424:  Hold'em No Limit ($3/$6 USD) - 2013/08/11 8:08:33 ET
Table 'Lorcia IV 40-100 bb' 6-max Seat #1 is the button
Seat 1: Scarface.VLT ($600 in chips) 
Seat 3: ZarubaNT ($1364.23 in chips) 
Seat 4: GERAKLmeat ($767.76 in chips) 
Seat 5: klenius ($865.66 in chips) 
Seat 6: LukaschenkoA ($600 in chips) 
ZarubaNT: posts small blind $3
GERAKLmeat: posts big blind $6
*** HOLE CARDS ***
klenius: raises $6 to $12
LukaschenkoA: folds 
Scarface.VLT: folds 
patapong joins the table at seat #2 
ZarubaNT: calls $9
GERAKLmeat: folds 
*** FLOP *** [8d 2d 5h]
ZarubaNT: checks 
klenius: bets $18
ZarubaNT: folds 
Uncalled bet ($18) returned to klenius
klenius collected $28.65 from pot
*** SUMMARY ***
Total pot $30 | Rake $1.35 
Board [8d 2d 5h]
Seat 1: Scarface.VLT (button) folded before Flop (didn't bet)
Seat 3: ZarubaNT (small blind) folded on the Flop
Seat 4: GERAKLmeat (big blind) folded before Flop
Seat 5: klenius collected ($28.65)
Seat 6: LukaschenkoA folded before Flop (didn't bet)


PokerStars Game #102601501751:  Hold'em No Limit ($3/$6 USD) - 2013/08/11 8:09:09 ET
Table 'Lorcia IV 40-100 bb' 6-max Seat #3 is the button
Seat 1: Scarface.VLT ($600 in chips) 
Seat 3: ZarubaNT ($1352.23 in chips) 
Seat 4: GERAKLmeat ($761.76 in chips) 
Seat 5: klenius ($882.31 in chips) 
Seat 6: LukaschenkoA ($600 in chips) 
GERAKLmeat: posts small blind $3
klenius: posts big blind $6
patapong: sits out 
*** HOLE CARDS ***
LukaschenkoA: folds 
Scarface.VLT: folds 
ZarubaNT: raises $6 to $12
GERAKLmeat: raises $30 to $42
klenius: folds 
ZarubaNT: calls $30
*** FLOP *** [Kd Jd 8d]
GERAKLmeat: bets $44.47
ZarubaNT: folds 
Uncalled bet ($44.47) returned to GERAKLmeat
GERAKLmeat collected $87.20 from pot
GERAKLmeat: doesn't show hand 
*** SUMMARY ***
Total pot $90 | Rake $2.80 
Board [Kd Jd 8d]
Seat 1: Scarface.VLT folded before Flop (didn't bet)
Seat 3: ZarubaNT (button) folded on the Flop
Seat 4: GERAKLmeat (small blind) collected ($87.20)
Seat 5: klenius (big blind) folded before Flop
Seat 6: LukaschenkoA folded before Flop (didn't bet)


PokerStars Game #102601519746:  Hold'em No Limit ($3/$6 USD) - 2013/08/11 8:09:42 ET
Table 'Lorcia IV 40-100 bb' 6-max Seat #4 is the button
Seat 1: Scarface.VLT ($600 in chips) 
Seat 3: ZarubaNT ($1310.23 in chips) 
Seat 4: GERAKLmeat ($806.96 in chips) 
Seat 5: klenius ($876.31 in chips) 
Seat 6: LukaschenkoA ($600 in chips) 
klenius: posts small blind $3
LukaschenkoA: posts big blind $6
patapong: sits out 
*** HOLE CARDS ***
Scarface.VLT: raises $12 to $18
ZarubaNT: folds 
GERAKLmeat: folds 
klenius: folds 
LukaschenkoA: folds 
Uncalled bet ($12) returned to Scarface.VLT
Scarface.VLT collected $15 from pot
Scarface.VLT: doesn't show hand 
*** SUMMARY ***
Total pot $15 | Rake $0 
Seat 1: Scarface.VLT collected ($15)
Seat 3: ZarubaNT folded before Flop (didn't bet)
Seat 4: GERAKLmeat (button) folded before Flop (didn't bet)
Seat 5: klenius (small blind) folded before Flop
Seat 6: LukaschenkoA (big blind) folded before Flop


PokerStars Game #102601525343:  Hold'em No Limit ($3/$6 USD) - 2013/08/11 8:09:53 ET
Table 'Lorcia IV 40-100 bb' 6-max Seat #5 is the button
Seat 1: Scarface.VLT ($609 in chips) 
Seat 3: ZarubaNT ($1310.23 in chips) 
Seat 4: GERAKLmeat ($806.96 in chips) 
Seat 5: klenius ($873.31 in chips) 
Seat 6: LukaschenkoA ($600 in chips) 
LukaschenkoA: posts small blind $3
Scarface.VLT: posts big blind $6
patapong: sits out 
*** HOLE CARDS ***
ZarubaNT: folds 
GERAKLmeat: folds 
klenius: raises $6 to $12
LukaschenkoA: folds 
Scarface.VLT: calls $6
*** FLOP *** [Jd 2h 8c]
Scarface.VLT: checks 
klenius: bets $18
Scarface.VLT: calls $18
*** TURN *** [Jd 2h 8c] [4h]
Scarface.VLT: checks 
klenius: checks 
*** RIVER *** [Jd 2h 8c 4h] [9h]
Scarface.VLT: bets $50
klenius: folds 
Uncalled bet ($50) returned to Scarface.VLT
Scarface.VLT collected $60.20 from pot
Scarface.VLT: doesn't show hand 
*** SUMMARY ***
Total pot $63 | Rake $2.80 
Board [Jd 2h 8c 4h 9h]
Seat 1: Scarface.VLT (big blind) collected ($60.20)
Seat 3: ZarubaNT folded before Flop (didn't bet)
Seat 4: GERAKLmeat folded before Flop (didn't bet)
Seat 5: klenius (button) folded on the River
Seat 6: LukaschenkoA (small blind) folded before Flop


PokerStars Game #102601544401:  Hold'em No Limit ($3/$6 USD) - 2013/08/11 8:10:29 ET
Table 'Lorcia IV 40-100 bb' 6-max Seat #6 is the button
Seat 1: Scarface.VLT ($639.20 in chips) 
Seat 2: patapong ($600 in chips) 
Seat 3: ZarubaNT ($1310.23 in chips) 
Seat 4: GERAKLmeat ($806.96 in chips) 
Seat 5: klenius ($843.31 in chips) 
Seat 6: LukaschenkoA ($600 in chips) 
Scarface.VLT: posts small blind $3
patapong: posts big blind $6
*** HOLE CARDS ***
ZarubaNT: folds 
GERAKLmeat: raises $6 to $12
klenius: folds 
LukaschenkoA: folds 
Scarface.VLT: folds 
patapong: calls $6
*** FLOP *** [5s 2c 7d]
patapong: checks 
GERAKLmeat: bets $13.14
patapong: raises $19.86 to $33
GERAKLmeat: calls $19.86
*** TURN *** [5s 2c 7d] [Ad]
patapong: bets $66
GERAKLmeat: calls $66
*** RIVER *** [5s 2c 7d Ad] [Qs]
patapong: bets $126
GERAKLmeat: raises $569.96 to $695.96 and is all-in
patapong: calls $363 and is all-in
Uncalled bet ($206.96) returned to GERAKLmeat
*** SHOW DOWN ***
GERAKLmeat: shows [5d 5h] (three of a kind, Fives)
patapong: shows [7s 7c] (three of a kind, Sevens)
patapong collected $1200.20 from pot
*** SUMMARY ***
Total pot $1203 | Rake $2.80 
Board [5s 2c 7d Ad Qs]
Seat 1: Scarface.VLT (small blind) folded before Flop
Seat 2: patapong (big blind) showed [7s 7c] and won ($1200.20) with three of a kind, Sevens
Seat 3: ZarubaNT folded before Flop (didn't bet)
Seat 4: GERAKLmeat showed [5d 5h] and lost with three of a kind, Fives
Seat 5: klenius folded before Flop (didn't bet)
Seat 6: LukaschenkoA (button) folded before Flop (didn't bet)


PokerStars Game #102601608222:  Hold'em No Limit ($3/$6 USD) - 2013/08/11 8:12:28 ET
Table 'Lorcia IV 40-100 bb' 6-max Seat #1 is the button
Seat 1: Scarface.VLT ($636.20 in chips) 
Seat 2: patapong ($1200.20 in chips) 
Seat 3: ZarubaNT ($1310.23 in chips) 
Seat 4: GERAKLmeat ($240 in chips) 
Seat 5: klenius ($843.31 in chips) 
Seat 6: LukaschenkoA ($600 in chips) 
patapong: posts small blind $3
ZarubaNT: posts big blind $6
*** HOLE CARDS ***
GERAKLmeat: raises $6 to $12
klenius: raises $24 to $36
LukaschenkoA: folds 
Scarface.VLT: folds 
patapong: folds 
ZarubaNT: folds 
GERAKLmeat: raises $204 to $240 and is all-in
klenius: folds 
Uncalled bet ($204) returned to GERAKLmeat
GERAKLmeat collected $81 from pot
GERAKLmeat: doesn't show hand 
*** SUMMARY ***
Total pot $81 | Rake $0 
Seat 1: Scarface.VLT (button) folded before Flop (didn't bet)
Seat 2: patapong (small blind) folded before Flop
Seat 3: ZarubaNT (big blind) folded before Flop
Seat 4: GERAKLmeat collected ($81)
Seat 5: klenius folded before Flop
Seat 6: LukaschenkoA folded before Flop (didn't bet)


PokerStars Game #102601627249:  Hold'em No Limit ($3/$6 USD) - 2013/08/11 8:13:04 ET
Table 'Lorcia IV 40-100 bb' 6-max Seat #2 is the button
Seat 1: Scarface.VLT ($636.20 in chips) 
Seat 2: patapong ($1197.20 in chips) 
Seat 3: ZarubaNT ($1304.23 in chips) 
Seat 4: GERAKLmeat ($285 in chips) 
Seat 5: klenius ($807.31 in chips) 
Seat 6: LukaschenkoA ($600 in chips) 
ZarubaNT: posts small blind $3
GERAKLmeat: posts big blind $6
*** HOLE CARDS ***
klenius: raises $6 to $12
LukaschenkoA: folds 
Scarface.VLT: folds 
patapong: calls $12
ZarubaNT: folds 
GERAKLmeat: folds 
*** FLOP *** [7s 7d 6h]
klenius: bets $18
patapong: calls $18
*** TURN *** [7s 7d 6h] [Qs]
klenius: bets $48
patapong: folds 
Uncalled bet ($48) returned to klenius
klenius collected $66.20 from pot
*** SUMMARY ***
Total pot $69 | Rake $2.80 
Board [7s 7d 6h Qs]
Seat 1: Scarface.VLT folded before Flop (didn't bet)
Seat 2: patapong (button) folded on the Turn
Seat 3: ZarubaNT (small blind) folded before Flop
Seat 4: GERAKLmeat (big blind) folded before Flop
Seat 5: klenius collected ($66.20)
Seat 6: LukaschenkoA folded before Flop (didn't bet)


PokerStars Game #102601650534:  Hold'em No Limit ($3/$6 USD) - 2013/08/11 8:13:48 ET
Table 'Lorcia IV 40-100 bb' 6-max Seat #3 is the button
Seat 1: Scarface.VLT ($636.20 in chips) 
Seat 2: patapong ($1167.20 in chips) 
Seat 3: ZarubaNT ($1301.23 in chips) 
Seat 4: GERAKLmeat ($279 in chips) 
Seat 5: klenius ($843.51 in chips) 
Seat 6: LukaschenkoA ($600 in chips) 
GERAKLmeat: posts small blind $3
klenius: posts big blind $6
*** HOLE CARDS ***
LukaschenkoA: folds 
Scarface.VLT: folds 
patapong: raises $9 to $15
ZarubaNT: calls $15
GERAKLmeat: folds 
klenius: folds 
*** FLOP *** [4s Js 5d]
patapong: bets $24
ZarubaNT: calls $24
*** TURN *** [4s Js 5d] [8s]
patapong: checks 
ZarubaNT: bets $63
patapong: folds 
Uncalled bet ($63) returned to ZarubaNT
ZarubaNT collected $84.20 from pot
ZarubaNT: doesn't show hand 
*** SUMMARY ***
Total pot $87 | Rake $2.80 
Board [4s Js 5d 8s]
Seat 1: Scarface.VLT folded before Flop (didn't bet)
Seat 2: patapong folded on the Turn
Seat 3: ZarubaNT (button) collected ($84.20)
Seat 4: GERAKLmeat (small blind) folded before Flop
Seat 5: klenius (big blind) folded before Flop
Seat 6: LukaschenkoA folded before Flop (didn't bet)


PokerStars Game #102601680039:  Hold'em No Limit ($3/$6 USD) - 2013/08/11 8:14:44 ET
Table 'Lorcia IV 40-100 bb' 6-max Seat #4 is the button
Seat 1: Scarface.VLT ($636.20 in chips) 
Seat 2: patapong ($1128.20 in chips) 
Seat 3: ZarubaNT ($1346.43 in chips) 
Seat 4: GERAKLmeat ($276 in chips) 
Seat 5: klenius ($837.51 in chips) 
Seat 6: LukaschenkoA ($600 in chips) 
klenius: posts small blind $3
LukaschenkoA: posts big blind $6
*** HOLE CARDS ***
Scarface.VLT: folds 
patapong: folds 
ZarubaNT: folds 
GERAKLmeat: raises $6 to $12
klenius: raises $30 to $42
LukaschenkoA: folds 
GERAKLmeat: folds 
Uncalled bet ($30) returned to klenius
klenius collected $30 from pot
*** SUMMARY ***
Total pot $30 | Rake $0 
Seat 1: Scarface.VLT folded before Flop (didn't bet)
Seat 2: patapong folded before Flop (didn't bet)
Seat 3: ZarubaNT folded before Flop (didn't bet)
Seat 4: GERAKLmeat (button) folded before Flop
Seat 5: klenius (small blind) collected ($30)
Seat 6: LukaschenkoA (big blind) folded before Flop


PokerStars Game #102603637743:  Hold'em No Limit ($3/$6 USD) - 2013/08/11 9:15:03 ET
Table 'Lorcia IV 40-100 bb' 6-max Seat #3 is the button
Seat 1: Scarface.VLT ($1218.40 in chips) 
Seat 2: patapong ($749.58 in chips) 
Seat 3: VegasMidas ($780.46 in chips) 
Seat 4: LueZaS ($600 in chips) 
Seat 5: klenius ($1152.44 in chips) 
Seat 6: EtniX111 ($600 in chips) 
LueZaS: posts small blind $3
klenius: posts big blind $6
*** HOLE CARDS ***
EtniX111: folds 
Scarface.VLT: folds 
patapong: raises $9 to $15
VegasMidas: folds 
LueZaS: folds 
klenius: folds 
Uncalled bet ($9) returned to patapong
patapong collected $15 from pot
*** SUMMARY ***
Total pot $15 | Rake $0 
Seat 1: Scarface.VLT folded before Flop (didn't bet)
Seat 2: patapong collected ($15)
Seat 3: VegasMidas (button) folded before Flop (didn't bet)
Seat 4: LueZaS (small blind) folded before Flop
Seat 5: klenius (big blind) folded before Flop
Seat 6: EtniX111 folded before Flop (didn't bet)


PokerStars Game #102603652385:  Hold'em No Limit ($3/$6 USD) - 2013/08/11 9:15:28 ET
Table 'Lorcia IV 40-100 bb' 6-max Seat #4 is the button
Seat 1: Scarface.VLT ($1218.40 in chips) 
Seat 2: patapong ($758.58 in chips) 
Seat 3: VegasMidas ($780.46 in chips) 
Seat 4: LueZaS ($600 in chips) 
Seat 5: klenius ($1146.44 in chips) 
klenius: posts small blind $3
EtniX111: is sitting out 
Scarface.VLT: posts big blind $6
*** HOLE CARDS ***
patapong: raises $9 to $15
EtniX111 leaves the table
VegasMidas: folds 
LueZaS: folds 
floriiiiider joins the table at seat #6 
klenius: calls $12
floriiiiider leaves the table
Sir_Fuj1 joins the table at seat #6 
Scarface.VLT: folds 
*** FLOP *** [Kh 3d Th]
klenius: checks 
patapong: bets $24.07
klenius: calls $24.07
*** TURN *** [Kh 3d Th] [2s]
klenius: checks 
patapong: bets $55.87
klenius: calls $55.87
*** RIVER *** [Kh 3d Th 2s] [8h]
klenius: checks 
patapong: bets $144
klenius: folds 
Uncalled bet ($144) returned to patapong
patapong collected $193.08 from pot
*** SUMMARY ***
Total pot $195.88 | Rake $2.80 
Board [Kh 3d Th 2s 8h]
Seat 1: Scarface.VLT (big blind) folded before Flop
Seat 2: patapong collected ($193.08)
Seat 3: VegasMidas folded before Flop (didn't bet)
Seat 4: LueZaS (button) folded before Flop (didn't bet)
Seat 5: klenius (small blind) folded on the River


PokerStars Game #102603716184:  Hold'em No Limit ($3/$6 USD) - 2013/08/11 9:17:15 ET
Table 'Lorcia IV 40-100 bb' 6-max Seat #5 is the button
Seat 1: Scarface.VLT ($1212.40 in chips) 
Seat 2: patapong ($856.72 in chips) 
Seat 3: VegasMidas ($780.46 in chips) 
Seat 4: LueZaS ($600 in chips) 
Seat 5: klenius ($1051.50 in chips) 
Sir_Fuj1 will be allowed to play after the button
Scarface.VLT: posts small blind $3
patapong: posts big blind $6
*** HOLE CARDS ***
VegasMidas: folds 
LueZaS: folds 
klenius: folds 
Scarface.VLT: raises $12 to $18
patapong: calls $12
*** FLOP *** [6h 7c 4d]
Scarface.VLT: checks 
patapong: bets $24.07
Scarface.VLT: calls $24.07
*** TURN *** [6h 7c 4d] [9s]
Scarface.VLT: checks 
patapong: checks 
*** RIVER *** [6h 7c 4d 9s] [Ac]
Scarface.VLT: checks 
patapong: checks 
*** SHOW DOWN ***
Scarface.VLT: shows [6c 8h] (a pair of Sixes)
patapong: shows [Qd 7d] (a pair of Sevens)
patapong collected $81.34 from pot
*** SUMMARY ***
Total pot $84.14 | Rake $2.80 
Board [6h 7c 4d 9s Ac]
Seat 1: Scarface.VLT (small blind) showed [6c 8h] and lost with a pair of Sixes
Seat 2: patapong (big blind) showed [Qd 7d] and won ($81.34) with a pair of Sevens
Seat 3: VegasMidas folded before Flop (didn't bet)
Seat 4: LueZaS folded before Flop (didn't bet)
Seat 5: klenius (button) folded before Flop (didn't bet)


PokerStars Game #102603774636:  Hold'em No Limit ($3/$6 USD) - 2013/08/11 9:18:54 ET
Table 'Lorcia IV 40-100 bb' 6-max Seat #1 is the button
Seat 1: Scarface.VLT ($1170.33 in chips) 
Seat 2: patapong ($895.99 in chips) 
Seat 3: VegasMidas ($780.46 in chips) 
Seat 4: LueZaS ($600 in chips) 
Seat 5: klenius ($1051.50 in chips) 
patapong: posts small blind $3
VegasMidas: posts big blind $6
Sir_Fuj1: sits out 
*** HOLE CARDS ***
LueZaS: folds 
klenius: raises $6 to $12
Scarface.VLT: folds 
patapong: folds 
VegasMidas: folds 
Uncalled bet ($6) returned to klenius
klenius collected $15 from pot
*** SUMMARY ***
Total pot $15 | Rake $0 
Seat 1: Scarface.VLT (button) folded before Flop (didn't bet)
Seat 2: patapong (small blind) folded before Flop
Seat 3: VegasMidas (big blind) folded before Flop
Seat 4: LueZaS folded before Flop (didn't bet)
Seat 5: klenius collected ($15)


PokerStars Game #102603793119:  Hold'em No Limit ($3/$6 USD) - 2013/08/11 9:19:25 ET
Table 'Lorcia IV 40-100 bb' 6-max Seat #2 is the button
Seat 1: Scarface.VLT ($1170.33 in chips) 
Seat 2: patapong ($892.99 in chips) 
Seat 3: VegasMidas ($774.46 in chips) 
Seat 4: LueZaS ($600 in chips) 
Seat 5: klenius ($1060.50 in chips) 
VegasMidas: posts small blind $3
LueZaS: posts big blind $6
Sir_Fuj1: sits out 
*** HOLE CARDS ***
klenius: folds 
Scarface.VLT: folds 
patapong: raises $6 to $12
VegasMidas: folds 
LueZaS: folds 
Uncalled bet ($6) returned to patapong
patapong collected $15 from pot
*** SUMMARY ***
Total pot $15 | Rake $0 
Seat 1: Scarface.VLT folded before Flop (didn't bet)
Seat 2: patapong (button) collected ($15)
Seat 3: VegasMidas (small blind) folded before Flop
Seat 4: LueZaS (big blind) folded before Flop
Seat 5: klenius folded before Flop (didn't bet)


PokerStars Game #102603802098:  Hold'em No Limit ($3/$6 USD) - 2013/08/11 9:19:41 ET
Table 'Lorcia IV 40-100 bb' 6-max Seat #3 is the button
Seat 1: Scarface.VLT ($1170.33 in chips) 
Seat 2: patapong ($901.99 in chips) 
Seat 3: VegasMidas ($771.46 in chips) 
Seat 4: LueZaS ($600 in chips) 
Seat 5: klenius ($1060.50 in chips) 
LueZaS: posts small blind $3
klenius: posts big blind $6
Sir_Fuj1: sits out 
*** HOLE CARDS ***
Scarface.VLT: folds 
patapong: folds 
VegasMidas: folds 
LueZaS: raises $9 to $15
klenius: raises $27 to $42
LueZaS: folds 
Uncalled bet ($27) returned to klenius
klenius collected $30 from pot
*** SUMMARY ***
Total pot $30 | Rake $0 
Seat 1: Scarface.VLT folded before Flop (didn't bet)
Seat 2: patapong folded before Flop (didn't bet)
Seat 3: VegasMidas (button) folded before Flop (didn't bet)
Seat 4: LueZaS (small blind) folded before Flop
Seat 5: klenius (big blind) collected ($30)


PokerStars Game #102603466726:  Hold'em No Limit ($3/$6 USD) - 2013/08/11 9:10:09 ET
Table 'Lorcia IV 40-100 bb' 6-max Seat #5 is the button
Seat 1: Scarface.VLT ($1194.20 in chips) 
Seat 2: patapong ($745.20 in chips) 
Seat 3: VegasMidas ($828.46 in chips) 
Seat 4: floriiiiider ($1122.20 in chips) 
Seat 5: klenius ($1086.44 in chips) 
Scarface.VLT: posts small blind $3
patapong: posts big blind $6
*** HOLE CARDS ***
VegasMidas: folds 
floriiiiider: folds 
klenius: raises $6 to $12
Scarface.VLT: folds 
patapong: folds 
Uncalled bet ($6) returned to klenius
klenius collected $15 from pot
*** SUMMARY ***
Total pot $15 | Rake $0 
Seat 1: Scarface.VLT (small blind) folded before Flop
Seat 2: patapong (big blind) folded before Flop
Seat 3: VegasMidas folded before Flop (didn't bet)
Seat 4: floriiiiider folded before Flop (didn't bet)
Seat 5: klenius (button) collected ($15)


PokerStars Game #102603483199:  Hold'em No Limit ($3/$6 USD) - 2013/08/11 9:10:38 ET
Table 'Lorcia IV 40-100 bb' 6-max Seat #1 is the button
Seat 1: Scarface.VLT ($1191.20 in chips) 
Seat 2: patapong ($739.20 in chips) 
Seat 3: VegasMidas ($828.46 in chips) 
Seat 4: floriiiiider ($1122.20 in chips) 
Seat 5: klenius ($1095.44 in chips) 
patapong: posts small blind $3
VegasMidas: posts big blind $6
*** HOLE CARDS ***
floriiiiider: raises $12 to $18
klenius: folds 
EtniX111 joins the table at seat #6 
Scarface.VLT: folds 
patapong: folds 
VegasMidas: folds 
Uncalled bet ($12) returned to floriiiiider
floriiiiider collected $15 from pot
floriiiiider: doesn't show hand 
*** SUMMARY ***
Total pot $15 | Rake $0 
Seat 1: Scarface.VLT (button) folded before Flop (didn't bet)
Seat 2: patapong (small blind) folded before Flop
Seat 3: VegasMidas (big blind) folded before Flop
Seat 4: floriiiiider collected ($15)
Seat 5: klenius folded before Flop (didn't bet)


PokerStars Game #102603499654:  Hold'em No Limit ($3/$6 USD) - 2013/08/11 9:11:06 ET
Table 'Lorcia IV 40-100 bb' 6-max Seat #2 is the button
Seat 1: Scarface.VLT ($1191.20 in chips) 
Seat 2: patapong ($736.20 in chips) 
Seat 3: VegasMidas ($822.46 in chips) 
Seat 5: klenius ($1095.44 in chips) 
VegasMidas: posts small blind $3
floriiiiider: is sitting out 
klenius: posts big blind $6
EtniX111: sits out 
*** HOLE CARDS ***
Scarface.VLT: folds 
patapong: folds 
VegasMidas: calls $3
klenius: raises $12 to $18
floriiiiider leaves the table
VegasMidas: raises $42 to $60
LueZaS joins the table at seat #4 
klenius: raises $96 to $156
VegasMidas: folds 
Uncalled bet ($96) returned to klenius
klenius collected $120 from pot
*** SUMMARY ***
Total pot $120 | Rake $0 
Seat 1: Scarface.VLT folded before Flop (didn't bet)
Seat 2: patapong (button) folded before Flop (didn't bet)
Seat 3: VegasMidas (small blind) folded before Flop
Seat 5: klenius (big blind) collected ($120)


PokerStars Game #102603519367:  Hold'em No Limit ($3/$6 USD) - 2013/08/11 9:11:40 ET
Table 'Lorcia IV 40-100 bb' 6-max Seat #3 is the button
Seat 1: Scarface.VLT ($1191.20 in chips) 
Seat 2: patapong ($736.20 in chips) 
Seat 3: VegasMidas ($762.46 in chips) 
Seat 5: klenius ($1155.44 in chips) 
Seat 6: EtniX111 ($600 in chips) 
LueZaS will be allowed to play after the button
klenius: posts small blind $3
EtniX111: posts big blind $6
*** HOLE CARDS ***
Scarface.VLT: folds 
patapong: folds 
VegasMidas: folds 
klenius: folds 
Uncalled bet ($3) returned to EtniX111
EtniX111 collected $6 from pot
EtniX111: doesn't show hand 
*** SUMMARY ***
Total pot $6 | Rake $0 
Seat 1: Scarface.VLT folded before Flop (didn't bet)
Seat 2: patapong folded before Flop (didn't bet)
Seat 3: VegasMidas (button) folded before Flop (didn't bet)
Seat 5: klenius (small blind) folded before Flop
Seat 6: EtniX111 (big blind) collected ($6)


PokerStars Game #102603526345:  Hold'em No Limit ($3/$6 USD) - 2013/08/11 9:11:52 ET
Table 'Lorcia IV 40-100 bb' 6-max Seat #5 is the button
Seat 1: Scarface.VLT ($1191.20 in chips) 
Seat 2: patapong ($736.20 in chips) 
Seat 3: VegasMidas ($762.46 in chips) 
Seat 5: klenius ($1152.44 in chips) 
Seat 6: EtniX111 ($603 in chips) 
EtniX111: posts small blind $3
Scarface.VLT: posts big blind $6
LueZaS: sits out 
*** HOLE CARDS ***
patapong: folds 
VegasMidas: folds 
klenius: folds 
EtniX111: folds 
Uncalled bet ($3) returned to Scarface.VLT
Scarface.VLT collected $6 from pot
Scarface.VLT: doesn't show hand 
*** SUMMARY ***
Total pot $6 | Rake $0 
Seat 1: Scarface.VLT (big blind) collected ($6)
Seat 2: patapong folded before Flop (didn't bet)
Seat 3: VegasMidas folded before Flop (didn't bet)
Seat 5: klenius (button) folded before Flop (didn't bet)
Seat 6: EtniX111 (small blind) folded before Flop


PokerStars Game #102603538765:  Hold'em No Limit ($3/$6 USD) - 2013/08/11 9:12:14 ET
Table 'Lorcia IV 40-100 bb' 6-max Seat #6 is the button
Seat 1: Scarface.VLT ($1194.20 in chips) 
Seat 2: patapong ($736.20 in chips) 
Seat 3: VegasMidas ($762.46 in chips) 
Seat 5: klenius ($1152.44 in chips) 
Seat 6: EtniX111 ($600 in chips) 
Scarface.VLT: posts small blind $3
patapong: posts big blind $6
LueZaS: sits out 
*** HOLE CARDS ***
VegasMidas: folds 
klenius: folds 
EtniX111: folds 
Scarface.VLT: raises $12 to $18
patapong: calls $12
*** FLOP *** [4s As 8d]
Scarface.VLT said, "luezasssss"
Scarface.VLT said, "pollito"
Scarface.VLT said, ":)"
LueZaS said, "hahaha"
Scarface.VLT: checks 
LueZaS said, "^^"
patapong: bets $24.07
Scarface.VLT said, "buenas suerte"
Scarface.VLT said, "xx"
LueZaS said, "ty"
Scarface.VLT: folds 
Uncalled bet ($24.07) returned to patapong
patapong collected $34.38 from pot
*** SUMMARY ***
Total pot $36 | Rake $1.62 
Board [4s As 8d]
Seat 1: Scarface.VLT (small blind) folded on the Flop
Seat 2: patapong (big blind) collected ($34.38)
Seat 3: VegasMidas folded before Flop (didn't bet)
Seat 5: klenius folded before Flop (didn't bet)
Seat 6: EtniX111 (button) folded before Flop (didn't bet)


PokerStars Game #102603568818:  Hold'em No Limit ($3/$6 USD) - 2013/08/11 9:13:05 ET
Table 'Lorcia IV 40-100 bb' 6-max Seat #1 is the button
Seat 1: Scarface.VLT ($1176.20 in chips) 
Seat 2: patapong ($752.58 in chips) 
Seat 3: VegasMidas ($762.46 in chips) 
Seat 5: klenius ($1152.44 in chips) 
Seat 6: EtniX111 ($600 in chips) 
patapong: posts small blind $3
VegasMidas: posts big blind $6
LueZaS: sits out 
*** HOLE CARDS ***
LueZaS said, "^^"
klenius: folds 
EtniX111: raises $12 to $18
Scarface.VLT: folds 
patapong: folds 
VegasMidas: raises $42 to $60
EtniX111: folds 
Uncalled bet ($42) returned to VegasMidas
VegasMidas collected $39 from pot
*** SUMMARY ***
Total pot $39 | Rake $0 
Seat 1: Scarface.VLT (button) folded before Flop (didn't bet)
Seat 2: patapong (small blind) folded before Flop
Seat 3: VegasMidas (big blind) collected ($39)
Seat 5: klenius folded before Flop (didn't bet)
Seat 6: EtniX111 folded before Flop


PokerStars Game #102603588692:  Hold'em No Limit ($3/$6 USD) - 2013/08/11 9:13:39 ET
Table 'Lorcia IV 40-100 bb' 6-max Seat #2 is the button
Seat 1: Scarface.VLT ($1176.20 in chips) 
Seat 2: patapong ($749.58 in chips) 
Seat 3: VegasMidas ($783.46 in chips) 
Seat 4: LueZaS ($600 in chips) 
Seat 5: klenius ($1152.44 in chips) 
Seat 6: EtniX111 ($600 in chips) 
VegasMidas: posts small blind $3
LueZaS: posts big blind $6
*** HOLE CARDS ***
klenius: folds 
EtniX111: raises $12 to $18
Scarface.VLT: raises $18 to $36
patapong: folds 
VegasMidas: folds 
LueZaS: folds 
EtniX111: calls $18
*** FLOP *** [9d 9s Kc]
EtniX111: checks 
Scarface.VLT: checks 
*** TURN *** [9d 9s Kc] [Jd]
EtniX111: checks 
Scarface.VLT: bets $54.74
EtniX111: folds 
Uncalled bet ($54.74) returned to Scarface.VLT
Scarface.VLT collected $78.20 from pot
Scarface.VLT: doesn't show hand 
*** SUMMARY ***
Total pot $81 | Rake $2.80 
Board [9d 9s Kc Jd]
Seat 1: Scarface.VLT collected ($78.20)
Seat 2: patapong (button) folded before Flop (didn't bet)
Seat 3: VegasMidas (small blind) folded before Flop
Seat 4: LueZaS (big blind) folded before Flop
Seat 5: klenius folded before Flop (didn't bet)
Seat 6: EtniX111 folded on the Turn


PokerStars Game #102603304783:  Hold'em No Limit ($3/$6 USD) - 2013/08/11 9:05:29 ET
Table 'Lorcia IV 40-100 bb' 6-max Seat #4 is the button
Seat 1: Scarface.VLT ($600 in chips) 
Seat 2: patapong ($766.20 in chips) 
Seat 3: VegasMidas ($789.46 in chips) 
Seat 4: floriiiiider ($1131.20 in chips) 
Seat 5: klenius ($1753.52 in chips) 
Seat 6: Chappolini ($830.40 in chips) 
klenius: posts small blind $3
Chappolini: posts big blind $6
*** HOLE CARDS ***
Scarface.VLT: folds 
patapong: folds 
VegasMidas: folds 
floriiiiider: folds 
klenius: raises $6 to $12
Chappolini: calls $6
*** FLOP *** [2s Kh 8h]
klenius: bets $18
Chappolini: calls $18
*** TURN *** [2s Kh 8h] [6c]
klenius: bets $42
Chappolini: calls $42
*** RIVER *** [2s Kh 8h 6c] [9s]
klenius: checks 
Chappolini: checks 
*** SHOW DOWN ***
klenius: shows [6h Ah] (a pair of Sixes)
Chappolini: shows [Kd 5c] (a pair of Kings)
Chappolini collected $141.20 from pot
*** SUMMARY ***
Total pot $144 | Rake $2.80 
Board [2s Kh 8h 6c 9s]
Seat 1: Scarface.VLT folded before Flop (didn't bet)
Seat 2: patapong folded before Flop (didn't bet)
Seat 3: VegasMidas folded before Flop (didn't bet)
Seat 4: floriiiiider (button) folded before Flop (didn't bet)
Seat 5: klenius (small blind) showed [6h Ah] and lost with a pair of Sixes
Seat 6: Chappolini (big blind) showed [Kd 5c] and won ($141.20) with a pair of Kings


PokerStars Game #102603342493:  Hold'em No Limit ($3/$6 USD) - 2013/08/11 9:06:34 ET
Table 'Lorcia IV 40-100 bb' 6-max Seat #5 is the button
Seat 1: Scarface.VLT ($600 in chips) 
Seat 2: patapong ($766.20 in chips) 
Seat 3: VegasMidas ($789.46 in chips) 
Seat 4: floriiiiider ($1131.20 in chips) 
Seat 5: klenius ($1681.52 in chips) 
Seat 6: Chappolini ($899.60 in chips) 
Chappolini: posts small blind $3
Scarface.VLT: posts big blind $6
*** HOLE CARDS ***
patapong: folds 
VegasMidas: raises $12 to $18
floriiiiider: folds 
klenius: folds 
Chappolini: folds 
Scarface.VLT: folds 
Uncalled bet ($12) returned to VegasMidas
VegasMidas collected $15 from pot
*** SUMMARY ***
Total pot $15 | Rake $0 
Seat 1: Scarface.VLT (big blind) folded before Flop
Seat 2: patapong folded before Flop (didn't bet)
Seat 3: VegasMidas collected ($15)
Seat 4: floriiiiider folded before Flop (didn't bet)
Seat 5: klenius (button) folded before Flop (didn't bet)
Seat 6: Chappolini (small blind) folded before Flop


PokerStars Game #102603360274:  Hold'em No Limit ($3/$6 USD) - 2013/08/11 9:07:04 ET
Table 'Lorcia IV 40-100 bb' 6-max Seat #6 is the button
Seat 1: Scarface.VLT ($600 in chips) 
Seat 2: patapong ($766.20 in chips) 
Seat 3: VegasMidas ($798.46 in chips) 
Seat 4: floriiiiider ($1131.20 in chips) 
Seat 5: klenius ($1681.52 in chips) 
Seat 6: Chappolini ($896.60 in chips) 
Scarface.VLT: posts small blind $3
patapong: posts big blind $6
*** HOLE CARDS ***
VegasMidas: raises $12 to $18
floriiiiider: folds 
klenius: folds 
Chappolini: folds 
Scarface.VLT: folds 
patapong: folds 
Uncalled bet ($12) returned to VegasMidas
VegasMidas collected $15 from pot
*** SUMMARY ***
Total pot $15 | Rake $0 
Seat 1: Scarface.VLT (small blind) folded before Flop
Seat 2: patapong (big blind) folded before Flop
Seat 3: VegasMidas collected ($15)
Seat 4: floriiiiider folded before Flop (didn't bet)
Seat 5: klenius folded before Flop (didn't bet)
Seat 6: Chappolini (button) folded before Flop (didn't bet)


PokerStars Game #102603372744:  Hold'em No Limit ($3/$6 USD) - 2013/08/11 9:07:26 ET
Table 'Lorcia IV 40-100 bb' 6-max Seat #1 is the button
Seat 1: Scarface.VLT ($600 in chips) 
Seat 2: patapong ($760.20 in chips) 
Seat 3: VegasMidas ($807.46 in chips) 
Seat 4: floriiiiider ($1131.20 in chips) 
Seat 5: klenius ($1681.52 in chips) 
Seat 6: Chappolini ($896.60 in chips) 
patapong: posts small blind $3
VegasMidas: posts big blind $6
*** HOLE CARDS ***
floriiiiider: folds 
klenius: raises $6 to $12
Chappolini: folds 
Scarface.VLT: raises $30 to $42
patapong: folds 
VegasMidas: folds 
klenius: calls $30
*** FLOP *** [3d 9c 2c]
klenius: checks 
Scarface.VLT: bets $60
klenius: calls $60
*** TURN *** [3d 9c 2c] [5s]
klenius: checks 
Scarface.VLT: bets $150
klenius: raises $1429.52 to $1579.52 and is all-in
Scarface.VLT: calls $348 and is all-in
Uncalled bet ($1081.52) returned to klenius
*** RIVER *** [3d 9c 2c 5s] [Th]
*** SHOW DOWN ***
klenius: shows [9d Ah] (a pair of Nines)
Scarface.VLT: shows [Ks Kc] (a pair of Kings)
Scarface.VLT collected $1206.20 from pot
*** SUMMARY ***
Total pot $1209 | Rake $2.80 
Board [3d 9c 2c 5s Th]
Seat 1: Scarface.VLT (button) showed [Ks Kc] and won ($1206.20) with a pair of Kings
Seat 2: patapong (small blind) folded before Flop
Seat 3: VegasMidas (big blind) folded before Flop
Seat 4: floriiiiider folded before Flop (didn't bet)
Seat 5: klenius showed [9d Ah] and lost with a pair of Nines
Seat 6: Chappolini folded before Flop (didn't bet)


PokerStars Game #102603418909:  Hold'em No Limit ($3/$6 USD) - 2013/08/11 9:08:46 ET
Table 'Lorcia IV 40-100 bb' 6-max Seat #2 is the button
Seat 1: Scarface.VLT ($1206.20 in chips) 
Seat 2: patapong ($757.20 in chips) 
Seat 3: VegasMidas ($801.46 in chips) 
Seat 4: floriiiiider ($1131.20 in chips) 
Seat 5: klenius ($1081.52 in chips) 
Seat 6: Chappolini ($896.60 in chips) 
VegasMidas: posts small blind $3
floriiiiider: posts big blind $6
*** HOLE CARDS ***
klenius: folds 
Chappolini: folds 
Scarface.VLT: folds 
patapong: raises $6 to $12
VegasMidas: raises $36 to $48
floriiiiider: folds 
patapong: folds 
Uncalled bet ($36) returned to VegasMidas
VegasMidas collected $30 from pot
*** SUMMARY ***
Total pot $30 | Rake $0 
Seat 1: Scarface.VLT folded before Flop (didn't bet)
Seat 2: patapong (button) folded before Flop
Seat 3: VegasMidas (small blind) collected ($30)
Seat 4: floriiiiider (big blind) folded before Flop
Seat 5: klenius folded before Flop (didn't bet)
Seat 6: Chappolini folded before Flop (didn't bet)


PokerStars Game #102603428634:  Hold'em No Limit ($3/$6 USD) - 2013/08/11 9:09:03 ET
Table 'Lorcia IV 40-100 bb' 6-max Seat #3 is the button
Seat 1: Scarface.VLT ($1206.20 in chips) 
Seat 2: patapong ($745.20 in chips) 
Seat 3: VegasMidas ($819.46 in chips) 
Seat 4: floriiiiider ($1125.20 in chips) 
Seat 5: klenius ($1081.52 in chips) 
Seat 6: Chappolini ($896.60 in chips) 
floriiiiider: posts small blind $3
klenius: posts big blind $6
*** HOLE CARDS ***
Chappolini: folds 
Scarface.VLT: folds 
patapong: folds 
VegasMidas: raises $6 to $12
floriiiiider: folds 
klenius: folds 
Uncalled bet ($6) returned to VegasMidas
VegasMidas collected $15 from pot
*** SUMMARY ***
Total pot $15 | Rake $0 
Seat 1: Scarface.VLT folded before Flop (didn't bet)
Seat 2: patapong folded before Flop (didn't bet)
Seat 3: VegasMidas (button) collected ($15)
Seat 4: floriiiiider (small blind) folded before Flop
Seat 5: klenius (big blind) folded before Flop
Seat 6: Chappolini folded before Flop (didn't bet)


PokerStars Game #102603446565:  Hold'em No Limit ($3/$6 USD) - 2013/08/11 9:09:34 ET
Table 'Lorcia IV 40-100 bb' 6-max Seat #4 is the button
Seat 1: Scarface.VLT ($1206.20 in chips) 
Seat 2: patapong ($745.20 in chips) 
Seat 3: VegasMidas ($828.46 in chips) 
Seat 4: floriiiiider ($1122.20 in chips) 
Seat 5: klenius ($1075.52 in chips) 
klenius: posts small blind $3
Chappolini: is sitting out 
Scarface.VLT: posts big blind $6
*** HOLE CARDS ***
patapong: folds 
VegasMidas: folds 
floriiiiider: folds 
klenius: raises $6 to $12
Chappolini leaves the table
LuckyMorkva joins the table at seat #6 
LuckyMorkva leaves the table
Scarface.VLT: calls $6
*** FLOP *** [3h Jh Ac]
klenius: bets $18
Scarface.VLT: folds 
Uncalled bet ($18) returned to klenius
klenius collected $22.92 from pot
*** SUMMARY ***
Total pot $24 | Rake $1.08 
Board [3h Jh Ac]
Seat 1: Scarface.VLT (big blind) folded on the Flop
Seat 2: patapong folded before Flop (didn't bet)
Seat 3: VegasMidas folded before Flop (didn't bet)
Seat 4: floriiiiider (button) folded before Flop (didn't bet)
Seat 5: klenius (small blind) collected ($22.92)


PokerStars Game #102602991031:  Hold'em No Limit ($3/$6 USD) - 2013/08/11 8:55:05 ET
Table 'Lorcia IV 40-100 bb' 6-max Seat #4 is the button
Seat 1: Scarface.VLT ($680.82 in chips) 
Seat 2: patapong ($878.26 in chips) 
Seat 4: floriiiiider ($1236.20 in chips) 
Seat 5: klenius ($1579.86 in chips) 
Seat 6: Chappolini ($909.20 in chips) 
klenius: posts small blind $3
Chappolini: posts big blind $6
VegasMidas: sits out 
*** HOLE CARDS ***
Scarface.VLT: folds 
patapong: folds 
floriiiiider: raises $6 to $12
klenius: raises $30 to $42
Chappolini: folds 
floriiiiider: calls $30
*** FLOP *** [As 4c 3s]
klenius: bets $54
floriiiiider: calls $54
*** TURN *** [As 4c 3s] [5d]
klenius: bets $174
floriiiiider: folds 
Uncalled bet ($174) returned to klenius
klenius collected $195.20 from pot
*** SUMMARY ***
Total pot $198 | Rake $2.80 
Board [As 4c 3s 5d]
Seat 1: Scarface.VLT folded before Flop (didn't bet)
Seat 2: patapong folded before Flop (didn't bet)
Seat 4: floriiiiider (button) folded on the Turn
Seat 5: klenius (small blind) collected ($195.20)
Seat 6: Chappolini (big blind) folded before Flop


PokerStars Game #102603014027:  Hold'em No Limit ($3/$6 USD) - 2013/08/11 8:55:58 ET
Table 'Lorcia IV 40-100 bb' 6-max Seat #5 is the button
Seat 1: Scarface.VLT ($680.82 in chips) 
Seat 2: patapong ($878.26 in chips) 
Seat 4: floriiiiider ($1140.20 in chips) 
Seat 5: klenius ($1679.06 in chips) 
Seat 6: Chappolini ($903.20 in chips) 
Chappolini: posts small blind $3
Scarface.VLT: posts big blind $6
VegasMidas: sits out 
*** HOLE CARDS ***
patapong: folds 
floriiiiider: folds 
klenius: folds 
Chappolini: raises $12 to $18
Scarface.VLT: folds 
Uncalled bet ($12) returned to Chappolini
Chappolini collected $12 from pot
Chappolini: doesn't show hand 
*** SUMMARY ***
Total pot $12 | Rake $0 
Seat 1: Scarface.VLT (big blind) folded before Flop
Seat 2: patapong folded before Flop (didn't bet)
Seat 4: floriiiiider folded before Flop (didn't bet)
Seat 5: klenius (button) folded before Flop (didn't bet)
Seat 6: Chappolini (small blind) collected ($12)


PokerStars Game #102603021869:  Hold'em No Limit ($3/$6 USD) - 2013/08/11 8:56:16 ET
Table 'Lorcia IV 40-100 bb' 6-max Seat #6 is the button
Seat 1: Scarface.VLT ($674.82 in chips) 
Seat 2: patapong ($878.26 in chips) 
Seat 4: floriiiiider ($1140.20 in chips) 
Seat 5: klenius ($1679.06 in chips) 
Seat 6: Chappolini ($909.20 in chips) 
Scarface.VLT: posts small blind $3
patapong: posts big blind $6
VegasMidas: sits out 
*** HOLE CARDS ***
floriiiiider: folds 
klenius: raises $6 to $12
Chappolini: folds 
Scarface.VLT: folds 
patapong: folds 
Uncalled bet ($6) returned to klenius
klenius collected $15 from pot
*** SUMMARY ***
Total pot $15 | Rake $0 
Seat 1: Scarface.VLT (small blind) folded before Flop
Seat 2: patapong (big blind) folded before Flop
Seat 4: floriiiiider folded before Flop (didn't bet)
Seat 5: klenius collected ($15)
Seat 6: Chappolini (button) folded before Flop (didn't bet)


PokerStars Game #102603035077:  Hold'em No Limit ($3/$6 USD) - 2013/08/11 8:56:47 ET
Table 'Lorcia IV 40-100 bb' 6-max Seat #1 is the button
Seat 1: Scarface.VLT ($671.82 in chips) 
Seat 2: patapong ($872.26 in chips) 
Seat 3: VegasMidas ($600 in chips) 
Seat 4: floriiiiider ($1140.20 in chips) 
Seat 5: klenius ($1688.06 in chips) 
Seat 6: Chappolini ($909.20 in chips) 
patapong: posts small blind $3
VegasMidas: posts big blind $6
*** HOLE CARDS ***
floriiiiider: folds 
klenius: folds 
Chappolini: folds 
Scarface.VLT: raises $6 to $12
patapong: folds 
VegasMidas: calls $6
*** FLOP *** [4d Kd 9h]
VegasMidas: checks 
Scarface.VLT: bets $8
VegasMidas: raises $40 to $48
Scarface.VLT: folds 
Uncalled bet ($40) returned to VegasMidas
VegasMidas collected $41.06 from pot
*** SUMMARY ***
Total pot $43 | Rake $1.94 
Board [4d Kd 9h]
Seat 1: Scarface.VLT (button) folded on the Flop
Seat 2: patapong (small blind) folded before Flop
Seat 3: VegasMidas (big blind) collected ($41.06)
Seat 4: floriiiiider folded before Flop (didn't bet)
Seat 5: klenius folded before Flop (didn't bet)
Seat 6: Chappolini folded before Flop (didn't bet)


PokerStars Game #102603064401:  Hold'em No Limit ($3/$6 USD) - 2013/08/11 8:57:56 ET
Table 'Lorcia IV 40-100 bb' 6-max Seat #2 is the button
Seat 1: Scarface.VLT ($651.82 in chips) 
Seat 2: patapong ($869.26 in chips) 
Seat 3: VegasMidas ($621.06 in chips) 
Seat 4: floriiiiider ($1140.20 in chips) 
Seat 5: klenius ($1688.06 in chips) 
Seat 6: Chappolini ($909.20 in chips) 
VegasMidas: posts small blind $3
floriiiiider: posts big blind $6
*** HOLE CARDS ***
klenius: raises $6 to $12
Chappolini: folds 
Scarface.VLT: folds 
patapong: folds 
VegasMidas: folds 
floriiiiider: folds 
Uncalled bet ($6) returned to klenius
klenius collected $15 from pot
*** SUMMARY ***
Total pot $15 | Rake $0 
Seat 1: Scarface.VLT folded before Flop (didn't bet)
Seat 2: patapong (button) folded before Flop (didn't bet)
Seat 3: VegasMidas (small blind) folded before Flop
Seat 4: floriiiiider (big blind) folded before Flop
Seat 5: klenius collected ($15)
Seat 6: Chappolini folded before Flop (didn't bet)


PokerStars Game #102603072346:  Hold'em No Limit ($3/$6 USD) - 2013/08/11 8:58:14 ET
Table 'Lorcia IV 40-100 bb' 6-max Seat #3 is the button
Seat 1: Scarface.VLT ($651.82 in chips) 
Seat 2: patapong ($869.26 in chips) 
Seat 3: VegasMidas ($618.06 in chips) 
Seat 4: floriiiiider ($1134.20 in chips) 
Seat 5: klenius ($1697.06 in chips) 
Seat 6: Chappolini ($909.20 in chips) 
floriiiiider: posts small blind $3
klenius: posts big blind $6
*** HOLE CARDS ***
Chappolini: folds 
Scarface.VLT: folds 
patapong: raises $9 to $15
VegasMidas: folds 
floriiiiider: folds 
klenius: calls $9
*** FLOP *** [6d Kh Qh]
klenius: checks 
patapong: bets $22.06
klenius: calls $22.06
*** TURN *** [6d Kh Qh] [2h]
klenius: bets $66
patapong: calls $66
*** RIVER *** [6d Kh Qh 2h] [5d]
klenius: bets $204
patapong: folds 
Uncalled bet ($204) returned to klenius
klenius collected $206.32 from pot
*** SUMMARY ***
Total pot $209.12 | Rake $2.80 
Board [6d Kh Qh 2h 5d]
Seat 1: Scarface.VLT folded before Flop (didn't bet)
Seat 2: patapong folded on the River
Seat 3: VegasMidas (button) folded before Flop (didn't bet)
Seat 4: floriiiiider (small blind) folded before Flop
Seat 5: klenius (big blind) collected ($206.32)
Seat 6: Chappolini folded before Flop (didn't bet)


PokerStars Game #102603116585:  Hold'em No Limit ($3/$6 USD) - 2013/08/11 8:59:56 ET
Table 'Lorcia IV 40-100 bb' 6-max Seat #4 is the button
Seat 1: Scarface.VLT ($651.82 in chips) 
Seat 2: patapong ($766.20 in chips) 
Seat 3: VegasMidas ($618.06 in chips) 
Seat 4: floriiiiider ($1131.20 in chips) 
Seat 5: klenius ($1800.32 in chips) 
Seat 6: Chappolini ($909.20 in chips) 
klenius: posts small blind $3
Chappolini: posts big blind $6
*** HOLE CARDS ***
Scarface.VLT: folds 
patapong: folds 
VegasMidas: folds 
floriiiiider: raises $6 to $12
klenius: folds 
Chappolini: folds 
Uncalled bet ($6) returned to floriiiiider
floriiiiider collected $15 from pot
floriiiiider: doesn't show hand 
*** SUMMARY ***
Total pot $15 | Rake $0 
Seat 1: Scarface.VLT folded before Flop (didn't bet)
Seat 2: patapong folded before Flop (didn't bet)
Seat 3: VegasMidas folded before Flop (didn't bet)
Seat 4: floriiiiider (button) collected ($15)
Seat 5: klenius (small blind) folded before Flop
Seat 6: Chappolini (big blind) folded before Flop


PokerStars Game #102603125976:  Hold'em No Limit ($3/$6 USD) - 2013/08/11 9:00:12 ET
Table 'Lorcia IV 40-100 bb' 6-max Seat #5 is the button
Seat 1: Scarface.VLT ($651.82 in chips) 
Seat 2: patapong ($766.20 in chips) 
Seat 3: VegasMidas ($618.06 in chips) 
Seat 4: floriiiiider ($1140.20 in chips) 
Seat 5: klenius ($1797.32 in chips) 
Seat 6: Chappolini ($903.20 in chips) 
Chappolini: posts small blind $3
Scarface.VLT: posts big blind $6
*** HOLE CARDS ***
patapong: raises $9 to $15
VegasMidas: folds 
floriiiiider: folds 
klenius: folds 
Chappolini: folds 
Scarface.VLT: folds 
Uncalled bet ($9) returned to patapong
patapong collected $15 from pot
*** SUMMARY ***
Total pot $15 | Rake $0 
Seat 1: Scarface.VLT (big blind) folded before Flop
Seat 2: patapong collected ($15)
Seat 3: VegasMidas folded before Flop (didn't bet)
Seat 4: floriiiiider folded before Flop (didn't bet)
Seat 5: klenius (button) folded before Flop (didn't bet)
Seat 6: Chappolini (small blind) folded before Flop


PokerStars Game #102603139843:  Hold'em No Limit ($3/$6 USD) - 2013/08/11 9:00:42 ET
Table 'Lorcia IV 40-100 bb' 6-max Seat #6 is the button
Seat 1: Scarface.VLT ($645.82 in chips) 
Seat 2: patapong ($775.20 in chips) 
Seat 3: VegasMidas ($618.06 in chips) 
Seat 4: floriiiiider ($1140.20 in chips) 
Seat 5: klenius ($1797.32 in chips) 
Seat 6: Chappolini ($900.20 in chips) 
Scarface.VLT: posts small blind $3
patapong: posts big blind $6
*** HOLE CARDS ***
VegasMidas: raises $12 to $18
floriiiiider: folds 
klenius: raises $30 to $48
Chappolini: folds 
Scarface.VLT: folds 
patapong: folds 
VegasMidas: raises $72 to $120
klenius: calls $72
*** FLOP *** [Ts 8c 3s]
VegasMidas: bets $132.94
klenius: folds 
Uncalled bet ($132.94) returned to VegasMidas
VegasMidas collected $246.20 from pot
*** SUMMARY ***
Total pot $249 | Rake $2.80 
Board [Ts 8c 3s]
Seat 1: Scarface.VLT (small blind) folded before Flop
Seat 2: patapong (big blind) folded before Flop
Seat 3: VegasMidas collected ($246.20)
Seat 4: floriiiiider folded before Flop (didn't bet)
Seat 5: klenius folded on the Flop
Seat 6: Chappolini (button) folded before Flop (didn't bet)


PokerStars Game #102603176817:  Hold'em No Limit ($3/$6 USD) - 2013/08/11 9:01:51 ET
Table 'Lorcia IV 40-100 bb' 6-max Seat #1 is the button
Seat 1: Scarface.VLT ($642.82 in chips) 
Seat 2: patapong ($769.20 in chips) 
Seat 3: VegasMidas ($744.26 in chips) 
Seat 4: floriiiiider ($1140.20 in chips) 
Seat 5: klenius ($1677.32 in chips) 
Seat 6: Chappolini ($900.20 in chips) 
patapong: posts small blind $3
VegasMidas: posts big blind $6
*** HOLE CARDS ***
floriiiiider: folds 
klenius: folds 
Chappolini: folds 
Scarface.VLT: raises $6 to $12
patapong: folds 
VegasMidas: raises $36 to $48
Scarface.VLT: calls $36
*** FLOP *** [9c Jc 6h]
VegasMidas: checks 
Scarface.VLT: checks 
*** TURN *** [9c Jc 6h] [4s]
VegasMidas: bets $74.07
Scarface.VLT: folds 
Uncalled bet ($74.07) returned to VegasMidas
VegasMidas collected $96.20 from pot
*** SUMMARY ***
Total pot $99 | Rake $2.80 
Board [9c Jc 6h 4s]
Seat 1: Scarface.VLT (button) folded on the Turn
Seat 2: patapong (small blind) folded before Flop
Seat 3: VegasMidas (big blind) collected ($96.20)
Seat 4: floriiiiider folded before Flop (didn't bet)
Seat 5: klenius folded before Flop (didn't bet)
Seat 6: Chappolini folded before Flop (didn't bet)


PokerStars Game #102603219578:  Hold'em No Limit ($3/$6 USD) - 2013/08/11 9:03:04 ET
Table 'Lorcia IV 40-100 bb' 6-max Seat #2 is the button
Seat 1: Scarface.VLT ($600 in chips) 
Seat 2: patapong ($766.20 in chips) 
Seat 3: VegasMidas ($792.46 in chips) 
Seat 4: floriiiiider ($1140.20 in chips) 
Seat 5: klenius ($1677.32 in chips) 
Seat 6: Chappolini ($900.20 in chips) 
VegasMidas: posts small blind $3
floriiiiider: posts big blind $6
*** HOLE CARDS ***
klenius: raises $6 to $12
Chappolini: raises $30 to $42
Scarface.VLT: folds 
patapong: folds 
VegasMidas: folds 
floriiiiider: folds 
klenius: calls $30
*** FLOP *** [5d Qd Ts]
klenius: checks 
Chappolini: checks 
*** TURN *** [5d Qd Ts] [Jc]
klenius: checks 
Chappolini: bets $70
klenius: calls $70
*** RIVER *** [5d Qd Ts Jc] [Qs]
klenius: checks 
Chappolini: checks 
*** SHOW DOWN ***
klenius: shows [Qh Jd] (a full house, Queens full of Jacks)
Chappolini: mucks hand 
klenius collected $230.20 from pot
*** SUMMARY ***
Total pot $233 | Rake $2.80 
Board [5d Qd Ts Jc Qs]
Seat 1: Scarface.VLT folded before Flop (didn't bet)
Seat 2: patapong (button) folded before Flop (didn't bet)
Seat 3: VegasMidas (small blind) folded before Flop
Seat 4: floriiiiider (big blind) folded before Flop
Seat 5: klenius showed [Qh Jd] and won ($230.20) with a full house, Queens full of Jacks
Seat 6: Chappolini mucked


PokerStars Game #102603261695:  Hold'em No Limit ($3/$6 USD) - 2013/08/11 9:04:17 ET
Table 'Lorcia IV 40-100 bb' 6-max Seat #3 is the button
Seat 1: Scarface.VLT ($600 in chips) 
Seat 2: patapong ($766.20 in chips) 
Seat 3: VegasMidas ($789.46 in chips) 
Seat 4: floriiiiider ($1134.20 in chips) 
Seat 5: klenius ($1795.52 in chips) 
Seat 6: Chappolini ($788.20 in chips) 
floriiiiider: posts small blind $3
klenius: posts big blind $6
*** HOLE CARDS ***
Chappolini: raises $12 to $18
Scarface.VLT: folds 
patapong: folds 
VegasMidas: folds 
floriiiiider: folds 
klenius: calls $12
*** FLOP *** [9s Qd Kd]
klenius: checks 
Chappolini: bets $24
klenius: calls $24
*** TURN *** [9s Qd Kd] [7c]
klenius: checks 
Chappolini: bets $75
klenius: folds 
Uncalled bet ($75) returned to Chappolini
Chappolini collected $84.20 from pot
Chappolini: doesn't show hand 
*** SUMMARY ***
Total pot $87 | Rake $2.80 
Board [9s Qd Kd 7c]
Seat 1: Scarface.VLT folded before Flop (didn't bet)
Seat 2: patapong folded before Flop (didn't bet)
Seat 3: VegasMidas (button) folded before Flop (didn't bet)
Seat 4: floriiiiider (small blind) folded before Flop
Seat 5: klenius (big blind) folded on the Turn
Seat 6: Chappolini collected ($84.20)


PokerStars Game #102604542911:  Hold'em No Limit ($3/$6 USD) - 2013/08/11 9:40:36 ET
Table 'Lorcia IV 40-100 bb' 6-max Seat #3 is the button
Seat 1: Scarface.VLT ($867.12 in chips) 
Seat 2: patapong ($739.78 in chips) 
Seat 3: VegasMidas ($744.42 in chips) 
Seat 4: LueZaS ($613.78 in chips) 
Seat 5: klenius ($1644.19 in chips) 
Seat 6: barrao ($609 in chips) 
LueZaS: posts small blind $3
klenius: posts big blind $6
*** HOLE CARDS ***
barrao: folds 
Scarface.VLT: folds 
patapong: folds 
VegasMidas: raises $6 to $12
LueZaS: folds 
klenius: folds 
Uncalled bet ($6) returned to VegasMidas
VegasMidas collected $15 from pot
*** SUMMARY ***
Total pot $15 | Rake $0 
Seat 1: Scarface.VLT folded before Flop (didn't bet)
Seat 2: patapong folded before Flop (didn't bet)
Seat 3: VegasMidas (button) collected ($15)
Seat 4: LueZaS (small blind) folded before Flop
Seat 5: klenius (big blind) folded before Flop
Seat 6: barrao folded before Flop (didn't bet)


PokerStars Game #102604559967:  Hold'em No Limit ($3/$6 USD) - 2013/08/11 9:41:05 ET
Table 'Lorcia IV 40-100 bb' 6-max Seat #4 is the button
Seat 1: Scarface.VLT ($867.12 in chips) 
Seat 2: patapong ($739.78 in chips) 
Seat 3: VegasMidas ($753.42 in chips) 
Seat 4: LueZaS ($610.78 in chips) 
Seat 5: klenius ($1638.19 in chips) 
Seat 6: barrao ($609 in chips) 
klenius: posts small blind $3
barrao: posts big blind $6
*** HOLE CARDS ***
Scarface.VLT: folds 
patapong: folds 
VegasMidas: folds 
LueZaS: raises $6.48 to $12.48
klenius: raises $41.52 to $54
barrao: folds 
LueZaS: folds 
Uncalled bet ($41.52) returned to klenius
klenius collected $30.96 from pot
*** SUMMARY ***
Total pot $30.96 | Rake $0 
Seat 1: Scarface.VLT folded before Flop (didn't bet)
Seat 2: patapong folded before Flop (didn't bet)
Seat 3: VegasMidas folded before Flop (didn't bet)
Seat 4: LueZaS (button) folded before Flop
Seat 5: klenius (small blind) collected ($30.96)
Seat 6: barrao (big blind) folded before Flop


PokerStars Game #102604572278:  Hold'em No Limit ($3/$6 USD) - 2013/08/11 9:41:25 ET
Table 'Lorcia IV 40-100 bb' 6-max Seat #5 is the button
Seat 1: Scarface.VLT ($867.12 in chips) 
Seat 2: patapong ($739.78 in chips) 
Seat 3: VegasMidas ($753.42 in chips) 
Seat 4: LueZaS ($600 in chips) 
Seat 5: klenius ($1656.67 in chips) 
Seat 6: barrao ($603 in chips) 
barrao: posts small blind $3
Scarface.VLT: posts big blind $6
*** HOLE CARDS ***
patapong: folds 
VegasMidas: folds 
LueZaS: raises $6.48 to $12.48
klenius: calls $12.48
barrao: folds 
Scarface.VLT: folds 
*** FLOP *** [3h 2c 3d]
LueZaS: bets $18
klenius: calls $18
*** TURN *** [3h 2c 3d] [Qc]
LueZaS: bets $40.89
klenius: raises $103.11 to $144
LueZaS: folds 
Uncalled bet ($103.11) returned to klenius
klenius collected $148.94 from pot
*** SUMMARY ***
Total pot $151.74 | Rake $2.80 
Board [3h 2c 3d Qc]
Seat 1: Scarface.VLT (big blind) folded before Flop
Seat 2: patapong folded before Flop (didn't bet)
Seat 3: VegasMidas folded before Flop (didn't bet)
Seat 4: LueZaS folded on the Turn
Seat 5: klenius (button) collected ($148.94)
Seat 6: barrao (small blind) folded before Flop


PokerStars Game #102604613428:  Hold'em No Limit ($3/$6 USD) - 2013/08/11 9:42:34 ET
Table 'Lorcia IV 40-100 bb' 6-max Seat #6 is the button
Seat 1: Scarface.VLT ($861.12 in chips) 
Seat 2: patapong ($739.78 in chips) 
Seat 3: VegasMidas ($753.42 in chips) 
Seat 4: LueZaS ($600 in chips) 
Seat 5: klenius ($1734.24 in chips) 
Seat 6: barrao ($600 in chips) 
Scarface.VLT: posts small blind $3
patapong: posts big blind $6
*** HOLE CARDS ***
VegasMidas: folds 
LueZaS: raises $6.48 to $12.48
klenius: raises $35.52 to $48
barrao: folds 
Scarface.VLT: folds 
patapong: folds 
LueZaS: calls $35.52
*** FLOP *** [4h 8h 5d]
LueZaS: checks 
klenius: bets $84
LueZaS: folds 
Uncalled bet ($84) returned to klenius
klenius collected $102.20 from pot
*** SUMMARY ***
Total pot $105 | Rake $2.80 
Board [4h 8h 5d]
Seat 1: Scarface.VLT (small blind) folded before Flop
Seat 2: patapong (big blind) folded before Flop
Seat 3: VegasMidas folded before Flop (didn't bet)
Seat 4: LueZaS folded on the Flop
Seat 5: klenius collected ($102.20)
Seat 6: barrao (button) folded before Flop (didn't bet)


PokerStars Game #102604634580:  Hold'em No Limit ($3/$6 USD) - 2013/08/11 9:43:09 ET
Table 'Lorcia IV 40-100 bb' 6-max Seat #1 is the button
Seat 1: Scarface.VLT ($858.12 in chips) 
Seat 2: patapong ($733.78 in chips) 
Seat 3: VegasMidas ($753.42 in chips) 
Seat 4: LueZaS ($600 in chips) 
Seat 5: klenius ($1788.44 in chips) 
Seat 6: barrao ($600 in chips) 
patapong: posts small blind $3
VegasMidas: posts big blind $6
*** HOLE CARDS ***
LueZaS: folds 
klenius: folds 
LueZaS leaves the table
barrao: folds 
floriiiiider joins the table at seat #4 
Scarface.VLT: raises $6 to $12
patapong: folds 
floriiiiider leaves the table
vivecrew joins the table at seat #4 
VegasMidas: folds 
Uncalled bet ($6) returned to Scarface.VLT
Scarface.VLT collected $15 from pot
Scarface.VLT: doesn't show hand 
*** SUMMARY ***
Total pot $15 | Rake $0 
Seat 1: Scarface.VLT (button) collected ($15)
Seat 2: patapong (small blind) folded before Flop
Seat 3: VegasMidas (big blind) folded before Flop
Seat 4: LueZaS folded before Flop (didn't bet)
Seat 5: klenius folded before Flop (didn't bet)
Seat 6: barrao folded before Flop (didn't bet)


PokerStars Game #102604655195:  Hold'em No Limit ($3/$6 USD) - 2013/08/11 9:43:44 ET
Table 'Lorcia IV 40-100 bb' 6-max Seat #2 is the button
Seat 1: Scarface.VLT ($867.12 in chips) 
Seat 2: patapong ($730.78 in chips) 
Seat 3: VegasMidas ($747.42 in chips) 
Seat 4: vivecrew ($480 in chips) 
Seat 5: klenius ($1788.44 in chips) 
Seat 6: barrao ($600 in chips) 
VegasMidas: posts small blind $3
vivecrew: posts big blind $6
*** HOLE CARDS ***
klenius: folds 
barrao: raises $6 to $12
Scarface.VLT: folds 
patapong: folds 
VegasMidas: folds 
vivecrew: folds 
Uncalled bet ($6) returned to barrao
barrao collected $15 from pot
barrao: doesn't show hand 
*** SUMMARY ***
Total pot $15 | Rake $0 
Seat 1: Scarface.VLT folded before Flop (didn't bet)
Seat 2: patapong (button) folded before Flop (didn't bet)
Seat 3: VegasMidas (small blind) folded before Flop
Seat 4: vivecrew (big blind) folded before Flop
Seat 5: klenius folded before Flop (didn't bet)
Seat 6: barrao collected ($15)


PokerStars Game #102604691289:  Hold'em No Limit ($3/$6 USD) - 2013/08/11 9:44:45 ET
Table 'Lorcia IV 40-100 bb' 6-max Seat #3 is the button
Seat 1: Scarface.VLT ($867.12 in chips) 
Seat 2: patapong ($730.78 in chips) 
Seat 3: VegasMidas ($744.42 in chips) 
Seat 5: klenius ($1788.44 in chips) 
Seat 6: barrao ($609 in chips) 
klenius: posts small blind $3
barrao: posts big blind $6
*** HOLE CARDS ***
Scarface.VLT: raises $12 to $18
patapong: folds 
VegasMidas: folds 
klenius: folds 
barrao: calls $12
*** FLOP *** [5d Td 4d]
barrao: checks 
Scarface.VLT: bets $15.87
barrao: calls $15.87
*** TURN *** [5d Td 4d] [6s]
barrao: checks 
Scarface.VLT: checks 
*** RIVER *** [5d Td 4d 6s] [Qs]
barrao: bets $54
Scarface.VLT: folds 
Uncalled bet ($54) returned to barrao
barrao collected $67.94 from pot
barrao: doesn't show hand 
*** SUMMARY ***
Total pot $70.74 | Rake $2.80 
Board [5d Td 4d 6s Qs]
Seat 1: Scarface.VLT folded on the River
Seat 2: patapong folded before Flop (didn't bet)
Seat 3: VegasMidas (button) folded before Flop (didn't bet)
Seat 5: klenius (small blind) folded before Flop
Seat 6: barrao (big blind) collected ($67.94)


PokerStars Game #102604372630:  Hold'em No Limit ($3/$6 USD) - 2013/08/11 9:35:50 ET
Table 'Lorcia IV 40-100 bb' 6-max Seat #6 is the button
Seat 1: Scarface.VLT ($888.12 in chips) 
Seat 2: patapong ($808.78 in chips) 
Seat 3: VegasMidas ($729.42 in chips) 
Seat 4: LueZaS ($600 in chips) 
Seat 5: klenius ($1629.19 in chips) 
Seat 6: barrao ($222 in chips) 
Scarface.VLT: posts small blind $3
patapong: posts big blind $6
*** HOLE CARDS ***
VegasMidas: folds 
LueZaS: folds 
klenius: folds 
Scarface.VLT said, "^^"
barrao: folds 
Scarface.VLT said, "todos monos"
Scarface.VLT: folds 
Uncalled bet ($3) returned to patapong
patapong collected $6 from pot
*** SUMMARY ***
Total pot $6 | Rake $0 
Seat 1: Scarface.VLT (small blind) folded before Flop
Seat 2: patapong (big blind) collected ($6)
Seat 3: VegasMidas folded before Flop (didn't bet)
Seat 4: LueZaS folded before Flop (didn't bet)
Seat 5: klenius folded before Flop (didn't bet)
Seat 6: barrao (button) folded before Flop (didn't bet)


PokerStars Game #102604381304:  Hold'em No Limit ($3/$6 USD) - 2013/08/11 9:36:04 ET
Table 'Lorcia IV 40-100 bb' 6-max Seat #1 is the button
Seat 1: Scarface.VLT ($885.12 in chips) 
Seat 2: patapong ($811.78 in chips) 
Seat 3: VegasMidas ($729.42 in chips) 
Seat 4: LueZaS ($600 in chips) 
Seat 5: klenius ($1629.19 in chips) 
Seat 6: barrao ($222 in chips) 
patapong: posts small blind $3
VegasMidas: posts big blind $6
*** HOLE CARDS ***
LueZaS: folds 
klenius: folds 
barrao: folds 
LueZaS said, "do you like de potuguese *******es?"
Scarface.VLT: folds 
patapong: folds 
Uncalled bet ($3) returned to VegasMidas
VegasMidas collected $6 from pot
*** SUMMARY ***
Total pot $6 | Rake $0 
Seat 1: Scarface.VLT (button) folded before Flop (didn't bet)
Seat 2: patapong (small blind) folded before Flop
Seat 3: VegasMidas (big blind) collected ($6)
Seat 4: LueZaS folded before Flop (didn't bet)
Seat 5: klenius folded before Flop (didn't bet)
Seat 6: barrao folded before Flop (didn't bet)


PokerStars Game #102604398832:  Hold'em No Limit ($3/$6 USD) - 2013/08/11 9:36:33 ET
Table 'Lorcia IV 40-100 bb' 6-max Seat #2 is the button
Seat 1: Scarface.VLT ($885.12 in chips) 
Seat 2: patapong ($808.78 in chips) 
Seat 3: VegasMidas ($732.42 in chips) 
Seat 4: LueZaS ($600 in chips) 
Seat 5: klenius ($1629.19 in chips) 
Seat 6: barrao ($222 in chips) 
VegasMidas: posts small blind $3
LueZaS: posts big blind $6
*** HOLE CARDS ***
klenius: raises $6 to $12
barrao: folds 
Scarface.VLT: folds 
patapong: folds 
Scarface.VLT said, "no se"
VegasMidas: folds 
LueZaS said, "all ****ing spaniards 40 bbs MA-ri.coon"
LueZaS: folds 
Uncalled bet ($6) returned to klenius
klenius collected $15 from pot
*** SUMMARY ***
Total pot $15 | Rake $0 
Seat 1: Scarface.VLT folded before Flop (didn't bet)
Seat 2: patapong (button) folded before Flop (didn't bet)
Seat 3: VegasMidas (small blind) folded before Flop
Seat 4: LueZaS (big blind) folded before Flop
Seat 5: klenius collected ($15)
Seat 6: barrao folded before Flop (didn't bet)


PokerStars Game #102604415232:  Hold'em No Limit ($3/$6 USD) - 2013/08/11 9:37:01 ET
Table 'Lorcia IV 40-100 bb' 6-max Seat #3 is the button
Seat 1: Scarface.VLT ($885.12 in chips) 
Seat 2: patapong ($808.78 in chips) 
Seat 3: VegasMidas ($729.42 in chips) 
Seat 4: LueZaS ($600 in chips) 
Seat 5: klenius ($1638.19 in chips) 
Seat 6: barrao ($222 in chips) 
LueZaS: posts small blind $3
klenius: posts big blind $6
*** HOLE CARDS ***
barrao: folds 
Scarface.VLT: folds 
patapong: raises $9 to $15
LueZaS said, "none of them are from portugal"
VegasMidas: raises $27 to $42
Scarface.VLT said, "bueno"
LueZaS: folds 
Scarface.VLT said, "tengo q concentrarme"
klenius: folds 
Scarface.VLT said, "te mando muchos besos"
patapong: folds 
Uncalled bet ($27) returned to VegasMidas
Scarface.VLT said, "suerteeeee"
Scarface.VLT said, ":*"
VegasMidas collected $39 from pot
*** SUMMARY ***
Total pot $39 | Rake $0 
Seat 1: Scarface.VLT folded before Flop (didn't bet)
Seat 2: patapong folded before Flop
Seat 3: VegasMidas (button) collected ($39)
Seat 4: LueZaS (small blind) folded before Flop
Seat 5: klenius (big blind) folded before Flop
Seat 6: barrao folded before Flop (didn't bet)


PokerStars Game #102604437452:  Hold'em No Limit ($3/$6 USD) - 2013/08/11 9:37:38 ET
Table 'Lorcia IV 40-100 bb' 6-max Seat #4 is the button
Seat 1: Scarface.VLT ($885.12 in chips) 
Seat 2: patapong ($793.78 in chips) 
Seat 3: VegasMidas ($753.42 in chips) 
Seat 4: LueZaS ($600 in chips) 
Seat 5: klenius ($1632.19 in chips) 
Seat 6: barrao ($222 in chips) 
klenius: posts small blind $3
barrao: posts big blind $6
*** HOLE CARDS ***
Scarface.VLT: folds 
patapong: folds 
VegasMidas: folds 
LueZaS said, "ok yo tambien"
LueZaS: folds 
klenius: raises $6 to $12
LueZaS said, ":*:*"
barrao: raises $18 to $30
klenius: calls $18
*** FLOP *** [4s 5s 5d]
klenius: checks 
barrao: bets $33
klenius: folds 
Uncalled bet ($33) returned to barrao
patapong said, "que lindo!"
barrao collected $57.30 from pot
barrao: doesn't show hand 
*** SUMMARY ***
Total pot $60 | Rake $2.70 
Board [4s 5s 5d]
Seat 1: Scarface.VLT folded before Flop (didn't bet)
Seat 2: patapong folded before Flop (didn't bet)
Seat 3: VegasMidas folded before Flop (didn't bet)
Seat 4: LueZaS (button) folded before Flop (didn't bet)
Seat 5: klenius (small blind) folded on the Flop
Seat 6: barrao (big blind) collected ($57.30)


PokerStars Game #102604465922:  Hold'em No Limit ($3/$6 USD) - 2013/08/11 9:38:26 ET
Table 'Lorcia IV 40-100 bb' 6-max Seat #5 is the button
Seat 1: Scarface.VLT ($885.12 in chips) 
Seat 2: patapong ($793.78 in chips) 
Seat 3: VegasMidas ($753.42 in chips) 
Seat 4: LueZaS ($600 in chips) 
Seat 5: klenius ($1602.19 in chips) 
Seat 6: barrao ($249.30 in chips) 
barrao: posts small blind $3
Scarface.VLT: posts big blind $6
*** HOLE CARDS ***
patapong: folds 
LueZaS said, "tu si que ere lindo"
LueZaS said, "hahaha"
VegasMidas: folds 
LueZaS: folds 
klenius: folds 
barrao: raises $9 to $15
Scarface.VLT: calls $9
*** FLOP *** [9h Ah 4h]
barrao: bets $18
Scarface.VLT: folds 
Uncalled bet ($18) returned to barrao
barrao collected $28.65 from pot
barrao: doesn't show hand 
*** SUMMARY ***
Total pot $30 | Rake $1.35 
Board [9h Ah 4h]
Seat 1: Scarface.VLT (big blind) folded on the Flop
Seat 2: patapong folded before Flop (didn't bet)
Seat 3: VegasMidas folded before Flop (didn't bet)
Seat 4: LueZaS folded before Flop (didn't bet)
Seat 5: klenius (button) folded before Flop (didn't bet)
Seat 6: barrao (small blind) collected ($28.65)


PokerStars Game #102604485644:  Hold'em No Limit ($3/$6 USD) - 2013/08/11 9:38:59 ET
Table 'Lorcia IV 40-100 bb' 6-max Seat #6 is the button
Seat 1: Scarface.VLT ($870.12 in chips) 
Seat 2: patapong ($793.78 in chips) 
Seat 3: VegasMidas ($753.42 in chips) 
Seat 4: LueZaS ($600 in chips) 
Seat 5: klenius ($1602.19 in chips) 
Seat 6: barrao ($600 in chips) 
Scarface.VLT: posts small blind $3
patapong: posts big blind $6
*** HOLE CARDS ***
patapong said, "jeje"
VegasMidas: folds 
LueZaS: folds 
klenius: raises $6 to $12
barrao: folds 
Scarface.VLT: folds 
patapong: raises $27 to $39
klenius: raises $93 to $132
patapong: folds 
Uncalled bet ($93) returned to klenius
klenius collected $81 from pot
*** SUMMARY ***
Total pot $81 | Rake $0 
Seat 1: Scarface.VLT (small blind) folded before Flop
Seat 2: patapong (big blind) folded before Flop
Seat 3: VegasMidas folded before Flop (didn't bet)
Seat 4: LueZaS folded before Flop (didn't bet)
Seat 5: klenius collected ($81)
Seat 6: barrao (button) folded before Flop (didn't bet)


PokerStars Game #102604505217:  Hold'em No Limit ($3/$6 USD) - 2013/08/11 9:39:32 ET
Table 'Lorcia IV 40-100 bb' 6-max Seat #1 is the button
Seat 1: Scarface.VLT ($867.12 in chips) 
Seat 2: patapong ($754.78 in chips) 
Seat 3: VegasMidas ($753.42 in chips) 
Seat 4: LueZaS ($600 in chips) 
Seat 5: klenius ($1644.19 in chips) 
Seat 6: barrao ($600 in chips) 
patapong: posts small blind $3
VegasMidas: posts big blind $6
*** HOLE CARDS ***
LueZaS: folds 
klenius: folds 
barrao: raises $6 to $12
Scarface.VLT: folds 
patapong: folds 
VegasMidas: folds 
Uncalled bet ($6) returned to barrao
barrao collected $15 from pot
barrao: doesn't show hand 
*** SUMMARY ***
Total pot $15 | Rake $0 
Seat 1: Scarface.VLT (button) folded before Flop (didn't bet)
Seat 2: patapong (small blind) folded before Flop
Seat 3: VegasMidas (big blind) folded before Flop
Seat 4: LueZaS folded before Flop (didn't bet)
Seat 5: klenius folded before Flop (didn't bet)
Seat 6: barrao collected ($15)


PokerStars Game #102604517510:  Hold'em No Limit ($3/$6 USD) - 2013/08/11 9:39:53 ET
Table 'Lorcia IV 40-100 bb' 6-max Seat #2 is the button
Seat 1: Scarface.VLT ($867.12 in chips) 
Seat 2: patapong ($751.78 in chips) 
Seat 3: VegasMidas ($747.42 in chips) 
Seat 4: LueZaS ($600 in chips) 
Seat 5: klenius ($1644.19 in chips) 
Seat 6: barrao ($609 in chips) 
VegasMidas: posts small blind $3
LueZaS: posts big blind $6
*** HOLE CARDS ***
klenius: folds 
barrao: folds 
Scarface.VLT: folds 
patapong: raises $6 to $12
VegasMidas: folds 
LueZaS: calls $6
*** FLOP *** [7c Ad 4h]
LueZaS: checks 
patapong: checks 
*** TURN *** [7c Ad 4h] [7s]
LueZaS: checks 
patapong: checks 
*** RIVER *** [7c Ad 4h 7s] [Ts]
LueZaS: checks 
patapong: checks 
*** SHOW DOWN ***
LueZaS: shows [Ac 4d] (two pair, Aces and Sevens)
patapong: mucks hand 
LueZaS collected $25.78 from pot
*** SUMMARY ***
Total pot $27 | Rake $1.22 
Board [7c Ad 4h 7s Ts]
Seat 1: Scarface.VLT folded before Flop (didn't bet)
Seat 2: patapong (button) mucked
Seat 3: VegasMidas (small blind) folded before Flop
Seat 4: LueZaS (big blind) showed [Ac 4d] and won ($25.78) with two pair, Aces and Sevens
Seat 5: klenius folded before Flop (didn't bet)
Seat 6: barrao folded before Flop (didn't bet)


PokerStars Game #102604192012:  Hold'em No Limit ($3/$6 USD) - 2013/08/11 9:30:45 ET
Table 'Lorcia IV 40-100 bb' 6-max Seat #5 is the button
Seat 1: Scarface.VLT ($871.20 in chips) 
Seat 2: patapong ($817.78 in chips) 
Seat 3: VegasMidas ($738.42 in chips) 
Seat 4: LueZaS ($694.37 in chips) 
Seat 5: klenius ($1214.79 in chips) 
Scarface.VLT: posts small blind $3
patapong: posts big blind $6
*** HOLE CARDS ***
VegasMidas: folds 
LueZaS: folds 
klenius: folds 
Scarface.VLT: raises $12 to $18
patapong: folds 
Uncalled bet ($12) returned to Scarface.VLT
Scarface.VLT collected $12 from pot
Scarface.VLT: doesn't show hand 
*** SUMMARY ***
Total pot $12 | Rake $0 
Seat 1: Scarface.VLT (small blind) collected ($12)
Seat 2: patapong (big blind) folded before Flop
Seat 3: VegasMidas folded before Flop (didn't bet)
Seat 4: LueZaS folded before Flop (didn't bet)
Seat 5: klenius (button) folded before Flop (didn't bet)


PokerStars Game #102604208008:  Hold'em No Limit ($3/$6 USD) - 2013/08/11 9:31:12 ET
Table 'Lorcia IV 40-100 bb' 6-max Seat #1 is the button
Seat 1: Scarface.VLT ($877.20 in chips) 
Seat 2: patapong ($811.78 in chips) 
Seat 3: VegasMidas ($738.42 in chips) 
Seat 4: LueZaS ($694.37 in chips) 
Seat 5: klenius ($1214.79 in chips) 
patapong: posts small blind $3
VegasMidas: posts big blind $6
*** HOLE CARDS ***
LueZaS: raises $9 to $15
klenius: raises $39 to $54
Scarface.VLT: folds 
patapong: folds 
VegasMidas: folds 
LueZaS: calls $39
*** FLOP *** [Kh Jc 4c]
LueZaS: checks 
barrao joins the table at seat #6 
Scarface.VLT said, "adria teached u that :D ?"
klenius: bets $84
Scarface.VLT said, "never fold"
LueZaS said, "hahaah"
LueZaS: calls $84
*** TURN *** [Kh Jc 4c] [Ah]
LueZaS: checks 
Scarface.VLT said, "adria te enseno ese?"
Scarface.VLT said, "jajaa"
klenius: bets $204
LueZaS: calls $204
*** RIVER *** [Kh Jc 4c Ah] [Qc]
LueZaS: checks 
klenius: checks 
*** SHOW DOWN ***
LueZaS: shows [Js As] (two pair, Aces and Jacks)
klenius: shows [Jd Jh] (three of a kind, Jacks)
klenius collected $690.20 from pot
*** SUMMARY ***
Total pot $693 | Rake $2.80 
Board [Kh Jc 4c Ah Qc]
Seat 1: Scarface.VLT (button) folded before Flop (didn't bet)
Seat 2: patapong (small blind) folded before Flop
Seat 3: VegasMidas (big blind) folded before Flop
Seat 4: LueZaS showed [Js As] and lost with two pair, Aces and Jacks
Seat 5: klenius showed [Jd Jh] and won ($690.20) with three of a kind, Jacks


PokerStars Game #102604256870:  Hold'em No Limit ($3/$6 USD) - 2013/08/11 9:32:35 ET
Table 'Lorcia IV 40-100 bb' 6-max Seat #2 is the button
Seat 1: Scarface.VLT ($877.20 in chips) 
Seat 2: patapong ($808.78 in chips) 
Seat 3: VegasMidas ($732.42 in chips) 
Seat 4: LueZaS ($600 in chips) 
Seat 5: klenius ($1562.99 in chips) 
VegasMidas: posts small blind $3
LueZaS: posts big blind $6
barrao: sits out 
*** HOLE CARDS ***
klenius: folds 
Scarface.VLT said, "no voy a tirar mi mano , me las follas a todas!"
LueZaS said, "hahahaha"
Scarface.VLT: raises $6 to $12
patapong: folds 
Scarface.VLT said, "como asi tienes q pensar no"
VegasMidas: folds 
Scarface.VLT said, "good coach adri :)"
LueZaS: folds 
Uncalled bet ($6) returned to Scarface.VLT
Scarface.VLT collected $15 from pot
Scarface.VLT: doesn't show hand 
*** SUMMARY ***
Total pot $15 | Rake $0 
Seat 1: Scarface.VLT collected ($15)
Seat 2: patapong (button) folded before Flop (didn't bet)
Seat 3: VegasMidas (small blind) folded before Flop
Seat 4: LueZaS (big blind) folded before Flop
Seat 5: klenius folded before Flop (didn't bet)


PokerStars Game #102604280371:  Hold'em No Limit ($3/$6 USD) - 2013/08/11 9:33:15 ET
Table 'Lorcia IV 40-100 bb' 6-max Seat #3 is the button
Seat 1: Scarface.VLT ($886.20 in chips) 
Seat 2: patapong ($808.78 in chips) 
Seat 3: VegasMidas ($729.42 in chips) 
Seat 4: LueZaS ($600 in chips) 
Seat 5: klenius ($1562.99 in chips) 
LueZaS: posts small blind $3
klenius: posts big blind $6
barrao: sits out 
*** HOLE CARDS ***
Scarface.VLT: raises $12 to $18
patapong: folds 
LueZaS said, "adria es asi"
VegasMidas: folds 
LueZaS: calls $15
klenius: raises $36 to $54
Scarface.VLT: folds 
Scarface.VLT said, "yo se"
LueZaS: calls $36
*** FLOP *** [Tc 8h 3h]
LueZaS: checks 
klenius: bets $96
LueZaS: folds 
Uncalled bet ($96) returned to klenius
klenius collected $123.20 from pot
*** SUMMARY ***
Total pot $126 | Rake $2.80 
Board [Tc 8h 3h]
Seat 1: Scarface.VLT folded before Flop
Seat 2: patapong folded before Flop (didn't bet)
Seat 3: VegasMidas (button) folded before Flop (didn't bet)
Seat 4: LueZaS (small blind) folded on the Flop
Seat 5: klenius (big blind) collected ($123.20)


PokerStars Game #102604321755:  Hold'em No Limit ($3/$6 USD) - 2013/08/11 9:34:25 ET
Table 'Lorcia IV 40-100 bb' 6-max Seat #4 is the button
Seat 1: Scarface.VLT ($868.20 in chips) 
Seat 2: patapong ($808.78 in chips) 
Seat 3: VegasMidas ($729.42 in chips) 
Seat 4: LueZaS ($600 in chips) 
Seat 5: klenius ($1632.19 in chips) 
Seat 6: barrao ($240 in chips) 
klenius: posts small blind $3
barrao: posts big blind $6
*** HOLE CARDS ***
Scarface.VLT said, "extrano el monito espanol"
Scarface.VLT: raises $12 to $18
patapong: folds 
VegasMidas: folds 
LueZaS said, "hahaha"
LueZaS: folds 
klenius: folds 
barrao: folds 
Uncalled bet ($12) returned to Scarface.VLT
Scarface.VLT collected $15 from pot
Scarface.VLT: doesn't show hand 
*** SUMMARY ***
Total pot $15 | Rake $0 
Seat 1: Scarface.VLT collected ($15)
Seat 2: patapong folded before Flop (didn't bet)
Seat 3: VegasMidas folded before Flop (didn't bet)
Seat 4: LueZaS (button) folded before Flop (didn't bet)
Seat 5: klenius (small blind) folded before Flop
Seat 6: barrao (big blind) folded before Flop


PokerStars Game #102604334655:  Hold'em No Limit ($3/$6 USD) - 2013/08/11 9:34:46 ET
Table 'Lorcia IV 40-100 bb' 6-max Seat #5 is the button
Seat 1: Scarface.VLT ($877.20 in chips) 
Seat 2: patapong ($808.78 in chips) 
Seat 3: VegasMidas ($729.42 in chips) 
Seat 4: LueZaS ($600 in chips) 
Seat 5: klenius ($1629.19 in chips) 
Seat 6: barrao ($234 in chips) 
barrao: posts small blind $3
Scarface.VLT: posts big blind $6
*** HOLE CARDS ***
patapong: folds 
VegasMidas: folds 
LueZaS: folds 
klenius: folds 
barrao: raises $6 to $12
Scarface.VLT: calls $6
*** FLOP *** [8c 3c 2h]
LueZaS said, "a ver si pelamos al monito de mi izq"
barrao: checks 
Scarface.VLT: bets $16.04
barrao: folds 
Uncalled bet ($16.04) returned to Scarface.VLT
Scarface.VLT collected $22.92 from pot
Scarface.VLT: doesn't show hand 
*** SUMMARY ***
Total pot $24 | Rake $1.08 
Board [8c 3c 2h]
Seat 1: Scarface.VLT (big blind) collected ($22.92)
Seat 2: patapong folded before Flop (didn't bet)
Seat 3: VegasMidas folded before Flop (didn't bet)
Seat 4: LueZaS folded before Flop (didn't bet)
Seat 5: klenius (button) folded before Flop (didn't bet)
Seat 6: barrao (small blind) folded on the Flop


PokerStars Game #102604002163:  Hold'em No Limit ($3/$6 USD) - 2013/08/11 9:25:23 ET
Table 'Lorcia IV 40-100 bb' 6-max Seat #2 is the button
Seat 1: Scarface.VLT ($965.37 in chips) 
Seat 2: patapong ($847.99 in chips) 
Seat 3: VegasMidas ($741.42 in chips) 
Seat 4: LueZaS ($600 in chips) 
Seat 5: klenius ($1132.70 in chips) 
Seat 6: Sir_Fuj1 ($461.60 in chips) 
VegasMidas: posts small blind $3
LueZaS: posts big blind $6
*** HOLE CARDS ***
klenius: folds 
Sir_Fuj1: raises $12 to $18
Scarface.VLT: folds 
patapong: folds 
VegasMidas: folds 
LueZaS: folds 
Uncalled bet ($12) returned to Sir_Fuj1
Sir_Fuj1 collected $15 from pot
Sir_Fuj1: doesn't show hand 
*** SUMMARY ***
Total pot $15 | Rake $0 
Seat 1: Scarface.VLT folded before Flop (didn't bet)
Seat 2: patapong (button) folded before Flop (didn't bet)
Seat 3: VegasMidas (small blind) folded before Flop
Seat 4: LueZaS (big blind) folded before Flop
Seat 5: klenius folded before Flop (didn't bet)
Seat 6: Sir_Fuj1 collected ($15)


PokerStars Game #102604018031:  Hold'em No Limit ($3/$6 USD) - 2013/08/11 9:25:50 ET
Table 'Lorcia IV 40-100 bb' 6-max Seat #3 is the button
Seat 1: Scarface.VLT ($965.37 in chips) 
Seat 2: patapong ($847.99 in chips) 
Seat 3: VegasMidas ($738.42 in chips) 
Seat 4: LueZaS ($600 in chips) 
Seat 5: klenius ($1132.70 in chips) 
Seat 6: Sir_Fuj1 ($470.60 in chips) 
LueZaS: posts small blind $3
klenius: posts big blind $6
*** HOLE CARDS ***
Sir_Fuj1: folds 
Scarface.VLT: folds 
patapong: folds 
VegasMidas: raises $6 to $12
LueZaS: folds 
klenius: folds 
Uncalled bet ($6) returned to VegasMidas
VegasMidas collected $15 from pot
*** SUMMARY ***
Total pot $15 | Rake $0 
Seat 1: Scarface.VLT folded before Flop (didn't bet)
Seat 2: patapong folded before Flop (didn't bet)
Seat 3: VegasMidas (button) collected ($15)
Seat 4: LueZaS (small blind) folded before Flop
Seat 5: klenius (big blind) folded before Flop
Seat 6: Sir_Fuj1 folded before Flop (didn't bet)


PokerStars Game #102604038931:  Hold'em No Limit ($3/$6 USD) - 2013/08/11 9:26:25 ET
Table 'Lorcia IV 40-100 bb' 6-max Seat #4 is the button
Seat 1: Scarface.VLT ($965.37 in chips) 
Seat 2: patapong ($847.99 in chips) 
Seat 3: VegasMidas ($747.42 in chips) 
Seat 4: LueZaS ($600 in chips) 
Seat 5: klenius ($1126.70 in chips) 
Seat 6: Sir_Fuj1 ($470.60 in chips) 
klenius: posts small blind $3
Sir_Fuj1: posts big blind $6
*** HOLE CARDS ***
Scarface.VLT: folds 
patapong: raises $9 to $15
VegasMidas: folds 
LueZaS: folds 
klenius: folds 
Sir_Fuj1: folds 
Uncalled bet ($9) returned to patapong
patapong collected $15 from pot
*** SUMMARY ***
Total pot $15 | Rake $0 
Seat 1: Scarface.VLT folded before Flop (didn't bet)
Seat 2: patapong collected ($15)
Seat 3: VegasMidas folded before Flop (didn't bet)
Seat 4: LueZaS (button) folded before Flop (didn't bet)
Seat 5: klenius (small blind) folded before Flop
Seat 6: Sir_Fuj1 (big blind) folded before Flop


PokerStars Game #102604050685:  Hold'em No Limit ($3/$6 USD) - 2013/08/11 9:26:45 ET
Table 'Lorcia IV 40-100 bb' 6-max Seat #5 is the button
Seat 1: Scarface.VLT ($965.37 in chips) 
Seat 2: patapong ($856.99 in chips) 
Seat 3: VegasMidas ($747.42 in chips) 
Seat 4: LueZaS ($600 in chips) 
Seat 5: klenius ($1123.70 in chips) 
Seat 6: Sir_Fuj1 ($464.60 in chips) 
Sir_Fuj1: posts small blind $3
Scarface.VLT: posts big blind $6
*** HOLE CARDS ***
patapong: raises $9 to $15
VegasMidas: folds 
LueZaS: folds 
klenius: calls $15
Sir_Fuj1: folds 
Scarface.VLT: folds 
*** FLOP *** [6s 9d 5h]
patapong: checks 
klenius: checks 
*** TURN *** [6s 9d 5h] [8c]
patapong: bets $24.21
klenius: raises $47.79 to $72
patapong: folds 
Uncalled bet ($47.79) returned to klenius
klenius collected $84.62 from pot
*** SUMMARY ***
Total pot $87.42 | Rake $2.80 
Board [6s 9d 5h 8c]
Seat 1: Scarface.VLT (big blind) folded before Flop
Seat 2: patapong folded on the Turn
Seat 3: VegasMidas folded before Flop (didn't bet)
Seat 4: LueZaS folded before Flop (didn't bet)
Seat 5: klenius (button) collected ($84.62)
Seat 6: Sir_Fuj1 (small blind) folded before Flop


PokerStars Game #102604081401:  Hold'em No Limit ($3/$6 USD) - 2013/08/11 9:27:37 ET
Table 'Lorcia IV 40-100 bb' 6-max Seat #6 is the button
Seat 1: Scarface.VLT ($959.37 in chips) 
Seat 2: patapong ($817.78 in chips) 
Seat 3: VegasMidas ($747.42 in chips) 
Seat 4: LueZaS ($600 in chips) 
Seat 5: klenius ($1169.11 in chips) 
Seat 6: Sir_Fuj1 ($461.60 in chips) 
Scarface.VLT: posts small blind $3
patapong: posts big blind $6
*** HOLE CARDS ***
VegasMidas: folds 
LueZaS: folds 
klenius: folds 
Sir_Fuj1: folds 
Scarface.VLT: folds 
Uncalled bet ($3) returned to patapong
patapong collected $6 from pot
*** SUMMARY ***
Total pot $6 | Rake $0 
Seat 1: Scarface.VLT (small blind) folded before Flop
Seat 2: patapong (big blind) collected ($6)
Seat 3: VegasMidas folded before Flop (didn't bet)
Seat 4: LueZaS folded before Flop (didn't bet)
Seat 5: klenius folded before Flop (didn't bet)
Seat 6: Sir_Fuj1 (button) folded before Flop (didn't bet)


PokerStars Game #102604089084:  Hold'em No Limit ($3/$6 USD) - 2013/08/11 9:27:51 ET
Table 'Lorcia IV 40-100 bb' 6-max Seat #1 is the button
Seat 1: Scarface.VLT ($956.37 in chips) 
Seat 2: patapong ($820.78 in chips) 
Seat 3: VegasMidas ($747.42 in chips) 
Seat 4: LueZaS ($600 in chips) 
Seat 5: klenius ($1169.11 in chips) 
Seat 6: Sir_Fuj1 ($461.60 in chips) 
patapong: posts small blind $3
VegasMidas: posts big blind $6
*** HOLE CARDS ***
LueZaS: folds 
klenius: raises $6 to $12
Sir_Fuj1: raises $18 to $30
Scarface.VLT: folds 
patapong: folds 
VegasMidas: folds 
klenius: calls $18
*** FLOP *** [9s Tc 7s]
klenius: checks 
Sir_Fuj1: checks 
*** TURN *** [9s Tc 7s] [2c]
klenius: bets $42
Sir_Fuj1: folds 
Uncalled bet ($42) returned to klenius
klenius collected $66.20 from pot
*** SUMMARY ***
Total pot $69 | Rake $2.80 
Board [9s Tc 7s 2c]
Seat 1: Scarface.VLT (button) folded before Flop (didn't bet)
Seat 2: patapong (small blind) folded before Flop
Seat 3: VegasMidas (big blind) folded before Flop
Seat 4: LueZaS folded before Flop (didn't bet)
Seat 5: klenius collected ($66.20)
Seat 6: Sir_Fuj1 folded on the Turn


PokerStars Game #102604129995:  Hold'em No Limit ($3/$6 USD) - 2013/08/11 9:29:00 ET
Table 'Lorcia IV 40-100 bb' 6-max Seat #2 is the button
Seat 1: Scarface.VLT ($956.37 in chips) 
Seat 2: patapong ($817.78 in chips) 
Seat 3: VegasMidas ($741.42 in chips) 
Seat 4: LueZaS ($600 in chips) 
Seat 5: klenius ($1205.31 in chips) 
Seat 6: Sir_Fuj1 ($431.60 in chips) 
VegasMidas: posts small blind $3
LueZaS: posts big blind $6
*** HOLE CARDS ***
klenius: folds 
Sir_Fuj1: folds 
Scarface.VLT: raises $6 to $12
patapong: folds 
VegasMidas: folds 
LueZaS: folds 
Uncalled bet ($6) returned to Scarface.VLT
Scarface.VLT collected $15 from pot
Scarface.VLT: doesn't show hand 
*** SUMMARY ***
Total pot $15 | Rake $0 
Seat 1: Scarface.VLT collected ($15)
Seat 2: patapong (button) folded before Flop (didn't bet)
Seat 3: VegasMidas (small blind) folded before Flop
Seat 4: LueZaS (big blind) folded before Flop
Seat 5: klenius folded before Flop (didn't bet)
Seat 6: Sir_Fuj1 folded before Flop (didn't bet)


PokerStars Game #102604141739:  Hold'em No Limit ($3/$6 USD) - 2013/08/11 9:29:20 ET
Table 'Lorcia IV 40-100 bb' 6-max Seat #3 is the button
Seat 1: Scarface.VLT ($965.37 in chips) 
Seat 2: patapong ($817.78 in chips) 
Seat 3: VegasMidas ($738.42 in chips) 
Seat 4: LueZaS ($600 in chips) 
Seat 5: klenius ($1205.31 in chips) 
Seat 6: Sir_Fuj1 ($431.60 in chips) 
LueZaS: posts small blind $3
klenius: posts big blind $6
*** HOLE CARDS ***
Sir_Fuj1: folds 
Scarface.VLT: folds 
patapong: folds 
VegasMidas: folds 
LueZaS: raises $6.48 to $12.48
klenius: raises $35.52 to $48
LueZaS: folds 
Uncalled bet ($35.52) returned to klenius
klenius collected $24.96 from pot
*** SUMMARY ***
Total pot $24.96 | Rake $0 
Seat 1: Scarface.VLT folded before Flop (didn't bet)
Seat 2: patapong folded before Flop (didn't bet)
Seat 3: VegasMidas (button) folded before Flop (didn't bet)
Seat 4: LueZaS (small blind) folded before Flop
Seat 5: klenius (big blind) collected ($24.96)
Seat 6: Sir_Fuj1 folded before Flop (didn't bet)


PokerStars Game #102604162977:  Hold'em No Limit ($3/$6 USD) - 2013/08/11 9:29:56 ET
Table 'Lorcia IV 40-100 bb' 6-max Seat #4 is the button
Seat 1: Scarface.VLT ($965.37 in chips) 
Seat 2: patapong ($817.78 in chips) 
Seat 3: VegasMidas ($738.42 in chips) 
Seat 4: LueZaS ($600 in chips) 
Seat 5: klenius ($1217.79 in chips) 
klenius: posts small blind $3
Sir_Fuj1: is sitting out 
Scarface.VLT: posts big blind $6
*** HOLE CARDS ***
patapong: folds 
Sir_Fuj1 leaves the table
VegasMidas: folds 
LueZaS: raises $6.48 to $12.48
klenius: folds 
Scarface.VLT: calls $6.48
*** FLOP *** [Td As 9s]
Scarface.VLT: checks 
LueZaS: checks 
*** TURN *** [Td As 9s] [Ah]
Scarface.VLT: bets $26.70
LueZaS: calls $26.70
*** RIVER *** [Td As 9s Ah] [8c]
Scarface.VLT: bets $54.99
LueZaS: calls $54.99
*** SHOW DOWN ***
Scarface.VLT: shows [Kh Js] (a pair of Aces)
LueZaS: shows [6h Th] (two pair, Aces and Tens)
LueZaS collected $188.54 from pot
*** SUMMARY ***
Total pot $191.34 | Rake $2.80 
Board [Td As 9s Ah 8c]
Seat 1: Scarface.VLT (big blind) showed [Kh Js] and lost with a pair of Aces
Seat 2: patapong folded before Flop (didn't bet)
Seat 3: VegasMidas folded before Flop (didn't bet)
Seat 4: LueZaS (button) showed [6h Th] and won ($188.54) with two pair, Aces and Tens
Seat 5: klenius (small blind) folded before Flop


PokerStars Game #102603831985:  Hold'em No Limit ($3/$6 USD) - 2013/08/11 9:20:32 ET
Table 'Lorcia IV 40-100 bb' 6-max Seat #4 is the button
Seat 1: Scarface.VLT ($1170.33 in chips) 
Seat 2: patapong ($901.99 in chips) 
Seat 3: VegasMidas ($771.46 in chips) 
Seat 4: LueZaS ($600 in chips) 
Seat 5: klenius ($1075.50 in chips) 
Seat 6: Sir_Fuj1 ($238.20 in chips) 
klenius: posts small blind $3
Sir_Fuj1: posts big blind $6
*** HOLE CARDS ***
Scarface.VLT: folds 
patapong: raises $9 to $15
VegasMidas: folds 
LueZaS: folds 
klenius: raises $39 to $54
Sir_Fuj1: folds 
patapong: calls $39
*** FLOP *** [Kc 3h 9s]
klenius: bets $72
patapong: folds 
Uncalled bet ($72) returned to klenius
klenius collected $111.20 from pot
*** SUMMARY ***
Total pot $114 | Rake $2.80 
Board [Kc 3h 9s]
Seat 1: Scarface.VLT folded before Flop (didn't bet)
Seat 2: patapong folded on the Flop
Seat 3: VegasMidas folded before Flop (didn't bet)
Seat 4: LueZaS (button) folded before Flop (didn't bet)
Seat 5: klenius (small blind) collected ($111.20)
Seat 6: Sir_Fuj1 (big blind) folded before Flop


PokerStars Game #102603862108:  Hold'em No Limit ($3/$6 USD) - 2013/08/11 9:21:23 ET
Table 'Lorcia IV 40-100 bb' 6-max Seat #5 is the button
Seat 1: Scarface.VLT ($1170.33 in chips) 
Seat 2: patapong ($847.99 in chips) 
Seat 3: VegasMidas ($771.46 in chips) 
Seat 4: LueZaS ($600 in chips) 
Seat 5: klenius ($1132.70 in chips) 
Seat 6: Sir_Fuj1 ($232.20 in chips) 
Sir_Fuj1: posts small blind $3
Scarface.VLT: posts big blind $6
*** HOLE CARDS ***
patapong: folds 
VegasMidas: folds 
LueZaS: folds 
klenius: folds 
Sir_Fuj1: raises $9 to $15
Scarface.VLT: calls $9
*** FLOP *** [Qh 4s Kc]
Sir_Fuj1: bets $15
Scarface.VLT: calls $15
*** TURN *** [Qh 4s Kc] [6d]
Sir_Fuj1: bets $42
Scarface.VLT: calls $42
*** RIVER *** [Qh 4s Kc 6d] [Qd]
Sir_Fuj1: checks 
Scarface.VLT: bets $556
Sir_Fuj1: calls $160.20 and is all-in
Uncalled bet ($395.80) returned to Scarface.VLT
*** SHOW DOWN ***
Scarface.VLT: shows [9d Td] (a pair of Queens)
Sir_Fuj1: shows [2d Ks] (two pair, Kings and Queens)
Sir_Fuj1 collected $461.60 from pot
*** SUMMARY ***
Total pot $464.40 | Rake $2.80 
Board [Qh 4s Kc 6d Qd]
Seat 1: Scarface.VLT (big blind) showed [9d Td] and lost with a pair of Queens
Seat 2: patapong folded before Flop (didn't bet)
Seat 3: VegasMidas folded before Flop (didn't bet)
Seat 4: LueZaS folded before Flop (didn't bet)
Seat 5: klenius (button) folded before Flop (didn't bet)
Seat 6: Sir_Fuj1 (small blind) showed [2d Ks] and won ($461.60) with two pair, Kings and Queens


PokerStars Game #102603923772:  Hold'em No Limit ($3/$6 USD) - 2013/08/11 9:23:09 ET
Table 'Lorcia IV 40-100 bb' 6-max Seat #6 is the button
Seat 1: Scarface.VLT ($938.13 in chips) 
Seat 2: patapong ($847.99 in chips) 
Seat 3: VegasMidas ($771.46 in chips) 
Seat 4: LueZaS ($600 in chips) 
Seat 5: klenius ($1132.70 in chips) 
Seat 6: Sir_Fuj1 ($461.60 in chips) 
Scarface.VLT: posts small blind $3
patapong: posts big blind $6
*** HOLE CARDS ***
VegasMidas: folds 
LueZaS: folds 
klenius: folds 
Sir_Fuj1: folds 
Scarface.VLT: folds 
Uncalled bet ($3) returned to patapong
patapong collected $6 from pot
*** SUMMARY ***
Total pot $6 | Rake $0 
Seat 1: Scarface.VLT (small blind) folded before Flop
Seat 2: patapong (big blind) collected ($6)
Seat 3: VegasMidas folded before Flop (didn't bet)
Seat 4: LueZaS folded before Flop (didn't bet)
Seat 5: klenius folded before Flop (didn't bet)
Seat 6: Sir_Fuj1 (button) folded before Flop (didn't bet)


PokerStars Game #102603934043:  Hold'em No Limit ($3/$6 USD) - 2013/08/11 9:23:26 ET
Table 'Lorcia IV 40-100 bb' 6-max Seat #1 is the button
Seat 1: Scarface.VLT ($935.13 in chips) 
Seat 2: patapong ($850.99 in chips) 
Seat 3: VegasMidas ($771.46 in chips) 
Seat 4: LueZaS ($600 in chips) 
Seat 5: klenius ($1132.70 in chips) 
Seat 6: Sir_Fuj1 ($461.60 in chips) 
patapong: posts small blind $3
VegasMidas: posts big blind $6
*** HOLE CARDS ***
LueZaS: folds 
klenius: folds 
Sir_Fuj1: folds 
Scarface.VLT: raises $6 to $12
patapong: folds 
VegasMidas: calls $6
*** FLOP *** [Js 3h Qd]
VegasMidas: checks 
Scarface.VLT: bets $18.04
VegasMidas: calls $18.04
*** TURN *** [Js 3h Qd] [4d]
VegasMidas: checks 
Scarface.VLT: checks 
*** RIVER *** [Js 3h Qd 4d] [Ts]
VegasMidas: checks 
Scarface.VLT: bets $42.19
VegasMidas: folds 
Uncalled bet ($42.19) returned to Scarface.VLT
Scarface.VLT collected $60.28 from pot
Scarface.VLT: doesn't show hand 
*** SUMMARY ***
Total pot $63.08 | Rake $2.80 
Board [Js 3h Qd 4d Ts]
Seat 1: Scarface.VLT (button) collected ($60.28)
Seat 2: patapong (small blind) folded before Flop
Seat 3: VegasMidas (big blind) folded on the River
Seat 4: LueZaS folded before Flop (didn't bet)
Seat 5: klenius folded before Flop (didn't bet)
Seat 6: Sir_Fuj1 folded before Flop (didn't bet)


PokerStars Game #102605088108:  Hold'em No Limit ($3/$6 USD) - 2013/08/11 9:55:46 ET
Table 'Lorcia IV 40-100 bb' 6-max Seat #1 is the button
Seat 1: Scarface.VLT ($1693.34 in chips) 
Seat 2: patapong ($715.78 in chips) 
Seat 3: VegasMidas ($1487.82 in chips) 
Seat 4: vivecrew ($479.11 in chips) 
Seat 5: klenius ($603.20 in chips) 
Seat 6: barrao ($565.27 in chips) 
patapong: posts small blind $3
VegasMidas: posts big blind $6
*** HOLE CARDS ***
vivecrew: raises $6.36 to $12.36
klenius: raises $41.64 to $54
barrao: folds 
Scarface.VLT: folds 
patapong: folds 
VegasMidas: folds 
vivecrew: folds 
Uncalled bet ($41.64) returned to klenius
klenius collected $33.72 from pot
*** SUMMARY ***
Total pot $33.72 | Rake $0 
Seat 1: Scarface.VLT (button) folded before Flop (didn't bet)
Seat 2: patapong (small blind) folded before Flop
Seat 3: VegasMidas (big blind) folded before Flop
Seat 4: vivecrew folded before Flop
Seat 5: klenius collected ($33.72)
Seat 6: barrao folded before Flop (didn't bet)


PokerStars Game #102605110389:  Hold'em No Limit ($3/$6 USD) - 2013/08/11 9:56:33 ET
Table 'Lorcia IV 40-100 bb' 6-max Seat #2 is the button
Seat 1: Scarface.VLT ($1693.34 in chips) 
Seat 2: patapong ($712.78 in chips) 
Seat 3: VegasMidas ($1481.82 in chips) 
Seat 4: vivecrew ($466.75 in chips) 
Seat 5: klenius ($624.56 in chips) 
Seat 6: barrao ($565.27 in chips) 
VegasMidas: posts small blind $3
vivecrew: posts big blind $6
*** HOLE CARDS ***
klenius: raises $6 to $12
barrao: folds 
Scarface.VLT: folds 
patapong: folds 
VegasMidas: folds 
vivecrew: folds 
Uncalled bet ($6) returned to klenius
klenius collected $15 from pot
*** SUMMARY ***
Total pot $15 | Rake $0 
Seat 1: Scarface.VLT folded before Flop (didn't bet)
Seat 2: patapong (button) folded before Flop (didn't bet)
Seat 3: VegasMidas (small blind) folded before Flop
Seat 4: vivecrew (big blind) folded before Flop
Seat 5: klenius collected ($15)
Seat 6: barrao folded before Flop (didn't bet)


PokerStars Game #102605122695:  Hold'em No Limit ($3/$6 USD) - 2013/08/11 9:56:59 ET
Table 'Lorcia IV 40-100 bb' 6-max Seat #3 is the button
Seat 1: Scarface.VLT ($1693.34 in chips) 
Seat 2: patapong ($712.78 in chips) 
Seat 3: VegasMidas ($1478.82 in chips) 
Seat 4: vivecrew ($594 in chips) 
Seat 5: klenius ($633.56 in chips) 
Seat 6: barrao ($565.27 in chips) 
vivecrew: posts small blind $3
klenius: posts big blind $6
*** HOLE CARDS ***
barrao: raises $6 to $12
Scarface.VLT: folds 
patapong: folds 
VegasMidas: raises $30 to $42
vivecrew: folds 
klenius: folds 
barrao: folds 
Uncalled bet ($30) returned to VegasMidas
VegasMidas collected $33 from pot
*** SUMMARY ***
Total pot $33 | Rake $0 
Seat 1: Scarface.VLT folded before Flop (didn't bet)
Seat 2: patapong folded before Flop (didn't bet)
Seat 3: VegasMidas (button) collected ($33)
Seat 4: vivecrew (small blind) folded before Flop
Seat 5: klenius (big blind) folded before Flop
Seat 6: barrao folded before Flop


PokerStars Game #102605142430:  Hold'em No Limit ($3/$6 USD) - 2013/08/11 9:57:41 ET
Table 'Lorcia IV 40-100 bb' 6-max Seat #4 is the button
Seat 1: Scarface.VLT ($1693.34 in chips) 
Seat 2: patapong ($712.78 in chips) 
Seat 3: VegasMidas ($1499.82 in chips) 
Seat 4: vivecrew ($591 in chips) 
Seat 5: klenius ($627.56 in chips) 
Seat 6: barrao ($553.27 in chips) 
klenius: posts small blind $3
barrao: posts big blind $6
*** HOLE CARDS ***
Scarface.VLT: folds 
patapong: folds 
VegasMidas: folds 
vivecrew: raises $6.36 to $12.36
klenius: calls $9.36
barrao: folds 
*** FLOP *** [Kh 8c Tc]
klenius: checks 
vivecrew: bets $19.65
klenius: calls $19.65
*** TURN *** [Kh 8c Tc] [9c]
klenius: checks 
vivecrew: checks 
*** RIVER *** [Kh 8c Tc 9c] [8h]
klenius: checks 
vivecrew: checks 
*** SHOW DOWN ***
klenius: shows [7h 7d] (two pair, Eights and Sevens)
vivecrew: shows [7c 9s] (two pair, Nines and Eights)
vivecrew collected $67.22 from pot
*** SUMMARY ***
Total pot $70.02 | Rake $2.80 
Board [Kh 8c Tc 9c 8h]
Seat 1: Scarface.VLT folded before Flop (didn't bet)
Seat 2: patapong folded before Flop (didn't bet)
Seat 3: VegasMidas folded before Flop (didn't bet)
Seat 4: vivecrew (button) showed [7c 9s] and won ($67.22) with two pair, Nines and Eights
Seat 5: klenius (small blind) showed [7h 7d] and lost with two pair, Eights and Sevens
Seat 6: barrao (big blind) folded before Flop


PokerStars Game #102605177145:  Hold'em No Limit ($3/$6 USD) - 2013/08/11 9:58:55 ET
Table 'Lorcia IV 40-100 bb' 6-max Seat #5 is the button
Seat 1: Scarface.VLT ($1693.34 in chips) 
Seat 2: patapong ($712.78 in chips) 
Seat 3: VegasMidas ($1499.82 in chips) 
Seat 4: vivecrew ($626.21 in chips) 
Seat 5: klenius ($595.55 in chips) 
Seat 6: barrao ($547.27 in chips) 
barrao: posts small blind $3
Scarface.VLT: posts big blind $6
*** HOLE CARDS ***
patapong: folds 
VegasMidas: folds 
vivecrew: folds 
klenius: folds 
barrao: folds 
Uncalled bet ($3) returned to Scarface.VLT
Scarface.VLT collected $6 from pot
Scarface.VLT: doesn't show hand 
*** SUMMARY ***
Total pot $6 | Rake $0 
Seat 1: Scarface.VLT (big blind) collected ($6)
Seat 2: patapong folded before Flop (didn't bet)
Seat 3: VegasMidas folded before Flop (didn't bet)
Seat 4: vivecrew folded before Flop (didn't bet)
Seat 5: klenius (button) folded before Flop (didn't bet)
Seat 6: barrao (small blind) folded before Flop


PokerStars Game #102605186896:  Hold'em No Limit ($3/$6 USD) - 2013/08/11 9:59:15 ET
Table 'Lorcia IV 40-100 bb' 6-max Seat #6 is the button
Seat 1: Scarface.VLT ($1696.34 in chips) 
Seat 2: patapong ($712.78 in chips) 
Seat 3: VegasMidas ($1499.82 in chips) 
Seat 4: vivecrew ($626.21 in chips) 
Seat 5: klenius ($595.55 in chips) 
Seat 6: barrao ($544.27 in chips) 
Scarface.VLT: posts small blind $3
patapong: posts big blind $6
*** HOLE CARDS ***
VegasMidas: folds 
vivecrew: folds 
klenius: folds 
barrao: folds 
Scarface.VLT: raises $12 to $18
patapong: calls $12
*** FLOP *** [Jc 6d As]
Scarface.VLT: checks 
patapong: bets $24.07
Scarface.VLT: calls $24.07
*** TURN *** [Jc 6d As] [3d]
Scarface.VLT: checks 
patapong: bets $55.87
Scarface.VLT: folds 
Uncalled bet ($55.87) returned to patapong
patapong collected $81.34 from pot
*** SUMMARY ***
Total pot $84.14 | Rake $2.80 
Board [Jc 6d As 3d]
Seat 1: Scarface.VLT (small blind) folded on the Turn
Seat 2: patapong (big blind) collected ($81.34)
Seat 3: VegasMidas folded before Flop (didn't bet)
Seat 4: vivecrew folded before Flop (didn't bet)
Seat 5: klenius folded before Flop (didn't bet)
Seat 6: barrao (button) folded before Flop (didn't bet)


PokerStars Game #102605246805:  Hold'em No Limit ($3/$6 USD) - 2013/08/11 10:01:08 ET
Table 'Lorcia IV 40-100 bb' 6-max Seat #1 is the button
Seat 1: Scarface.VLT ($1654.27 in chips) 
Seat 2: patapong ($752.05 in chips) 
Seat 4: vivecrew ($626.21 in chips) 
Seat 5: klenius ($595.55 in chips) 
Seat 6: barrao ($544.27 in chips) 
patapong: posts small blind $3
VegasMidas: is sitting out 
vivecrew: posts big blind $6
*** HOLE CARDS ***
klenius: folds 
VegasMidas leaves the table
barrao: raises $6 to $12
Scarface.VLT: folds 
elvn89 joins the table at seat #3 
patapong: folds 
vivecrew: folds 
Uncalled bet ($6) returned to barrao
barrao collected $15 from pot
barrao: doesn't show hand 
*** SUMMARY ***
Total pot $15 | Rake $0 
Seat 1: Scarface.VLT (button) folded before Flop (didn't bet)
Seat 2: patapong (small blind) folded before Flop
Seat 4: vivecrew (big blind) folded before Flop
Seat 5: klenius folded before Flop (didn't bet)
Seat 6: barrao collected ($15)


PokerStars Game #102605262065:  Hold'em No Limit ($3/$6 USD) - 2013/08/11 10:01:33 ET
Table 'Lorcia IV 40-100 bb' 6-max Seat #2 is the button
Seat 1: Scarface.VLT ($1654.27 in chips) 
Seat 2: patapong ($749.05 in chips) 
Seat 4: vivecrew ($620.21 in chips) 
Seat 5: klenius ($595.55 in chips) 
Seat 6: barrao ($553.27 in chips) 
elvn89 will be allowed to play after the button
vivecrew: posts small blind $3
klenius: posts big blind $6
*** HOLE CARDS ***
barrao: folds 
Scarface.VLT: folds 
patapong: raises $6 to $12
vivecrew: folds 
klenius: calls $6
*** FLOP *** [5h Ts Jh]
klenius: checks 
patapong: bets $18.05
klenius: calls $18.05
*** TURN *** [5h Ts Jh] [Js]
klenius: checks 
patapong: bets $39.20
klenius: calls $39.20
*** RIVER *** [5h Ts Jh Js] [Ac]
klenius: checks 
patapong: bets $108
klenius: calls $108
*** SHOW DOWN ***
patapong: shows [Kh Qh] (a straight, Ten to Ace)
klenius: mucks hand 
patapong collected $354.70 from pot
*** SUMMARY ***
Total pot $357.50 | Rake $2.80 
Board [5h Ts Jh Js Ac]
Seat 1: Scarface.VLT folded before Flop (didn't bet)
Seat 2: patapong (button) showed [Kh Qh] and won ($354.70) with a straight, Ten to Ace
Seat 4: vivecrew (small blind) folded before Flop
Seat 5: klenius (big blind) mucked
Seat 6: barrao folded before Flop (didn't bet)


PokerStars Game #102605300056:  Hold'em No Limit ($3/$6 USD) - 2013/08/11 10:02:31 ET
Table 'Lorcia IV 40-100 bb' 6-max Seat #4 is the button
Seat 1: Scarface.VLT ($1654.27 in chips) 
Seat 2: patapong ($926.50 in chips) 
Seat 4: vivecrew ($617.21 in chips) 
Seat 5: klenius ($418.30 in chips) 
Seat 6: barrao ($553.27 in chips) 
klenius: posts small blind $3
barrao: posts big blind $6
elvn89: sits out 
*** HOLE CARDS ***
Scarface.VLT: folds 
patapong: folds 
vivecrew: folds 
klenius: raises $6 to $12
barrao: calls $6
*** FLOP *** [4c 3s 4h]
klenius: bets $18
barrao: folds 
Uncalled bet ($18) returned to klenius
klenius collected $22.92 from pot
*** SUMMARY ***
Total pot $24 | Rake $1.08 
Board [4c 3s 4h]
Seat 1: Scarface.VLT folded before Flop (didn't bet)
Seat 2: patapong folded before Flop (didn't bet)
Seat 4: vivecrew (button) folded before Flop (didn't bet)
Seat 5: klenius (small blind) collected ($22.92)
Seat 6: barrao (big blind) folded on the Flop


PokerStars Game #102605331131:  Hold'em No Limit ($3/$6 USD) - 2013/08/11 10:03:18 ET
Table 'Lorcia IV 40-100 bb' 6-max Seat #5 is the button
Seat 1: Scarface.VLT ($1654.27 in chips) 
Seat 2: patapong ($926.50 in chips) 
Seat 4: vivecrew ($617.21 in chips) 
Seat 5: klenius ($429.22 in chips) 
Seat 6: barrao ($541.27 in chips) 
barrao: posts small blind $3
Scarface.VLT: posts big blind $6
elvn89: sits out 
*** HOLE CARDS ***
patapong: folds 
vivecrew: folds 
klenius: raises $6 to $12
barrao: folds 
Scarface.VLT: calls $6
*** FLOP *** [Ah 2d Ac]
Scarface.VLT: checks 
klenius: bets $18
Scarface.VLT: calls $18
*** TURN *** [Ah 2d Ac] [Js]
Scarface.VLT: checks 
klenius: bets $54
Scarface.VLT: calls $54
*** RIVER *** [Ah 2d Ac Js] [5d]
Scarface.VLT: checks 
klenius: checks 
*** SHOW DOWN ***
Scarface.VLT: shows [As 4d] (three of a kind, Aces)
klenius: mucks hand 
Scarface.VLT collected $168.20 from pot
*** SUMMARY ***
Total pot $171 | Rake $2.80 
Board [Ah 2d Ac Js 5d]
Seat 1: Scarface.VLT (big blind) showed [As 4d] and won ($168.20) with three of a kind, Aces
Seat 2: patapong folded before Flop (didn't bet)
Seat 4: vivecrew folded before Flop (didn't bet)
Seat 5: klenius (button) mucked
Seat 6: barrao (small blind) folded before Flop


PokerStars Game #102605362752:  Hold'em No Limit ($3/$6 USD) - 2013/08/11 10:04:04 ET
Table 'Lorcia IV 40-100 bb' 6-max Seat #6 is the button
Seat 1: Scarface.VLT ($1738.47 in chips) 
Seat 2: patapong ($926.50 in chips) 
Seat 4: vivecrew ($617.21 in chips) 
Seat 5: klenius ($345.22 in chips) 
Seat 6: barrao ($538.27 in chips) 
Scarface.VLT: posts small blind $3
patapong: posts big blind $6
elvn89: sits out 
*** HOLE CARDS ***
vivecrew: folds 
klenius: folds 
barrao: folds 
Scarface.VLT: raises $12 to $18
patapong: calls $12
*** FLOP *** [Js Ad 4d]
Scarface.VLT: bets $24.06
patapong: folds 
Uncalled bet ($24.06) returned to Scarface.VLT
Scarface.VLT collected $34.38 from pot
Scarface.VLT: doesn't show hand 
*** SUMMARY ***
Total pot $36 | Rake $1.62 
Board [Js Ad 4d]
Seat 1: Scarface.VLT (small blind) collected ($34.38)
Seat 2: patapong (big blind) folded on the Flop
Seat 4: vivecrew folded before Flop (didn't bet)
Seat 5: klenius folded before Flop (didn't bet)
Seat 6: barrao (button) folded before Flop (didn't bet)


PokerStars Game #102604892273:  Hold'em No Limit ($3/$6 USD) - 2013/08/11 9:50:16 ET
Table 'Lorcia IV 40-100 bb' 6-max Seat #4 is the button
Seat 1: Scarface.VLT ($1708.70 in chips) 
Seat 2: patapong ($721.78 in chips) 
Seat 3: VegasMidas ($1474.04 in chips) 
Seat 4: vivecrew ($465 in chips) 
Seat 5: klenius ($615 in chips) 
Seat 6: barrao ($568.07 in chips) 
klenius: posts small blind $3
barrao: posts big blind $6
*** HOLE CARDS ***
Scarface.VLT: folds 
patapong: raises $9 to $15
VegasMidas: folds 
vivecrew: folds 
klenius: folds 
barrao: folds 
Uncalled bet ($9) returned to patapong
patapong collected $15 from pot
*** SUMMARY ***
Total pot $15 | Rake $0 
Seat 1: Scarface.VLT folded before Flop (didn't bet)
Seat 2: patapong collected ($15)
Seat 3: VegasMidas folded before Flop (didn't bet)
Seat 4: vivecrew (button) folded before Flop (didn't bet)
Seat 5: klenius (small blind) folded before Flop
Seat 6: barrao (big blind) folded before Flop


PokerStars Game #102604910622:  Hold'em No Limit ($3/$6 USD) - 2013/08/11 9:50:46 ET
Table 'Lorcia IV 40-100 bb' 6-max Seat #5 is the button
Seat 2: patapong ($730.78 in chips) 
Seat 3: VegasMidas ($1474.04 in chips) 
Seat 4: vivecrew ($465 in chips) 
Seat 5: klenius ($612 in chips) 
Seat 6: barrao ($562.07 in chips) 
barrao: posts small blind $3
Scarface.VLT: is sitting out 
patapong: posts big blind $6
*** HOLE CARDS ***
VegasMidas: folds 
vivecrew: folds 
klenius: raises $6 to $12
barrao: calls $9
patapong: folds 
*** FLOP *** [8s 4s Ac]
barrao: checks 
klenius: checks 
*** TURN *** [8s 4s Ac] [6s]
barrao: bets $24
klenius: raises $54 to $78
barrao: calls $54
*** RIVER *** [8s 4s Ac 6s] [Qc]
barrao: checks 
klenius: checks 
*** SHOW DOWN ***
barrao: shows [Ad 4d] (two pair, Aces and Fours)
klenius: mucks hand 
barrao collected $183.20 from pot
*** SUMMARY ***
Total pot $186 | Rake $2.80 
Board [8s 4s Ac 6s Qc]
Seat 2: patapong (big blind) folded before Flop
Seat 3: VegasMidas folded before Flop (didn't bet)
Seat 4: vivecrew folded before Flop (didn't bet)
Seat 5: klenius (button) mucked
Seat 6: barrao (small blind) showed [Ad 4d] and won ($183.20) with two pair, Aces and Fours


PokerStars Game #102604941439:  Hold'em No Limit ($3/$6 USD) - 2013/08/11 9:51:37 ET
Table 'Lorcia IV 40-100 bb' 6-max Seat #6 is the button
Seat 2: patapong ($724.78 in chips) 
Seat 3: VegasMidas ($1474.04 in chips) 
Seat 4: vivecrew ($465 in chips) 
Seat 5: klenius ($522 in chips) 
Seat 6: barrao ($655.27 in chips) 
patapong: posts small blind $3
VegasMidas: posts big blind $6
*** HOLE CARDS ***
vivecrew: folds 
klenius: folds 
barrao: folds 
patapong: folds 
Uncalled bet ($3) returned to VegasMidas
VegasMidas collected $6 from pot
*** SUMMARY ***
Total pot $6 | Rake $0 
Seat 2: patapong (small blind) folded before Flop
Seat 3: VegasMidas (big blind) collected ($6)
Seat 4: vivecrew folded before Flop (didn't bet)
Seat 5: klenius folded before Flop (didn't bet)
Seat 6: barrao (button) folded before Flop (didn't bet)


PokerStars Game #102604953750:  Hold'em No Limit ($3/$6 USD) - 2013/08/11 9:51:57 ET
Table 'Lorcia IV 40-100 bb' 6-max Seat #2 is the button
Seat 2: patapong ($721.78 in chips) 
Seat 3: VegasMidas ($1477.04 in chips) 
Seat 4: vivecrew ($465 in chips) 
Seat 5: klenius ($522 in chips) 
Seat 6: barrao ($655.27 in chips) 
VegasMidas: posts small blind $3
vivecrew: posts big blind $6
*** HOLE CARDS ***
klenius: folds 
barrao: raises $6 to $12
patapong: folds 
VegasMidas: folds 
vivecrew: folds 
Uncalled bet ($6) returned to barrao
barrao collected $15 from pot
barrao: doesn't show hand 
*** SUMMARY ***
Total pot $15 | Rake $0 
Seat 2: patapong (button) folded before Flop (didn't bet)
Seat 3: VegasMidas (small blind) folded before Flop
Seat 4: vivecrew (big blind) folded before Flop
Seat 5: klenius folded before Flop (didn't bet)
Seat 6: barrao collected ($15)


PokerStars Game #102604969000:  Hold'em No Limit ($3/$6 USD) - 2013/08/11 9:52:22 ET
Table 'Lorcia IV 40-100 bb' 6-max Seat #3 is the button
Seat 2: patapong ($721.78 in chips) 
Seat 3: VegasMidas ($1474.04 in chips) 
Seat 4: vivecrew ($459 in chips) 
Seat 5: klenius ($522 in chips) 
Seat 6: barrao ($664.27 in chips) 
vivecrew: posts small blind $3
klenius: posts big blind $6
*** HOLE CARDS ***
barrao: folds 
patapong: folds 
VegasMidas: raises $6 to $12
vivecrew: folds 
klenius: calls $6
*** FLOP *** [4d 2h Ac]
klenius: checks 
VegasMidas: checks 
*** TURN *** [4d 2h Ac] [Ah]
klenius: checks 
VegasMidas: checks 
*** RIVER *** [4d 2h Ac Ah] [Qc]
klenius: checks 
VegasMidas: bets $18
klenius: folds 
Uncalled bet ($18) returned to VegasMidas
VegasMidas collected $25.78 from pot
*** SUMMARY ***
Total pot $27 | Rake $1.22 
Board [4d 2h Ac Ah Qc]
Seat 2: patapong folded before Flop (didn't bet)
Seat 3: VegasMidas (button) collected ($25.78)
Seat 4: vivecrew (small blind) folded before Flop
Seat 5: klenius (big blind) folded on the River
Seat 6: barrao folded before Flop (didn't bet)


PokerStars Game #102604991470:  Hold'em No Limit ($3/$6 USD) - 2013/08/11 9:52:59 ET
Table 'Lorcia IV 40-100 bb' 6-max Seat #4 is the button
Seat 2: patapong ($721.78 in chips) 
Seat 3: VegasMidas ($1487.82 in chips) 
Seat 4: vivecrew ($456 in chips) 
Seat 5: klenius ($510 in chips) 
Seat 6: barrao ($664.27 in chips) 
klenius: posts small blind $3
barrao: posts big blind $6
Scarface.VLT: sits out 
*** HOLE CARDS ***
patapong: folds 
VegasMidas: folds 
vivecrew: raises $6.36 to $12.36
klenius: folds 
barrao: folds 
Uncalled bet ($6.36) returned to vivecrew
vivecrew collected $15 from pot
*** SUMMARY ***
Total pot $15 | Rake $0 
Seat 2: patapong folded before Flop (didn't bet)
Seat 3: VegasMidas folded before Flop (didn't bet)
Seat 4: vivecrew (button) collected ($15)
Seat 5: klenius (small blind) folded before Flop
Seat 6: barrao (big blind) folded before Flop


PokerStars Game #102605008420:  Hold'em No Limit ($3/$6 USD) - 2013/08/11 9:53:27 ET
Table 'Lorcia IV 40-100 bb' 6-max Seat #5 is the button
Seat 1: Scarface.VLT ($1708.70 in chips) 
Seat 2: patapong ($721.78 in chips) 
Seat 3: VegasMidas ($1487.82 in chips) 
Seat 4: vivecrew ($465 in chips) 
Seat 5: klenius ($507 in chips) 
Seat 6: barrao ($658.27 in chips) 
barrao: posts small blind $3
Scarface.VLT: posts big blind $6
*** HOLE CARDS ***
patapong: folds 
VegasMidas: folds 
vivecrew: raises $6.36 to $12.36
klenius: folds 
barrao: folds 
Scarface.VLT: calls $6.36
*** FLOP *** [2s 4c 4h]
Scarface.VLT: checks 
vivecrew: bets $17.73
Scarface.VLT: folds 
Uncalled bet ($17.73) returned to vivecrew
vivecrew collected $26.47 from pot
*** SUMMARY ***
Total pot $27.72 | Rake $1.25 
Board [2s 4c 4h]
Seat 1: Scarface.VLT (big blind) folded on the Flop
Seat 2: patapong folded before Flop (didn't bet)
Seat 3: VegasMidas folded before Flop (didn't bet)
Seat 4: vivecrew collected ($26.47)
Seat 5: klenius (button) folded before Flop (didn't bet)
Seat 6: barrao (small blind) folded before Flop


PokerStars Game #102605038284:  Hold'em No Limit ($3/$6 USD) - 2013/08/11 9:54:16 ET
Table 'Lorcia IV 40-100 bb' 6-max Seat #6 is the button
Seat 1: Scarface.VLT ($1696.34 in chips) 
Seat 2: patapong ($721.78 in chips) 
Seat 3: VegasMidas ($1487.82 in chips) 
Seat 4: vivecrew ($479.11 in chips) 
Seat 5: klenius ($507 in chips) 
Seat 6: barrao ($655.27 in chips) 
Scarface.VLT: posts small blind $3
patapong: posts big blind $6
*** HOLE CARDS ***
VegasMidas: folds 
vivecrew: folds 
klenius: raises $6 to $12
barrao: calls $12
Scarface.VLT: folds 
patapong: folds 
*** FLOP *** [Td Ks As]
klenius: bets $18
barrao: calls $18
*** TURN *** [Td Ks As] [7d]
klenius: bets $60
barrao: calls $60
*** RIVER *** [Td Ks As 7d] [Ts]
klenius: bets $156
barrao: folds 
Uncalled bet ($156) returned to klenius
klenius collected $186.20 from pot
*** SUMMARY ***
Total pot $189 | Rake $2.80 
Board [Td Ks As 7d Ts]
Seat 1: Scarface.VLT (small blind) folded before Flop
Seat 2: patapong (big blind) folded before Flop
Seat 3: VegasMidas folded before Flop (didn't bet)
Seat 4: vivecrew folded before Flop (didn't bet)
Seat 5: klenius collected ($186.20)
Seat 6: barrao (button) folded on the River


PokerStars Game #102604747488:  Hold'em No Limit ($3/$6 USD) - 2013/08/11 9:46:18 ET
Table 'Lorcia IV 40-100 bb' 6-max Seat #5 is the button
Seat 1: Scarface.VLT ($833.25 in chips) 
Seat 2: patapong ($730.78 in chips) 
Seat 3: VegasMidas ($744.42 in chips) 
Seat 5: klenius ($1785.44 in chips) 
Seat 6: barrao ($643.07 in chips) 
barrao: posts small blind $3
Scarface.VLT: posts big blind $6
*** HOLE CARDS ***
patapong: folds 
VegasMidas: raises $9 to $15
klenius: raises $27 to $42
barrao: folds 
Scarface.VLT: folds 
VegasMidas: raises $72 to $114
klenius: raises $96 to $210
VegasMidas: calls $96
*** FLOP *** [8c 4s Jc]
VegasMidas: checks 
klenius: bets $318
VegasMidas: raises $216.42 to $534.42 and is all-in
klenius: calls $216.42
*** TURN *** [8c 4s Jc] [8h]
*** RIVER *** [8c 4s Jc 8h] [3c]
*** SHOW DOWN ***
VegasMidas: shows [Ac Qc] (a flush, Ace high)
klenius: shows [Kc Jh] (two pair, Jacks and Eights)
VegasMidas collected $1495.04 from pot
*** SUMMARY ***
Total pot $1497.84 | Rake $2.80 
Board [8c 4s Jc 8h 3c]
Seat 1: Scarface.VLT (big blind) folded before Flop
Seat 2: patapong folded before Flop (didn't bet)
Seat 3: VegasMidas showed [Ac Qc] and won ($1495.04) with a flush, Ace high
Seat 5: klenius (button) showed [Kc Jh] and lost with two pair, Jacks and Eights
Seat 6: barrao (small blind) folded before Flop


PokerStars Game #102604787742:  Hold'em No Limit ($3/$6 USD) - 2013/08/11 9:47:24 ET
Table 'Lorcia IV 40-100 bb' 6-max Seat #6 is the button
Seat 1: Scarface.VLT ($827.25 in chips) 
Seat 2: patapong ($730.78 in chips) 
Seat 3: VegasMidas ($1495.04 in chips) 
Seat 5: klenius ($1041.02 in chips) 
Seat 6: barrao ($640.07 in chips) 
Scarface.VLT: posts small blind $3
patapong: posts big blind $6
vivecrew: sits out 
*** HOLE CARDS ***
VegasMidas: folds 
klenius: folds 
barrao: folds 
Scarface.VLT: raises $12 to $18
patapong: folds 
Uncalled bet ($12) returned to Scarface.VLT
Scarface.VLT collected $12 from pot
Scarface.VLT: doesn't show hand 
*** SUMMARY ***
Total pot $12 | Rake $0 
Seat 1: Scarface.VLT (small blind) collected ($12)
Seat 2: patapong (big blind) folded before Flop
Seat 3: VegasMidas folded before Flop (didn't bet)
Seat 5: klenius folded before Flop (didn't bet)
Seat 6: barrao (button) folded before Flop (didn't bet)


PokerStars Game #102604806373:  Hold'em No Limit ($3/$6 USD) - 2013/08/11 9:47:55 ET
Table 'Lorcia IV 40-100 bb' 6-max Seat #1 is the button
Seat 1: Scarface.VLT ($833.25 in chips) 
Seat 2: patapong ($724.78 in chips) 
Seat 3: VegasMidas ($1495.04 in chips) 
Seat 5: klenius ($1041.02 in chips) 
Seat 6: barrao ($640.07 in chips) 
patapong: posts small blind $3
VegasMidas: posts big blind $6
vivecrew: sits out 
*** HOLE CARDS ***
klenius: raises $6 to $12
barrao: raises $24 to $36
Scarface.VLT: calls $36
patapong: folds 
VegasMidas: folds 
klenius: raises $138 to $174
barrao: folds 
Scarface.VLT: raises $659.25 to $833.25 and is all-in
klenius: calls $659.25
*** FLOP *** [Jd 3h 2s]
*** TURN *** [Jd 3h 2s] [5s]
*** RIVER *** [Jd 3h 2s 5s] [4h]
*** SHOW DOWN ***
klenius: shows [8d 8h] (a pair of Eights)
Scarface.VLT: shows [Kd Kh] (a pair of Kings)
Scarface.VLT collected $1708.70 from pot
*** SUMMARY ***
Total pot $1711.50 | Rake $2.80 
Board [Jd 3h 2s 5s 4h]
Seat 1: Scarface.VLT (button) showed [Kd Kh] and won ($1708.70) with a pair of Kings
Seat 2: patapong (small blind) folded before Flop
Seat 3: VegasMidas (big blind) folded before Flop
Seat 5: klenius showed [8d 8h] and lost with a pair of Eights
Seat 6: barrao folded before Flop


PokerStars Game #102604850560:  Hold'em No Limit ($3/$6 USD) - 2013/08/11 9:49:08 ET
Table 'Lorcia IV 40-100 bb' 6-max Seat #2 is the button
Seat 1: Scarface.VLT ($1708.70 in chips) 
Seat 2: patapong ($721.78 in chips) 
Seat 3: VegasMidas ($1489.04 in chips) 
Seat 4: vivecrew ($474 in chips) 
Seat 5: klenius ($207.77 in chips) 
Seat 6: barrao ($604.07 in chips) 
VegasMidas: posts small blind $3
vivecrew: posts big blind $6
*** HOLE CARDS ***
klenius: raises $6 to $12
barrao: raises $24 to $36
Scarface.VLT: folds 
patapong: folds 
VegasMidas: folds 
vivecrew: folds 
klenius: raises $171.77 to $207.77 and is all-in
barrao: folds 
Uncalled bet ($171.77) returned to klenius
klenius collected $81 from pot
*** SUMMARY ***
Total pot $81 | Rake $0 
Seat 1: Scarface.VLT folded before Flop (didn't bet)
Seat 2: patapong (button) folded before Flop (didn't bet)
Seat 3: VegasMidas (small blind) folded before Flop
Seat 4: vivecrew (big blind) folded before Flop
Seat 5: klenius collected ($81)
Seat 6: barrao folded before Flop


PokerStars Game #102604871071:  Hold'em No Limit ($3/$6 USD) - 2013/08/11 9:49:41 ET
Table 'Lorcia IV 40-100 bb' 6-max Seat #3 is the button
Seat 1: Scarface.VLT ($1708.70 in chips) 
Seat 2: patapong ($721.78 in chips) 
Seat 3: VegasMidas ($1486.04 in chips) 
Seat 4: vivecrew ($468 in chips) 
Seat 5: klenius ($600 in chips) 
Seat 6: barrao ($568.07 in chips) 
vivecrew: posts small blind $3
klenius: posts big blind $6
*** HOLE CARDS ***
barrao: folds 
Scarface.VLT: folds 
patapong: folds 
VegasMidas: raises $6 to $12
vivecrew: folds 
klenius: raises $30 to $42
VegasMidas: folds 
Uncalled bet ($30) returned to klenius
klenius collected $27 from pot
*** SUMMARY ***
Total pot $27 | Rake $0 
Seat 1: Scarface.VLT folded before Flop (didn't bet)
Seat 2: patapong folded before Flop (didn't bet)
Seat 3: VegasMidas (button) folded before Flop
Seat 4: vivecrew (small blind) folded before Flop
Seat 5: klenius (big blind) collected ($27)
Seat 6: barrao folded before Flop (didn't bet)


PokerStars Game #102605885526:  Hold'em No Limit ($3/$6 USD) - 2013/08/11 10:16:11 ET
Table 'Lorcia IV 40-100 bb' 6-max Seat #3 is the button
Seat 1: Scarface.VLT ($1833.25 in chips) 
Seat 3: elvn89 ($198.96 in chips) 
Seat 4: vivecrew ($1196.13 in chips) 
Seat 5: x_QUIXTAR_x ($300 in chips) 
Seat 6: barrao ($529.27 in chips) 
vivecrew: posts small blind $3
x_QUIXTAR_x: posts big blind $6
patapong: sits out 
*** HOLE CARDS ***
barrao: folds 
Scarface.VLT: folds 
elvn89: raises $7.02 to $13.02
vivecrew: folds 
x_QUIXTAR_x: raises $22.98 to $36
elvn89: folds 
Uncalled bet ($22.98) returned to x_QUIXTAR_x
x_QUIXTAR_x collected $29.04 from pot
x_QUIXTAR_x: doesn't show hand 
*** SUMMARY ***
Total pot $29.04 | Rake $0 
Seat 1: Scarface.VLT folded before Flop (didn't bet)
Seat 3: elvn89 (button) folded before Flop
Seat 4: vivecrew (small blind) folded before Flop
Seat 5: x_QUIXTAR_x (big blind) collected ($29.04)
Seat 6: barrao folded before Flop (didn't bet)


PokerStars Game #102605913511:  Hold'em No Limit ($3/$6 USD) - 2013/08/11 10:16:48 ET
Table 'Lorcia IV 40-100 bb' 6-max Seat #4 is the button
Seat 1: Scarface.VLT ($1833.25 in chips) 
Seat 3: elvn89 ($185.94 in chips) 
Seat 4: vivecrew ($1193.13 in chips) 
Seat 5: x_QUIXTAR_x ($316.02 in chips) 
Seat 6: barrao ($529.27 in chips) 
x_QUIXTAR_x: posts small blind $3
barrao: posts big blind $6
patapong: sits out 
*** HOLE CARDS ***
Scarface.VLT: folds 
Scarface.VLT leaves the table
elvn89: folds 
vivecrew: raises $6.36 to $12.36
x_QUIXTAR_x: folds 
barrao: folds 
Uncalled bet ($6.36) returned to vivecrew
vivecrew collected $15 from pot
*** SUMMARY ***
Total pot $15 | Rake $0 
Seat 1: Scarface.VLT folded before Flop (didn't bet)
Seat 3: elvn89 folded before Flop (didn't bet)
Seat 4: vivecrew (button) collected ($15)
Seat 5: x_QUIXTAR_x (small blind) folded before Flop
Seat 6: barrao (big blind) folded before Flop


PokerStars Game #102605942490:  Hold'em No Limit ($3/$6 USD) - 2013/08/11 10:17:27 ET
Table 'Lorcia IV 40-100 bb' 6-max Seat #5 is the button
Seat 2: patapong ($887.50 in chips) 
Seat 3: elvn89 ($185.94 in chips) 
Seat 4: vivecrew ($1202.13 in chips) 
Seat 5: x_QUIXTAR_x ($313.02 in chips) 
Seat 6: barrao ($523.27 in chips) 
barrao: posts small blind $3
patapong: posts big blind $6
*** HOLE CARDS ***
elvn89: folds 
vivecrew: folds 
x_QUIXTAR_x: raises $7.50 to $13.50
barrao: folds 
patapong: folds 
Uncalled bet ($7.50) returned to x_QUIXTAR_x
x_QUIXTAR_x collected $15 from pot
x_QUIXTAR_x: doesn't show hand 
*** SUMMARY ***
Total pot $15 | Rake $0 
Seat 2: patapong (big blind) folded before Flop
Seat 3: elvn89 folded before Flop (didn't bet)
Seat 4: vivecrew folded before Flop (didn't bet)
Seat 5: x_QUIXTAR_x (button) collected ($15)
Seat 6: barrao (small blind) folded before Flop


PokerStars Game #102605969105:  Hold'em No Limit ($3/$6 USD) - 2013/08/11 10:18:03 ET
Table 'Lorcia IV 40-100 bb' 6-max Seat #6 is the button
Seat 2: patapong ($881.50 in chips) 
Seat 3: elvn89 ($185.94 in chips) 
Seat 4: vivecrew ($1202.13 in chips) 
Seat 5: x_QUIXTAR_x ($322.02 in chips) 
Seat 6: barrao ($520.27 in chips) 
patapong: posts small blind $3
elvn89: posts big blind $6
*** HOLE CARDS ***
vivecrew: folds 
x_QUIXTAR_x: folds 
barrao: raises $6 to $12
patapong: folds 
elvn89: folds 
Uncalled bet ($6) returned to barrao
barrao collected $15 from pot
barrao: doesn't show hand 
*** SUMMARY ***
Total pot $15 | Rake $0 
Seat 2: patapong (small blind) folded before Flop
Seat 3: elvn89 (big blind) folded before Flop
Seat 4: vivecrew folded before Flop (didn't bet)
Seat 5: x_QUIXTAR_x folded before Flop (didn't bet)
Seat 6: barrao (button) collected ($15)


PokerStars Game #102605998777:  Hold'em No Limit ($3/$6 USD) - 2013/08/11 10:18:42 ET
Table 'Lorcia IV 40-100 bb' 6-max Seat #2 is the button
Seat 2: patapong ($878.50 in chips) 
Seat 3: elvn89 ($179.94 in chips) 
Seat 5: x_QUIXTAR_x ($322.02 in chips) 
Seat 6: barrao ($529.27 in chips) 
elvn89: posts small blind $3
vivecrew: is sitting out 
vivecrew leaves the table
x_QUIXTAR_x: posts big blind $6
*** HOLE CARDS ***
barrao: folds 
barrao leaves the table
patapong: raises $6 to $12
elvn89: folds 
x_QUIXTAR_x: raises $24 to $36
patapong: folds 
Uncalled bet ($24) returned to x_QUIXTAR_x
x_QUIXTAR_x collected $27 from pot
x_QUIXTAR_x: doesn't show hand 
*** SUMMARY ***
Total pot $27 | Rake $0 
Seat 2: patapong (button) folded before Flop
Seat 3: elvn89 (small blind) folded before Flop
Seat 5: x_QUIXTAR_x (big blind) collected ($27)
Seat 6: barrao folded before Flop (didn't bet)


PokerStars Game #102606035862:  Hold'em No Limit ($3/$6 USD) - 2013/08/11 10:19:31 ET
Table 'Lorcia IV 40-100 bb' 6-max Seat #5 is the button
Seat 3: elvn89 ($176.94 in chips) 
Seat 5: x_QUIXTAR_x ($337.02 in chips) 
x_QUIXTAR_x: posts small blind $3
elvn89: posts big blind $6
*** HOLE CARDS ***
patapong leaves the table
x_QUIXTAR_x: raises $7.50 to $13.50
elvn89: raises $22.74 to $36.24
x_QUIXTAR_x: folds 
Uncalled bet ($22.74) returned to elvn89
elvn89 collected $27 from pot
*** SUMMARY ***
Total pot $27 | Rake $0 
Seat 3: elvn89 (big blind) collected ($27)
Seat 5: x_QUIXTAR_x (button) (small blind) folded before Flop


PokerStars Game #102605666388:  Hold'em No Limit ($3/$6 USD) - 2013/08/11 10:11:11 ET
Table 'Lorcia IV 40-100 bb' 6-max Seat #2 is the button
Seat 1: Scarface.VLT ($1800.05 in chips) 
Seat 2: patapong ($887.50 in chips) 
Seat 3: elvn89 ($211.98 in chips) 
Seat 4: vivecrew ($608.21 in chips) 
Seat 5: klenius ($608.67 in chips) 
Seat 6: barrao ($538.27 in chips) 
elvn89: posts small blind $3
vivecrew: posts big blind $6
*** HOLE CARDS ***
klenius: raises $6 to $12
barrao: folds 
Scarface.VLT: folds 
patapong: folds 
elvn89: folds 
vivecrew: folds 
Uncalled bet ($6) returned to klenius
klenius collected $15 from pot
*** SUMMARY ***
Total pot $15 | Rake $0 
Seat 1: Scarface.VLT folded before Flop (didn't bet)
Seat 2: patapong (button) folded before Flop (didn't bet)
Seat 3: elvn89 (small blind) folded before Flop
Seat 4: vivecrew (big blind) folded before Flop
Seat 5: klenius collected ($15)
Seat 6: barrao folded before Flop (didn't bet)


PokerStars Game #102605683928:  Hold'em No Limit ($3/$6 USD) - 2013/08/11 10:11:36 ET
Table 'Lorcia IV 40-100 bb' 6-max Seat #3 is the button
Seat 1: Scarface.VLT ($1800.05 in chips) 
Seat 2: patapong ($887.50 in chips) 
Seat 3: elvn89 ($208.98 in chips) 
Seat 4: vivecrew ($602.21 in chips) 
Seat 5: klenius ($617.67 in chips) 
Seat 6: barrao ($538.27 in chips) 
vivecrew: posts small blind $3
klenius: posts big blind $6
*** HOLE CARDS ***
barrao: folds 
Scarface.VLT: folds 
patapong: folds 
elvn89: raises $7.02 to $13.02
vivecrew: folds 
klenius: folds 
Uncalled bet ($7.02) returned to elvn89
elvn89 collected $15 from pot
*** SUMMARY ***
Total pot $15 | Rake $0 
Seat 1: Scarface.VLT folded before Flop (didn't bet)
Seat 2: patapong folded before Flop (didn't bet)
Seat 3: elvn89 (button) collected ($15)
Seat 4: vivecrew (small blind) folded before Flop
Seat 5: klenius (big blind) folded before Flop
Seat 6: barrao folded before Flop (didn't bet)


PokerStars Game #102605701965:  Hold'em No Limit ($3/$6 USD) - 2013/08/11 10:12:01 ET
Table 'Lorcia IV 40-100 bb' 6-max Seat #4 is the button
Seat 1: Scarface.VLT ($1800.05 in chips) 
Seat 2: patapong ($887.50 in chips) 
Seat 3: elvn89 ($217.98 in chips) 
Seat 4: vivecrew ($599.21 in chips) 
Seat 5: klenius ($611.67 in chips) 
Seat 6: barrao ($538.27 in chips) 
klenius: posts small blind $3
barrao: posts big blind $6
*** HOLE CARDS ***
Scarface.VLT: raises $12 to $18
patapong: folds 
elvn89: folds 
vivecrew: folds 
klenius: raises $30 to $48
barrao: folds 
Scarface.VLT: calls $30
*** FLOP *** [Td Jc As]
klenius: bets $66
Scarface.VLT: folds 
Uncalled bet ($66) returned to klenius
klenius collected $99.20 from pot
*** SUMMARY ***
Total pot $102 | Rake $2.80 
Board [Td Jc As]
Seat 1: Scarface.VLT folded on the Flop
Seat 2: patapong folded before Flop (didn't bet)
Seat 3: elvn89 folded before Flop (didn't bet)
Seat 4: vivecrew (button) folded before Flop (didn't bet)
Seat 5: klenius (small blind) collected ($99.20)
Seat 6: barrao (big blind) folded before Flop


PokerStars Game #102605756618:  Hold'em No Limit ($3/$6 USD) - 2013/08/11 10:13:16 ET
Table 'Lorcia IV 40-100 bb' 6-max Seat #5 is the button
Seat 1: Scarface.VLT ($1752.05 in chips) 
Seat 3: elvn89 ($217.98 in chips) 
Seat 4: vivecrew ($599.21 in chips) 
Seat 5: klenius ($662.87 in chips) 
Seat 6: barrao ($532.27 in chips) 
barrao: posts small blind $3
Scarface.VLT: posts big blind $6
*** HOLE CARDS ***
patapong is disconnected 
elvn89: folds 
vivecrew: folds 
klenius: raises $6 to $12
barrao: folds 
Scarface.VLT: calls $6
*** FLOP *** [Kh 9d 5s]
Scarface.VLT: checks 
klenius: bets $18
Scarface.VLT: calls $18
*** TURN *** [Kh 9d 5s] [8d]
Scarface.VLT: checks 
klenius: bets $54
Scarface.VLT: calls $54
*** RIVER *** [Kh 9d 5s 8d] [5c]
Scarface.VLT: checks 
klenius: checks 
*** SHOW DOWN ***
Scarface.VLT: shows [Th Ks] (two pair, Kings and Fives)
klenius: mucks hand 
Scarface.VLT collected $168.20 from pot
*** SUMMARY ***
Total pot $171 | Rake $2.80 
Board [Kh 9d 5s 8d 5c]
Seat 1: Scarface.VLT (big blind) showed [Th Ks] and won ($168.20) with two pair, Kings and Fives
Seat 3: elvn89 folded before Flop (didn't bet)
Seat 4: vivecrew folded before Flop (didn't bet)
Seat 5: klenius (button) mucked
Seat 6: barrao (small blind) folded before Flop


PokerStars Game #102605805216:  Hold'em No Limit ($3/$6 USD) - 2013/08/11 10:14:23 ET
Table 'Lorcia IV 40-100 bb' 6-max Seat #6 is the button
Seat 1: Scarface.VLT ($1836.25 in chips) 
Seat 3: elvn89 ($217.98 in chips) 
Seat 4: vivecrew ($599.21 in chips) 
Seat 5: klenius ($578.87 in chips) 
Seat 6: barrao ($529.27 in chips) 
Scarface.VLT: posts small blind $3
elvn89: posts big blind $6
*** HOLE CARDS ***
vivecrew: raises $6.36 to $12.36
klenius: raises $41.64 to $54
barrao: folds 
Scarface.VLT: folds 
elvn89: folds 
vivecrew: raises $545.21 to $599.21 and is all-in
klenius: calls $524.87 and is all-in
Uncalled bet ($20.34) returned to vivecrew
*** FLOP *** [2s Ks Td]
*** TURN *** [2s Ks Td] [5c]
*** RIVER *** [2s Ks Td 5c] [4c]
*** SHOW DOWN ***
vivecrew: shows [Qc Qh] (a pair of Queens)
klenius: shows [Jd Jh] (a pair of Jacks)
vivecrew collected $1163.94 from pot
*** SUMMARY ***
Total pot $1166.74 | Rake $2.80 
Board [2s Ks Td 5c 4c]
Seat 1: Scarface.VLT (small blind) folded before Flop
Seat 3: elvn89 (big blind) folded before Flop
Seat 4: vivecrew showed [Qc Qh] and won ($1163.94) with a pair of Queens
Seat 5: klenius showed [Jd Jh] and lost with a pair of Jacks
Seat 6: barrao (button) folded before Flop (didn't bet)


PokerStars Game #102605828872:  Hold'em No Limit ($3/$6 USD) - 2013/08/11 10:14:55 ET
Table 'Lorcia IV 40-100 bb' 6-max Seat #1 is the button
Seat 1: Scarface.VLT ($1833.25 in chips) 
Seat 3: elvn89 ($211.98 in chips) 
Seat 4: vivecrew ($1184.28 in chips) 
Seat 6: barrao ($529.27 in chips) 
elvn89: posts small blind $3
vivecrew: posts big blind $6
*** HOLE CARDS ***
barrao: folds 
klenius leaves the table
dRobespierre joins the table at seat #5 
Scarface.VLT: folds 
dRobespierre leaves the table
elvn89: raises $7.02 to $13.02
BKA12 joins the table at seat #5 
vivecrew: calls $7.02
*** FLOP *** [Qs 3h Jd]
BKA12 leaves the table
elvn89: checks 
vivecrew: checks 
*** TURN *** [Qs 3h Jd] [Jc]
x_QUIXTAR_x joins the table at seat #5 
elvn89: checks 
vivecrew: bets $16.66
elvn89: folds 
Uncalled bet ($16.66) returned to vivecrew
vivecrew collected $24.87 from pot
*** SUMMARY ***
Total pot $26.04 | Rake $1.17 
Board [Qs 3h Jd Jc]
Seat 1: Scarface.VLT (button) folded before Flop (didn't bet)
Seat 3: elvn89 (small blind) folded on the Turn
Seat 4: vivecrew (big blind) collected ($24.87)
Seat 6: barrao folded before Flop (didn't bet)


PokerStars Game #102605406140:  Hold'em No Limit ($3/$6 USD) - 2013/08/11 10:05:06 ET
Table 'Lorcia IV 40-100 bb' 6-max Seat #1 is the button
Seat 1: Scarface.VLT ($1754.85 in chips) 
Seat 2: patapong ($908.50 in chips) 
Seat 3: elvn89 ($240 in chips) 
Seat 4: vivecrew ($617.21 in chips) 
Seat 5: klenius ($345.22 in chips) 
Seat 6: barrao ($538.27 in chips) 
patapong: posts small blind $3
elvn89: posts big blind $6
*** HOLE CARDS ***
vivecrew: folds 
klenius: folds 
barrao: folds 
Scarface.VLT: raises $6 to $12
patapong: folds 
elvn89: folds 
Uncalled bet ($6) returned to Scarface.VLT
Scarface.VLT collected $15 from pot
Scarface.VLT: doesn't show hand 
*** SUMMARY ***
Total pot $15 | Rake $0 
Seat 1: Scarface.VLT (button) collected ($15)
Seat 2: patapong (small blind) folded before Flop
Seat 3: elvn89 (big blind) folded before Flop
Seat 4: vivecrew folded before Flop (didn't bet)
Seat 5: klenius folded before Flop (didn't bet)
Seat 6: barrao folded before Flop (didn't bet)


PokerStars Game #102605423720:  Hold'em No Limit ($3/$6 USD) - 2013/08/11 10:05:31 ET
Table 'Lorcia IV 40-100 bb' 6-max Seat #2 is the button
Seat 1: Scarface.VLT ($1763.85 in chips) 
Seat 2: patapong ($905.50 in chips) 
Seat 3: elvn89 ($234 in chips) 
Seat 4: vivecrew ($617.21 in chips) 
Seat 5: klenius ($600 in chips) 
Seat 6: barrao ($538.27 in chips) 
elvn89: posts small blind $3
vivecrew: posts big blind $6
*** HOLE CARDS ***
klenius: raises $6 to $12
barrao: folds 
Scarface.VLT: folds 
patapong: folds 
elvn89: folds 
vivecrew: folds 
Uncalled bet ($6) returned to klenius
klenius collected $15 from pot
*** SUMMARY ***
Total pot $15 | Rake $0 
Seat 1: Scarface.VLT folded before Flop (didn't bet)
Seat 2: patapong (button) folded before Flop (didn't bet)
Seat 3: elvn89 (small blind) folded before Flop
Seat 4: vivecrew (big blind) folded before Flop
Seat 5: klenius collected ($15)
Seat 6: barrao folded before Flop (didn't bet)


PokerStars Game #102605453969:  Hold'em No Limit ($3/$6 USD) - 2013/08/11 10:06:14 ET
Table 'Lorcia IV 40-100 bb' 6-max Seat #3 is the button
Seat 1: Scarface.VLT ($1763.85 in chips) 
Seat 2: patapong ($905.50 in chips) 
Seat 3: elvn89 ($231 in chips) 
Seat 4: vivecrew ($611.21 in chips) 
Seat 5: klenius ($609 in chips) 
Seat 6: barrao ($538.27 in chips) 
vivecrew: posts small blind $3
klenius: posts big blind $6
*** HOLE CARDS ***
barrao: folds 
Scarface.VLT: folds 
patapong: folds 
elvn89: raises $7.02 to $13.02
vivecrew: folds 
klenius: raises $28.98 to $42
elvn89: folds 
Uncalled bet ($28.98) returned to klenius
klenius collected $29.04 from pot
*** SUMMARY ***
Total pot $29.04 | Rake $0 
Seat 1: Scarface.VLT folded before Flop (didn't bet)
Seat 2: patapong folded before Flop (didn't bet)
Seat 3: elvn89 (button) folded before Flop
Seat 4: vivecrew (small blind) folded before Flop
Seat 5: klenius (big blind) collected ($29.04)
Seat 6: barrao folded before Flop (didn't bet)


PokerStars Game #102605479510:  Hold'em No Limit ($3/$6 USD) - 2013/08/11 10:06:50 ET
Table 'Lorcia IV 40-100 bb' 6-max Seat #4 is the button
Seat 1: Scarface.VLT ($1763.85 in chips) 
Seat 2: patapong ($905.50 in chips) 
Seat 3: elvn89 ($217.98 in chips) 
Seat 4: vivecrew ($608.21 in chips) 
Seat 5: klenius ($625.02 in chips) 
Seat 6: barrao ($538.27 in chips) 
klenius: posts small blind $3
barrao: posts big blind $6
*** HOLE CARDS ***
Scarface.VLT: raises $12 to $18
patapong: folds 
elvn89: folds 
vivecrew has timed out
vivecrew: folds 
klenius: folds 
barrao: folds 
Uncalled bet ($12) returned to Scarface.VLT
Scarface.VLT collected $15 from pot
Scarface.VLT: doesn't show hand 
*** SUMMARY ***
Total pot $15 | Rake $0 
Seat 1: Scarface.VLT collected ($15)
Seat 2: patapong folded before Flop (didn't bet)
Seat 3: elvn89 folded before Flop (didn't bet)
Seat 4: vivecrew (button) folded before Flop (didn't bet)
Seat 5: klenius (small blind) folded before Flop
Seat 6: barrao (big blind) folded before Flop


PokerStars Game #102605523995:  Hold'em No Limit ($3/$6 USD) - 2013/08/11 10:07:52 ET
Table 'Lorcia IV 40-100 bb' 6-max Seat #5 is the button
Seat 1: Scarface.VLT ($1772.85 in chips) 
Seat 2: patapong ($905.50 in chips) 
Seat 3: elvn89 ($217.98 in chips) 
Seat 4: vivecrew ($608.21 in chips) 
Seat 5: klenius ($622.02 in chips) 
Seat 6: barrao ($532.27 in chips) 
barrao: posts small blind $3
Scarface.VLT: posts big blind $6
*** HOLE CARDS ***
patapong: folds 
elvn89: folds 
vivecrew: folds 
klenius: raises $6 to $12
barrao: folds 
Scarface.VLT: calls $6
*** FLOP *** [9d Jh 9h]
Scarface.VLT: checks 
klenius: bets $18
Scarface.VLT: calls $18
*** TURN *** [9d Jh 9h] [2c]
Scarface.VLT: checks 
klenius: checks 
*** RIVER *** [9d Jh 9h 2c] [Ks]
Scarface.VLT: checks 
klenius: checks 
*** SHOW DOWN ***
Scarface.VLT: shows [Jc 7h] (two pair, Jacks and Nines)
klenius: mucks hand 
Scarface.VLT collected $60.20 from pot
*** SUMMARY ***
Total pot $63 | Rake $2.80 
Board [9d Jh 9h 2c Ks]
Seat 1: Scarface.VLT (big blind) showed [Jc 7h] and won ($60.20) with two pair, Jacks and Nines
Seat 2: patapong folded before Flop (didn't bet)
Seat 3: elvn89 folded before Flop (didn't bet)
Seat 4: vivecrew folded before Flop (didn't bet)
Seat 5: klenius (button) mucked
Seat 6: barrao (small blind) folded before Flop


PokerStars Game #102605570999:  Hold'em No Limit ($3/$6 USD) - 2013/08/11 10:08:58 ET
Table 'Lorcia IV 40-100 bb' 6-max Seat #6 is the button
Seat 1: Scarface.VLT ($1803.05 in chips) 
Seat 2: patapong ($905.50 in chips) 
Seat 3: elvn89 ($217.98 in chips) 
Seat 4: vivecrew ($608.21 in chips) 
Seat 5: klenius ($592.02 in chips) 
Seat 6: barrao ($529.27 in chips) 
Scarface.VLT: posts small blind $3
patapong: posts big blind $6
*** HOLE CARDS ***
elvn89: folds 
vivecrew: folds 
klenius: folds 
barrao: raises $6 to $12
Scarface.VLT: folds 
patapong: folds 
Uncalled bet ($6) returned to barrao
barrao collected $15 from pot
barrao: doesn't show hand 
*** SUMMARY ***
Total pot $15 | Rake $0 
Seat 1: Scarface.VLT (small blind) folded before Flop
Seat 2: patapong (big blind) folded before Flop
Seat 3: elvn89 folded before Flop (didn't bet)
Seat 4: vivecrew folded before Flop (didn't bet)
Seat 5: klenius folded before Flop (didn't bet)
Seat 6: barrao (button) collected ($15)


PokerStars Game #102605600139:  Hold'em No Limit ($3/$6 USD) - 2013/08/11 10:09:39 ET
Table 'Lorcia IV 40-100 bb' 6-max Seat #1 is the button
Seat 1: Scarface.VLT ($1800.05 in chips) 
Seat 2: patapong ($899.50 in chips) 
Seat 3: elvn89 ($217.98 in chips) 
Seat 4: vivecrew ($608.21 in chips) 
Seat 5: klenius ($592.02 in chips) 
Seat 6: barrao ($538.27 in chips) 
patapong: posts small blind $3
elvn89: posts big blind $6
*** HOLE CARDS ***
vivecrew: folds 
klenius: raises $6 to $12
barrao: folds 
Scarface.VLT: folds 
patapong: calls $9
elvn89: folds 
*** FLOP *** [Kd Qc 4h]
patapong: checks 
klenius: checks 
*** TURN *** [Kd Qc 4h] [3h]
patapong: checks 
klenius: checks 
*** RIVER *** [Kd Qc 4h 3h] [4s]
patapong: checks 
klenius: checks 
*** SHOW DOWN ***
patapong: shows [2c 2h] (two pair, Fours and Deuces)
klenius: shows [5s 5h] (two pair, Fives and Fours)
klenius collected $28.65 from pot
*** SUMMARY ***
Total pot $30 | Rake $1.35 
Board [Kd Qc 4h 3h 4s]
Seat 1: Scarface.VLT (button) folded before Flop (didn't bet)
Seat 2: patapong (small blind) showed [2c 2h] and lost with two pair, Fours and Deuces
Seat 3: elvn89 (big blind) folded before Flop
Seat 4: vivecrew folded before Flop (didn't bet)
Seat 5: klenius showed [5s 5h] and won ($28.65) with two pair, Fives and Fours
Seat 6: barrao folded before Flop (didn't bet)
