

PokerStars Game #102595145276:  Hold'em No Limit ($3/$6 USD) - 2013/08/11 3:50:15 ET
Table 'Dnoces II 40-100 bb' 6-max Seat #5 is the button
Seat 2: king10clubs ($600 in chips) 
Seat 5: vjxbkf ($623 in chips) 
vjxbkf: posts small blind $3
king10clubs: posts big blind $6
*** HOLE CARDS ***
vjxbkf: raises $6 to $12
king10clubs: folds 
Uncalled bet ($6) returned to vjxbkf
vjxbkf collected $12 from pot
vjxbkf: doesn't show hand 
*** SUMMARY ***
Total pot $12 | Rake $0 
Seat 2: king10clubs (big blind) folded before Flop
Seat 5: vjxbkf (button) (small blind) collected ($12)


PokerStars Game #102595150644:  Hold'em No Limit ($3/$6 USD) - 2013/08/11 3:50:31 ET
Table 'Dnoces II 40-100 bb' 6-max Seat #2 is the button
Seat 2: king10clubs ($600 in chips) 
Seat 5: vjxbkf ($629 in chips) 
king10clubs: posts small blind $3
vjxbkf: posts big blind $6
*** HOLE CARDS ***
king10clubs: raises $6 to $12
vjxbkf: folds 
Uncalled bet ($6) returned to king10clubs
king10clubs collected $12 from pot
king10clubs: doesn't show hand 
*** SUMMARY ***
Total pot $12 | Rake $0 
Seat 2: king10clubs (button) (small blind) collected ($12)
Seat 5: vjxbkf (big blind) folded before Flop


PokerStars Game #102595153443:  Hold'em No Limit ($3/$6 USD) - 2013/08/11 3:50:39 ET
Table 'Dnoces II 40-100 bb' 6-max Seat #5 is the button
Seat 2: king10clubs ($606 in chips) 
Seat 5: vjxbkf ($623 in chips) 
vjxbkf: posts small blind $3
king10clubs: posts big blind $6
*** HOLE CARDS ***
vjxbkf: raises $6 to $12
king10clubs: raises $30 to $42
vjxbkf: folds 
Uncalled bet ($30) returned to king10clubs
king10clubs collected $24 from pot
king10clubs: doesn't show hand 
*** SUMMARY ***
Total pot $24 | Rake $0 
Seat 2: king10clubs (big blind) collected ($24)
Seat 5: vjxbkf (button) (small blind) folded before Flop


PokerStars Game #102595162706:  Hold'em No Limit ($3/$6 USD) - 2013/08/11 3:51:05 ET
Table 'Dnoces II 40-100 bb' 6-max Seat #2 is the button
Seat 2: king10clubs ($618 in chips) 
Seat 5: vjxbkf ($611 in chips) 
king10clubs: posts small blind $3
vjxbkf: posts big blind $6
*** HOLE CARDS ***
king10clubs: raises $6 to $12
vjxbkf: folds 
Uncalled bet ($6) returned to king10clubs
king10clubs collected $12 from pot
*** SUMMARY ***
Total pot $12 | Rake $0 
Seat 2: king10clubs (button) (small blind) collected ($12)
Seat 5: vjxbkf (big blind) folded before Flop


PokerStars Game #102595167004:  Hold'em No Limit ($3/$6 USD) - 2013/08/11 3:51:17 ET
Table 'Dnoces II 40-100 bb' 6-max Seat #5 is the button
Seat 2: king10clubs ($624 in chips) 
Seat 5: vjxbkf ($605 in chips) 
vjxbkf: posts small blind $3
king10clubs: posts big blind $6
*** HOLE CARDS ***
vjxbkf: raises $6 to $12
king10clubs: calls $6
*** FLOP *** [6c As 7d]
king10clubs: checks 
vjxbkf: bets $15
king10clubs: calls $15
*** TURN *** [6c As 7d] [Td]
king10clubs: checks 
vjxbkf: checks 
*** RIVER *** [6c As 7d Td] [6s]
king10clubs: checks 
vjxbkf: checks 
*** SHOW DOWN ***
king10clubs: shows [Ah 8h] (two pair, Aces and Sixes)
vjxbkf: mucks hand 
king10clubs collected $53.50 from pot
*** SUMMARY ***
Total pot $54 | Rake $0.50 
Board [6c As 7d Td 6s]
Seat 2: king10clubs (big blind) showed [Ah 8h] and won ($53.50) with two pair, Aces and Sixes
Seat 5: vjxbkf (button) (small blind) mucked


PokerStars Game #102595187735:  Hold'em No Limit ($3/$6 USD) - 2013/08/11 3:52:16 ET
Table 'Dnoces II 40-100 bb' 6-max Seat #2 is the button
Seat 2: king10clubs ($650.50 in chips) 
Seat 5: vjxbkf ($600 in chips) 
king10clubs: posts small blind $3
vjxbkf: posts big blind $6
*** HOLE CARDS ***
king10clubs: raises $6 to $12
vjxbkf: folds 
Uncalled bet ($6) returned to king10clubs
king10clubs collected $12 from pot
king10clubs: doesn't show hand 
*** SUMMARY ***
Total pot $12 | Rake $0 
Seat 2: king10clubs (button) (small blind) collected ($12)
Seat 5: vjxbkf (big blind) folded before Flop


PokerStars Game #102595192554:  Hold'em No Limit ($3/$6 USD) - 2013/08/11 3:52:30 ET
Table 'Dnoces II 40-100 bb' 6-max Seat #5 is the button
Seat 2: king10clubs ($656.50 in chips) 
Seat 5: vjxbkf ($600 in chips) 
vjxbkf: posts small blind $3
king10clubs: posts big blind $6
*** HOLE CARDS ***
vjxbkf: raises $6 to $12
king10clubs: calls $6
*** FLOP *** [Ts 7c Qd]
king10clubs: checks 
vjxbkf: checks 
*** TURN *** [Ts 7c Qd] [5d]
king10clubs: checks 
vjxbkf: checks 
*** RIVER *** [Ts 7c Qd 5d] [Jd]
king10clubs: checks 
vjxbkf: checks 
*** SHOW DOWN ***
king10clubs: shows [9h 7s] (a pair of Sevens)
vjxbkf: mucks hand 
king10clubs collected $23.50 from pot
*** SUMMARY ***
Total pot $24 | Rake $0.50 
Board [Ts 7c Qd 5d Jd]
Seat 2: king10clubs (big blind) showed [9h 7s] and won ($23.50) with a pair of Sevens
Seat 5: vjxbkf (button) (small blind) mucked


PokerStars Game #102595213941:  Hold'em No Limit ($3/$6 USD) - 2013/08/11 3:53:30 ET
Table 'Dnoces II 40-100 bb' 6-max Seat #2 is the button
Seat 2: king10clubs ($668 in chips) 
Seat 5: vjxbkf ($600 in chips) 
king10clubs: posts small blind $3
vjxbkf: posts big blind $6
*** HOLE CARDS ***
king10clubs: raises $6 to $12
vjxbkf: raises $30 to $42
king10clubs: calls $30
*** FLOP *** [9c 5d Ad]
vjxbkf: bets $66
king10clubs: calls $66
*** TURN *** [9c 5d Ad] [Qc]
vjxbkf: bets $132
king10clubs: calls $132
*** RIVER *** [9c 5d Ad Qc] [Kh]
vjxbkf: checks 
king10clubs: checks 
*** SHOW DOWN ***
vjxbkf: shows [Qh Jh] (a pair of Queens)
king10clubs: shows [Ah 7h] (a pair of Aces)
king10clubs collected $479.50 from pot
*** SUMMARY ***
Total pot $480 | Rake $0.50 
Board [9c 5d Ad Qc Kh]
Seat 2: king10clubs (button) (small blind) showed [Ah 7h] and won ($479.50) with a pair of Aces
Seat 5: vjxbkf (big blind) showed [Qh Jh] and lost with a pair of Queens


PokerStars Game #102595092069:  Hold'em No Limit ($3/$6 USD) - 2013/08/11 3:47:43 ET
Table 'Dnoces II 40-100 bb' 6-max Seat #2 is the button
Seat 2: king10clubs ($600 in chips) 
Seat 5: vjxbkf ($600 in chips) 
king10clubs: posts small blind $3
vjxbkf: posts big blind $6
*** HOLE CARDS ***
king10clubs: raises $6 to $12
vjxbkf: folds 
Uncalled bet ($6) returned to king10clubs
king10clubs collected $12 from pot
king10clubs: doesn't show hand 
*** SUMMARY ***
Total pot $12 | Rake $0 
Seat 2: king10clubs (button) (small blind) collected ($12)
Seat 5: vjxbkf (big blind) folded before Flop


PokerStars Game #102595097933:  Hold'em No Limit ($3/$6 USD) - 2013/08/11 3:48:00 ET
Table 'Dnoces II 40-100 bb' 6-max Seat #5 is the button
Seat 2: king10clubs ($606 in chips) 
Seat 5: vjxbkf ($600 in chips) 
vjxbkf: posts small blind $3
king10clubs: posts big blind $6
*** HOLE CARDS ***
vjxbkf: raises $6 to $12
king10clubs: calls $6
*** FLOP *** [Js Ah 8h]
king10clubs: checks 
vjxbkf: bets $15
king10clubs: folds 
Uncalled bet ($15) returned to vjxbkf
vjxbkf collected $23.50 from pot
vjxbkf: doesn't show hand 
*** SUMMARY ***
Total pot $24 | Rake $0.50 
Board [Js Ah 8h]
Seat 2: king10clubs (big blind) folded on the Flop
Seat 5: vjxbkf (button) (small blind) collected ($23.50)


PokerStars Game #102595110722:  Hold'em No Limit ($3/$6 USD) - 2013/08/11 3:48:37 ET
Table 'Dnoces II 40-100 bb' 6-max Seat #2 is the button
Seat 2: king10clubs ($600 in chips) 
Seat 5: vjxbkf ($611.50 in chips) 
king10clubs: posts small blind $3
vjxbkf: posts big blind $6
*** HOLE CARDS ***
king10clubs: raises $6 to $12
vjxbkf: calls $6
*** FLOP *** [As 2c Th]
vjxbkf: checks 
king10clubs: checks 
*** TURN *** [As 2c Th] [4h]
vjxbkf: bets $18
king10clubs: folds 
Uncalled bet ($18) returned to vjxbkf
vjxbkf collected $23.50 from pot
vjxbkf: doesn't show hand 
*** SUMMARY ***
Total pot $24 | Rake $0.50 
Board [As 2c Th 4h]
Seat 2: king10clubs (button) (small blind) folded on the Turn
Seat 5: vjxbkf (big blind) collected ($23.50)


PokerStars Game #102595126119:  Hold'em No Limit ($3/$6 USD) - 2013/08/11 3:49:21 ET
Table 'Dnoces II 40-100 bb' 6-max Seat #5 is the button
Seat 2: king10clubs ($600 in chips) 
Seat 5: vjxbkf ($623 in chips) 
vjxbkf: posts small blind $3
king10clubs: posts big blind $6
*** HOLE CARDS ***
vjxbkf: raises $6 to $12
king10clubs: raises $30 to $42
vjxbkf: folds 
Uncalled bet ($30) returned to king10clubs
king10clubs collected $24 from pot
king10clubs: doesn't show hand 
*** SUMMARY ***
Total pot $24 | Rake $0 
Seat 2: king10clubs (big blind) collected ($24)
Seat 5: vjxbkf (button) (small blind) folded before Flop


PokerStars Game #102595137703:  Hold'em No Limit ($3/$6 USD) - 2013/08/11 3:49:54 ET
Table 'Dnoces II 40-100 bb' 6-max Seat #2 is the button
Seat 2: king10clubs ($612 in chips) 
Seat 5: vjxbkf ($611 in chips) 
king10clubs: posts small blind $3
vjxbkf: posts big blind $6
*** HOLE CARDS ***
king10clubs: raises $6 to $12
vjxbkf: raises $30 to $42
king10clubs: folds 
Uncalled bet ($30) returned to vjxbkf
vjxbkf collected $24 from pot
vjxbkf: doesn't show hand 
*** SUMMARY ***
Total pot $24 | Rake $0 
Seat 2: king10clubs (button) (small blind) folded before Flop
Seat 5: vjxbkf (big blind) collected ($24)


PokerStars Game #102595560815:  Hold'em No Limit ($3/$6 USD) - 2013/08/11 4:10:06 ET
Table 'Dnoces II 40-100 bb' 6-max Seat #5 is the button
Seat 2: king10clubs ($1100 in chips) 
Seat 5: vjxbkf ($600 in chips) 
vjxbkf: posts small blind $3
king10clubs: posts big blind $6
*** HOLE CARDS ***
vjxbkf: raises $6 to $12
king10clubs: folds 
Uncalled bet ($6) returned to vjxbkf
vjxbkf collected $12 from pot
vjxbkf: doesn't show hand 
*** SUMMARY ***
Total pot $12 | Rake $0 
Seat 2: king10clubs (big blind) folded before Flop
Seat 5: vjxbkf (button) (small blind) collected ($12)


PokerStars Game #102595564628:  Hold'em No Limit ($3/$6 USD) - 2013/08/11 4:10:17 ET
Table 'Dnoces II 40-100 bb' 6-max Seat #2 is the button
Seat 2: king10clubs ($1094 in chips) 
Seat 5: vjxbkf ($606 in chips) 
king10clubs: posts small blind $3
vjxbkf: posts big blind $6
*** HOLE CARDS ***
king10clubs: raises $6 to $12
vjxbkf: raises $30 to $42
king10clubs: raises $54 to $96
vjxbkf: calls $54
*** FLOP *** [8d Kc Ts]
vjxbkf: bets $117
king10clubs: calls $117
*** TURN *** [8d Kc Ts] [Ah]
vjxbkf: bets $393 and is all-in
king10clubs: calls $393
*** RIVER *** [8d Kc Ts Ah] [6s]
*** SHOW DOWN ***
vjxbkf: shows [Qh As] (a pair of Aces)
king10clubs: shows [Kh Ac] (two pair, Aces and Kings)
king10clubs collected $1211.50 from pot
*** SUMMARY ***
Total pot $1212 | Rake $0.50 
Board [8d Kc Ts Ah 6s]
Seat 2: king10clubs (button) (small blind) showed [Kh Ac] and won ($1211.50) with two pair, Aces and Kings
Seat 5: vjxbkf (big blind) showed [Qh As] and lost with a pair of Aces


PokerStars Game #102595604561:  Hold'em No Limit ($3/$6 USD) - 2013/08/11 4:12:09 ET
Table 'Dnoces II 40-100 bb' 6-max Seat #5 is the button
Seat 2: king10clubs ($1699.50 in chips) 
Seat 5: vjxbkf ($600 in chips) 
vjxbkf: posts small blind $3
king10clubs: posts big blind $6
*** HOLE CARDS ***
vjxbkf: raises $6 to $12
king10clubs: calls $6
*** FLOP *** [5c Tc 5h]
king10clubs: checks 
vjxbkf: bets $15
king10clubs: calls $15
*** TURN *** [5c Tc 5h] [Ah]
king10clubs: checks 
vjxbkf: bets $36
king10clubs: calls $36
*** RIVER *** [5c Tc 5h Ah] [Kd]
king10clubs: checks 
vjxbkf: checks 
*** SHOW DOWN ***
king10clubs: shows [Td 9s] (two pair, Tens and Fives)
vjxbkf: shows [Jd Ks] (two pair, Kings and Fives)
vjxbkf collected $125.50 from pot
*** SUMMARY ***
Total pot $126 | Rake $0.50 
Board [5c Tc 5h Ah Kd]
Seat 2: king10clubs (big blind) showed [Td 9s] and lost with two pair, Tens and Fives
Seat 5: vjxbkf (button) (small blind) showed [Jd Ks] and won ($125.50) with two pair, Kings and Fives


PokerStars Game #102595637183:  Hold'em No Limit ($3/$6 USD) - 2013/08/11 4:13:41 ET
Table 'Dnoces II 40-100 bb' 6-max Seat #2 is the button
Seat 2: king10clubs ($1636.50 in chips) 
Seat 5: vjxbkf ($662.50 in chips) 
king10clubs: posts small blind $3
vjxbkf: posts big blind $6
*** HOLE CARDS ***
king10clubs: raises $6 to $12
vjxbkf: folds 
Uncalled bet ($6) returned to king10clubs
king10clubs collected $12 from pot
king10clubs: doesn't show hand 
*** SUMMARY ***
Total pot $12 | Rake $0 
Seat 2: king10clubs (button) (small blind) collected ($12)
Seat 5: vjxbkf (big blind) folded before Flop


PokerStars Game #102595644919:  Hold'em No Limit ($3/$6 USD) - 2013/08/11 4:14:03 ET
Table 'Dnoces II 40-100 bb' 6-max Seat #5 is the button
Seat 2: king10clubs ($1642.50 in chips) 
Seat 5: vjxbkf ($656.50 in chips) 
vjxbkf: posts small blind $3
king10clubs: posts big blind $6
*** HOLE CARDS ***
vjxbkf: raises $6 to $12
king10clubs: folds 
Uncalled bet ($6) returned to vjxbkf
vjxbkf collected $12 from pot
vjxbkf: doesn't show hand 
*** SUMMARY ***
Total pot $12 | Rake $0 
Seat 2: king10clubs (big blind) folded before Flop
Seat 5: vjxbkf (button) (small blind) collected ($12)


PokerStars Game #102595648814:  Hold'em No Limit ($3/$6 USD) - 2013/08/11 4:14:14 ET
Table 'Dnoces II 40-100 bb' 6-max Seat #2 is the button
Seat 2: king10clubs ($1636.50 in chips) 
Seat 5: vjxbkf ($662.50 in chips) 
king10clubs: posts small blind $3
vjxbkf: posts big blind $6
*** HOLE CARDS ***
king10clubs: raises $6 to $12
vjxbkf: folds 
Uncalled bet ($6) returned to king10clubs
king10clubs collected $12 from pot
king10clubs: doesn't show hand 
*** SUMMARY ***
Total pot $12 | Rake $0 
Seat 2: king10clubs (button) (small blind) collected ($12)
Seat 5: vjxbkf (big blind) folded before Flop


PokerStars Game #102595655768:  Hold'em No Limit ($3/$6 USD) - 2013/08/11 4:14:33 ET
Table 'Dnoces II 40-100 bb' 6-max Seat #5 is the button
Seat 2: king10clubs ($1642.50 in chips) 
Seat 5: vjxbkf ($656.50 in chips) 
vjxbkf: posts small blind $3
king10clubs: posts big blind $6
*** HOLE CARDS ***
vjxbkf: raises $6 to $12
king10clubs: folds 
Uncalled bet ($6) returned to vjxbkf
vjxbkf collected $12 from pot
vjxbkf: doesn't show hand 
*** SUMMARY ***
Total pot $12 | Rake $0 
Seat 2: king10clubs (big blind) folded before Flop
Seat 5: vjxbkf (button) (small blind) collected ($12)


PokerStars Game #102595662875:  Hold'em No Limit ($3/$6 USD) - 2013/08/11 4:14:53 ET
Table 'Dnoces II 40-100 bb' 6-max Seat #2 is the button
Seat 2: king10clubs ($1636.50 in chips) 
Seat 5: vjxbkf ($662.50 in chips) 
king10clubs: posts small blind $3
vjxbkf: posts big blind $6
*** HOLE CARDS ***
king10clubs: raises $6 to $12
vjxbkf: calls $6
*** FLOP *** [Ts 6h Ks]
vjxbkf: checks 
king10clubs: bets $15
vjxbkf: raises $30 to $45
king10clubs: folds 
Uncalled bet ($30) returned to vjxbkf
vjxbkf collected $53.50 from pot
vjxbkf: doesn't show hand 
*** SUMMARY ***
Total pot $54 | Rake $0.50 
Board [Ts 6h Ks]
Seat 2: king10clubs (button) (small blind) folded on the Flop
Seat 5: vjxbkf (big blind) collected ($53.50)


PokerStars Game #102595473629:  Hold'em No Limit ($3/$6 USD) - 2013/08/11 4:06:09 ET
Table 'Dnoces II 40-100 bb' 6-max Seat #2 is the button
Seat 2: king10clubs ($771 in chips) 
Seat 5: vjxbkf ($896.50 in chips) 
king10clubs: posts small blind $3
vjxbkf: posts big blind $6
*** HOLE CARDS ***
king10clubs: raises $6 to $12
vjxbkf: raises $33 to $45
king10clubs: calls $33
*** FLOP *** [Qh 2c 5s]
vjxbkf: bets $72
king10clubs: calls $72
*** TURN *** [Qh 2c 5s] [8d]
vjxbkf: bets $162
king10clubs: raises $492 to $654 and is all-in
vjxbkf: folds 
Uncalled bet ($492) returned to king10clubs
king10clubs collected $557.50 from pot
king10clubs: doesn't show hand 
*** SUMMARY ***
Total pot $558 | Rake $0.50 
Board [Qh 2c 5s 8d]
Seat 2: king10clubs (button) (small blind) collected ($557.50)
Seat 5: vjxbkf (big blind) folded on the Turn


PokerStars Game #102595519821:  Hold'em No Limit ($3/$6 USD) - 2013/08/11 4:08:13 ET
Table 'Dnoces II 40-100 bb' 6-max Seat #5 is the button
Seat 2: king10clubs ($1049.50 in chips) 
Seat 5: vjxbkf ($617.50 in chips) 
vjxbkf: posts small blind $3
king10clubs: posts big blind $6
*** HOLE CARDS ***
vjxbkf: raises $6 to $12
king10clubs: folds 
Uncalled bet ($6) returned to vjxbkf
vjxbkf collected $12 from pot
vjxbkf: doesn't show hand 
*** SUMMARY ***
Total pot $12 | Rake $0 
Seat 2: king10clubs (big blind) folded before Flop
Seat 5: vjxbkf (button) (small blind) collected ($12)


PokerStars Game #102595522892:  Hold'em No Limit ($3/$6 USD) - 2013/08/11 4:08:21 ET
Table 'Dnoces II 40-100 bb' 6-max Seat #2 is the button
Seat 2: king10clubs ($1043.50 in chips) 
Seat 5: vjxbkf ($623.50 in chips) 
king10clubs: posts small blind $3
vjxbkf: posts big blind $6
*** HOLE CARDS ***
king10clubs: raises $6 to $12
vjxbkf: calls $6
*** FLOP *** [6s 5c Td]
vjxbkf: checks 
king10clubs: bets $15
vjxbkf: raises $30 to $45
king10clubs: calls $30
*** TURN *** [6s 5c Td] [Ts]
vjxbkf: checks 
king10clubs: bets $60
vjxbkf: folds 
Uncalled bet ($60) returned to king10clubs
king10clubs collected $113.50 from pot
king10clubs: doesn't show hand 
*** SUMMARY ***
Total pot $114 | Rake $0.50 
Board [6s 5c Td Ts]
Seat 2: king10clubs (button) (small blind) collected ($113.50)
Seat 5: vjxbkf (big blind) folded on the Turn


PokerStars Game #102595258176:  Hold'em No Limit ($3/$6 USD) - 2013/08/11 3:55:38 ET
Table 'Dnoces II 40-100 bb' 6-max Seat #5 is the button
Seat 2: king10clubs ($907.50 in chips) 
Seat 5: vjxbkf ($600 in chips) 
vjxbkf: posts small blind $3
king10clubs: posts big blind $6
*** HOLE CARDS ***
vjxbkf: folds 
Uncalled bet ($3) returned to king10clubs
king10clubs collected $6 from pot
king10clubs: doesn't show hand 
*** SUMMARY ***
Total pot $6 | Rake $0 
Seat 2: king10clubs (big blind) collected ($6)
Seat 5: vjxbkf (button) (small blind) folded before Flop


PokerStars Game #102595264091:  Hold'em No Limit ($3/$6 USD) - 2013/08/11 3:55:58 ET
Table 'Dnoces II 40-100 bb' 6-max Seat #2 is the button
Seat 2: king10clubs ($910.50 in chips) 
Seat 5: vjxbkf ($600 in chips) 
king10clubs: posts small blind $3
vjxbkf: posts big blind $6
*** HOLE CARDS ***
king10clubs: raises $6 to $12
vjxbkf: calls $6
*** FLOP *** [9s 6h Ts]
vjxbkf: bets $18
king10clubs: calls $18
*** TURN *** [9s 6h Ts] [4c]
vjxbkf: bets $48
king10clubs: calls $48
*** RIVER *** [9s 6h Ts 4c] [Qh]
vjxbkf: checks 
king10clubs: bets $225
vjxbkf: folds 
Uncalled bet ($225) returned to king10clubs
king10clubs collected $155.50 from pot
king10clubs: doesn't show hand 
*** SUMMARY ***
Total pot $156 | Rake $0.50 
Board [9s 6h Ts 4c Qh]
Seat 2: king10clubs (button) (small blind) collected ($155.50)
Seat 5: vjxbkf (big blind) folded on the River


PokerStars Game #102595304322:  Hold'em No Limit ($3/$6 USD) - 2013/08/11 3:58:12 ET
Table 'Dnoces II 40-100 bb' 6-max Seat #5 is the button
Seat 2: king10clubs ($988 in chips) 
Seat 5: vjxbkf ($600 in chips) 
vjxbkf: posts small blind $3
king10clubs: posts big blind $6
*** HOLE CARDS ***
vjxbkf: raises $6 to $12
king10clubs: folds 
Uncalled bet ($6) returned to vjxbkf
vjxbkf collected $12 from pot
vjxbkf: doesn't show hand 
*** SUMMARY ***
Total pot $12 | Rake $0 
Seat 2: king10clubs (big blind) folded before Flop
Seat 5: vjxbkf (button) (small blind) collected ($12)


PokerStars Game #102595307571:  Hold'em No Limit ($3/$6 USD) - 2013/08/11 3:58:23 ET
Table 'Dnoces II 40-100 bb' 6-max Seat #2 is the button
Seat 2: king10clubs ($982 in chips) 
Seat 5: vjxbkf ($606 in chips) 
king10clubs: posts small blind $3
vjxbkf: posts big blind $6
*** HOLE CARDS ***
king10clubs: raises $6 to $12
vjxbkf: folds 
Uncalled bet ($6) returned to king10clubs
king10clubs collected $12 from pot
king10clubs: doesn't show hand 
*** SUMMARY ***
Total pot $12 | Rake $0 
Seat 2: king10clubs (button) (small blind) collected ($12)
Seat 5: vjxbkf (big blind) folded before Flop


PokerStars Game #102595311685:  Hold'em No Limit ($3/$6 USD) - 2013/08/11 3:58:36 ET
Table 'Dnoces II 40-100 bb' 6-max Seat #5 is the button
Seat 2: king10clubs ($988 in chips) 
Seat 5: vjxbkf ($600 in chips) 
vjxbkf: posts small blind $3
king10clubs: posts big blind $6
*** HOLE CARDS ***
vjxbkf: raises $6 to $12
king10clubs: raises $33 to $45
vjxbkf: calls $33
*** FLOP *** [9h Jd 2c]
king10clubs: bets $54
vjxbkf: folds 
Uncalled bet ($54) returned to king10clubs
king10clubs collected $89.50 from pot
king10clubs: doesn't show hand 
*** SUMMARY ***
Total pot $90 | Rake $0.50 
Board [9h Jd 2c]
Seat 2: king10clubs (big blind) collected ($89.50)
Seat 5: vjxbkf (button) (small blind) folded on the Flop


PokerStars Game #102595329584:  Hold'em No Limit ($3/$6 USD) - 2013/08/11 3:59:36 ET
Table 'Dnoces II 40-100 bb' 6-max Seat #2 is the button
Seat 2: king10clubs ($1032.50 in chips) 
Seat 5: vjxbkf ($600 in chips) 
king10clubs: posts small blind $3
vjxbkf: posts big blind $6
*** HOLE CARDS ***
king10clubs: raises $6 to $12
vjxbkf: folds 
Uncalled bet ($6) returned to king10clubs
king10clubs collected $12 from pot
king10clubs: doesn't show hand 
*** SUMMARY ***
Total pot $12 | Rake $0 
Seat 2: king10clubs (button) (small blind) collected ($12)
Seat 5: vjxbkf (big blind) folded before Flop


PokerStars Game #102595335139:  Hold'em No Limit ($3/$6 USD) - 2013/08/11 3:59:52 ET
Table 'Dnoces II 40-100 bb' 6-max Seat #5 is the button
Seat 2: king10clubs ($1038.50 in chips) 
Seat 5: vjxbkf ($600 in chips) 
vjxbkf: posts small blind $3
king10clubs: posts big blind $6
*** HOLE CARDS ***
vjxbkf: raises $6 to $12
king10clubs: calls $6
*** FLOP *** [Js 8d Ad]
king10clubs: checks 
vjxbkf: bets $15
king10clubs: folds 
Uncalled bet ($15) returned to vjxbkf
vjxbkf collected $23.50 from pot
vjxbkf: doesn't show hand 
*** SUMMARY ***
Total pot $24 | Rake $0.50 
Board [Js 8d Ad]
Seat 2: king10clubs (big blind) folded on the Flop
Seat 5: vjxbkf (button) (small blind) collected ($23.50)


PokerStars Game #102595344656:  Hold'em No Limit ($3/$6 USD) - 2013/08/11 4:00:20 ET
Table 'Dnoces II 40-100 bb' 6-max Seat #2 is the button
Seat 2: king10clubs ($1026.50 in chips) 
Seat 5: vjxbkf ($611.50 in chips) 
king10clubs: posts small blind $3
vjxbkf: posts big blind $6
*** HOLE CARDS ***
king10clubs: raises $6 to $12
vjxbkf: raises $30 to $42
king10clubs: calls $30
*** FLOP *** [6c Kd Kh]
vjxbkf: checks 
king10clubs: bets $50
vjxbkf: folds 
Uncalled bet ($50) returned to king10clubs
king10clubs collected $83.50 from pot
king10clubs: doesn't show hand 
*** SUMMARY ***
Total pot $84 | Rake $0.50 
Board [6c Kd Kh]
Seat 2: king10clubs (button) (small blind) collected ($83.50)
Seat 5: vjxbkf (big blind) folded on the Flop


PokerStars Game #102595366436:  Hold'em No Limit ($3/$6 USD) - 2013/08/11 4:01:23 ET
Table 'Dnoces II 40-100 bb' 6-max Seat #5 is the button
Seat 2: king10clubs ($1068 in chips) 
Seat 5: vjxbkf ($600 in chips) 
vjxbkf: posts small blind $3
king10clubs: posts big blind $6
*** HOLE CARDS ***
vjxbkf: raises $6 to $12
king10clubs: folds 
Uncalled bet ($6) returned to vjxbkf
vjxbkf collected $12 from pot
vjxbkf: doesn't show hand 
*** SUMMARY ***
Total pot $12 | Rake $0 
Seat 2: king10clubs (big blind) folded before Flop
Seat 5: vjxbkf (button) (small blind) collected ($12)


PokerStars Game #102595370703:  Hold'em No Limit ($3/$6 USD) - 2013/08/11 4:01:35 ET
Table 'Dnoces II 40-100 bb' 6-max Seat #2 is the button
Seat 2: king10clubs ($1062 in chips) 
Seat 5: vjxbkf ($606 in chips) 
king10clubs: posts small blind $3
vjxbkf: posts big blind $6
*** HOLE CARDS ***
king10clubs: raises $6 to $12
vjxbkf: raises $30 to $42
king10clubs: folds 
Uncalled bet ($30) returned to vjxbkf
vjxbkf collected $24 from pot
vjxbkf: doesn't show hand 
*** SUMMARY ***
Total pot $24 | Rake $0 
Seat 2: king10clubs (button) (small blind) folded before Flop
Seat 5: vjxbkf (big blind) collected ($24)


PokerStars Game #102595378625:  Hold'em No Limit ($3/$6 USD) - 2013/08/11 4:01:56 ET
Table 'Dnoces II 40-100 bb' 6-max Seat #5 is the button
Seat 2: king10clubs ($1050 in chips) 
Seat 5: vjxbkf ($618 in chips) 
vjxbkf: posts small blind $3
king10clubs: posts big blind $6
*** HOLE CARDS ***
vjxbkf: raises $6 to $12
king10clubs: folds 
Uncalled bet ($6) returned to vjxbkf
vjxbkf collected $12 from pot
vjxbkf: doesn't show hand 
*** SUMMARY ***
Total pot $12 | Rake $0 
Seat 2: king10clubs (big blind) folded before Flop
Seat 5: vjxbkf (button) (small blind) collected ($12)


PokerStars Game #102595385541:  Hold'em No Limit ($3/$6 USD) - 2013/08/11 4:02:14 ET
Table 'Dnoces II 40-100 bb' 6-max Seat #2 is the button
Seat 2: king10clubs ($1044 in chips) 
Seat 5: vjxbkf ($624 in chips) 
king10clubs: posts small blind $3
vjxbkf: posts big blind $6
*** HOLE CARDS ***
king10clubs: raises $6 to $12
vjxbkf: raises $30 to $42
king10clubs: raises $53 to $95
vjxbkf: raises $70 to $165
king10clubs: folds 
Uncalled bet ($70) returned to vjxbkf
vjxbkf collected $190 from pot
vjxbkf: doesn't show hand 
*** SUMMARY ***
Total pot $190 | Rake $0 
Seat 2: king10clubs (button) (small blind) folded before Flop
Seat 5: vjxbkf (big blind) collected ($190)


PokerStars Game #102595410512:  Hold'em No Limit ($3/$6 USD) - 2013/08/11 4:03:21 ET
Table 'Dnoces II 40-100 bb' 6-max Seat #5 is the button
Seat 2: king10clubs ($949 in chips) 
Seat 5: vjxbkf ($719 in chips) 
vjxbkf: posts small blind $3
king10clubs: posts big blind $6
*** HOLE CARDS ***
vjxbkf: raises $6 to $12
king10clubs: raises $36 to $48
vjxbkf: raises $60 to $108
king10clubs: calls $60
*** FLOP *** [2c 8c 5c]
king10clubs: checks 
vjxbkf: bets $70
king10clubs: calls $70
*** TURN *** [2c 8c 5c] [Jc]
king10clubs: checks 
vjxbkf: checks 
*** RIVER *** [2c 8c 5c Jc] [9c]
king10clubs: checks 
vjxbkf: bets $249
king10clubs: folds 
Uncalled bet ($249) returned to vjxbkf
vjxbkf collected $355.50 from pot
vjxbkf: doesn't show hand 
*** SUMMARY ***
Total pot $356 | Rake $0.50 
Board [2c 8c 5c Jc 9c]
Seat 2: king10clubs (big blind) folded on the River
Seat 5: vjxbkf (button) (small blind) collected ($355.50)


PokerStars Game #102595777495:  Hold'em No Limit ($3/$6 USD) - 2013/08/11 4:20:15 ET
Table 'Dnoces II 40-100 bb' 6-max Seat #2 is the button
Seat 2: king10clubs ($1567 in chips) 
Seat 6: SlovakPsycho ($1204.50 in chips) 
king10clubs: posts small blind $3
vjxbkf: is sitting out 
SlovakPsycho: posts big blind $6
*** HOLE CARDS ***
king10clubs: raises $6 to $12
vjxbkf leaves the table
SlovakPsycho: calls $6
*** FLOP *** [6h Jh Jc]
SlovakPsycho: checks 
king10clubs: bets $15
SlovakPsycho: calls $15
*** TURN *** [6h Jh Jc] [Js]
SlovakPsycho: checks 
king10clubs: bets $42
SlovakPsycho: calls $42
*** RIVER *** [6h Jh Jc Js] [Ts]
SlovakPsycho: checks 
king10clubs: checks 
*** SHOW DOWN ***
SlovakPsycho: shows [7d Ac] (three of a kind, Jacks)
king10clubs: shows [7c 6s] (a full house, Jacks full of Sixes)
king10clubs collected $137.50 from pot
*** SUMMARY ***
Total pot $138 | Rake $0.50 
Board [6h Jh Jc Js Ts]
Seat 2: king10clubs (button) (small blind) showed [7c 6s] and won ($137.50) with a full house, Jacks full of Sixes
Seat 6: SlovakPsycho (big blind) showed [7d Ac] and lost with three of a kind, Jacks


PokerStars Game #102595797166:  Hold'em No Limit ($3/$6 USD) - 2013/08/11 4:21:11 ET
Table 'Dnoces II 40-100 bb' 6-max Seat #6 is the button
Seat 2: king10clubs ($1635.50 in chips) 
Seat 6: SlovakPsycho ($1135.50 in chips) 
SlovakPsycho: posts small blind $3
king10clubs: posts big blind $6
*** HOLE CARDS ***
SlovakPsycho: raises $12 to $18
king10clubs: raises $36 to $54
SlovakPsycho: folds 
Uncalled bet ($36) returned to king10clubs
king10clubs collected $36 from pot
king10clubs: doesn't show hand 
*** SUMMARY ***
Total pot $36 | Rake $0 
Seat 2: king10clubs (big blind) collected ($36)
Seat 6: SlovakPsycho (button) (small blind) folded before Flop


PokerStars Game #102595742618:  Hold'em No Limit ($3/$6 USD) - 2013/08/11 4:18:36 ET
Table 'Dnoces II 40-100 bb' 6-max Seat #2 is the button
Seat 2: king10clubs ($1585 in chips) 
Seat 5: vjxbkf ($712.50 in chips) 
Seat 6: SlovakPsycho ($600 in chips) 
vjxbkf: posts small blind $3
SlovakPsycho: posts big blind $6
*** HOLE CARDS ***
king10clubs: raises $6 to $12
vjxbkf: raises $33 to $45
SlovakPsycho: folds 
king10clubs: folds 
Uncalled bet ($33) returned to vjxbkf
vjxbkf collected $30 from pot
vjxbkf: doesn't show hand 
*** SUMMARY ***
Total pot $30 | Rake $0 
Seat 2: king10clubs (button) folded before Flop
Seat 5: vjxbkf (small blind) collected ($30)
Seat 6: SlovakPsycho (big blind) folded before Flop


PokerStars Game #102595753749:  Hold'em No Limit ($3/$6 USD) - 2013/08/11 4:19:08 ET
Table 'Dnoces II 40-100 bb' 6-max Seat #5 is the button
Seat 2: king10clubs ($1573 in chips) 
Seat 5: vjxbkf ($730.50 in chips) 
Seat 6: SlovakPsycho ($600 in chips) 
SlovakPsycho: posts small blind $3
king10clubs: posts big blind $6
*** HOLE CARDS ***
vjxbkf: raises $6 to $12
SlovakPsycho: raises $39 to $51
king10clubs: folds 
vjxbkf: raises $69 to $120
SlovakPsycho: raises $480 to $600 and is all-in
vjxbkf: calls $480
*** FLOP *** [2h 3s 7s]
*** TURN *** [2h 3s 7s] [6d]
*** RIVER *** [2h 3s 7s 6d] [8h]
*** SHOW DOWN ***
SlovakPsycho: shows [5h 5s] (a pair of Fives)
vjxbkf: mucks hand 
SlovakPsycho collected $1204.50 from pot
*** SUMMARY ***
Total pot $1206 | Rake $1.50 
Board [2h 3s 7s 6d 8h]
Seat 2: king10clubs (big blind) folded before Flop
Seat 5: vjxbkf (button) mucked
Seat 6: SlovakPsycho (small blind) showed [5h 5s] and won ($1204.50) with a pair of Fives


PokerStars Game #102595676033:  Hold'em No Limit ($3/$6 USD) - 2013/08/11 4:15:30 ET
Table 'Dnoces II 40-100 bb' 6-max Seat #5 is the button
Seat 2: king10clubs ($1609.50 in chips) 
Seat 5: vjxbkf ($689 in chips) 
vjxbkf: posts small blind $3
king10clubs: posts big blind $6
*** HOLE CARDS ***
vjxbkf: raises $6 to $12
king10clubs: calls $6
*** FLOP *** [5s Qd Kc]
king10clubs: checks 
vjxbkf: bets $15
king10clubs: calls $15
*** TURN *** [5s Qd Kc] [7d]
king10clubs: checks 
vjxbkf: bets $36
king10clubs: calls $36
*** RIVER *** [5s Qd Kc 7d] [7c]
king10clubs: checks 
vjxbkf: checks 
*** SHOW DOWN ***
king10clubs: shows [2d 5d] (two pair, Sevens and Fives)
vjxbkf: mucks hand 
king10clubs collected $125.50 from pot
*** SUMMARY ***
Total pot $126 | Rake $0.50 
Board [5s Qd Kc 7d 7c]
Seat 2: king10clubs (big blind) showed [2d 5d] and won ($125.50) with two pair, Sevens and Fives
Seat 5: vjxbkf (button) (small blind) mucked


PokerStars Game #102595709330:  Hold'em No Limit ($3/$6 USD) - 2013/08/11 4:17:03 ET
Table 'Dnoces II 40-100 bb' 6-max Seat #2 is the button
Seat 2: king10clubs ($1672 in chips) 
Seat 5: vjxbkf ($626 in chips) 
king10clubs: posts small blind $3
vjxbkf: posts big blind $6
*** HOLE CARDS ***
SlovakPsycho joins the table at seat #6 
king10clubs: raises $6 to $12
vjxbkf: raises $30 to $42
king10clubs: calls $30
*** FLOP *** [3s 2d Td]
vjxbkf: checks 
king10clubs: bets $45
vjxbkf: raises $87 to $132
king10clubs: folds 
Uncalled bet ($87) returned to vjxbkf
vjxbkf collected $173.50 from pot
vjxbkf: doesn't show hand 
*** SUMMARY ***
Total pot $174 | Rake $0.50 
Board [3s 2d Td]
Seat 2: king10clubs (button) (small blind) folded on the Flop
Seat 5: vjxbkf (big blind) collected ($173.50)


PokerStars Game #102596198612:  Hold'em No Limit ($3/$6 USD) - 2013/08/11 4:40:14 ET
Table 'Dnoces II 40-100 bb' 6-max Seat #5 is the button
Seat 2: king10clubs ($1712.50 in chips) 
Seat 5: vjxbkf ($600 in chips) 
vjxbkf: posts small blind $3
king10clubs: posts big blind $6
*** HOLE CARDS ***
vjxbkf: raises $6 to $12
king10clubs: folds 
Uncalled bet ($6) returned to vjxbkf
vjxbkf collected $12 from pot
vjxbkf: doesn't show hand 
*** SUMMARY ***
Total pot $12 | Rake $0 
Seat 2: king10clubs (big blind) folded before Flop
Seat 5: vjxbkf (button) (small blind) collected ($12)


PokerStars Game #102596204021:  Hold'em No Limit ($3/$6 USD) - 2013/08/11 4:40:29 ET
Table 'Dnoces II 40-100 bb' 6-max Seat #2 is the button
Seat 2: king10clubs ($1706.50 in chips) 
Seat 5: vjxbkf ($606 in chips) 
king10clubs: posts small blind $3
vjxbkf: posts big blind $6
*** HOLE CARDS ***
king10clubs: raises $6 to $12
vjxbkf: folds 
Uncalled bet ($6) returned to king10clubs
king10clubs collected $12 from pot
king10clubs: doesn't show hand 
*** SUMMARY ***
Total pot $12 | Rake $0 
Seat 2: king10clubs (button) (small blind) collected ($12)
Seat 5: vjxbkf (big blind) folded before Flop


PokerStars Game #102596206749:  Hold'em No Limit ($3/$6 USD) - 2013/08/11 4:40:37 ET
Table 'Dnoces II 40-100 bb' 6-max Seat #5 is the button
Seat 2: king10clubs ($1712.50 in chips) 
Seat 5: vjxbkf ($600 in chips) 
vjxbkf: posts small blind $3
king10clubs: posts big blind $6
*** HOLE CARDS ***
vjxbkf: raises $6 to $12
king10clubs: folds 
Uncalled bet ($6) returned to vjxbkf
vjxbkf collected $12 from pot
vjxbkf: doesn't show hand 
*** SUMMARY ***
Total pot $12 | Rake $0 
Seat 2: king10clubs (big blind) folded before Flop
Seat 5: vjxbkf (button) (small blind) collected ($12)


PokerStars Game #102596211783:  Hold'em No Limit ($3/$6 USD) - 2013/08/11 4:40:51 ET
Table 'Dnoces II 40-100 bb' 6-max Seat #2 is the button
Seat 2: king10clubs ($1706.50 in chips) 
Seat 5: vjxbkf ($606 in chips) 
king10clubs: posts small blind $3
vjxbkf: posts big blind $6
*** HOLE CARDS ***
king10clubs: raises $6 to $12
vjxbkf: raises $30 to $42
king10clubs: calls $30
*** FLOP *** [4d 4s Js]
vjxbkf: bets $66
king10clubs: calls $66
*** TURN *** [4d 4s Js] [2h]
vjxbkf: bets $132
floriiiiider joins the table at seat #6 
floriiiiider leaves the table
king10clubs: calls $132
*** RIVER *** [4d 4s Js 2h] [Ac]
vjxbkf: bets $366 and is all-in
king10clubs: folds 
Uncalled bet ($366) returned to vjxbkf
vjxbkf collected $479.50 from pot
vjxbkf: doesn't show hand 
*** SUMMARY ***
Total pot $480 | Rake $0.50 
Board [4d 4s Js 2h Ac]
Seat 2: king10clubs (button) (small blind) folded on the River
Seat 5: vjxbkf (big blind) collected ($479.50)


PokerStars Game #102596272137:  Hold'em No Limit ($3/$6 USD) - 2013/08/11 4:43:40 ET
Table 'Dnoces II 40-100 bb' 6-max Seat #5 is the button
Seat 2: king10clubs ($1466.50 in chips) 
Seat 5: vjxbkf ($845.50 in chips) 
vjxbkf: posts small blind $3
king10clubs: posts big blind $6
*** HOLE CARDS ***
vjxbkf: raises $6 to $12
king10clubs: folds 
Uncalled bet ($6) returned to vjxbkf
vjxbkf collected $12 from pot
vjxbkf: doesn't show hand 
*** SUMMARY ***
Total pot $12 | Rake $0 
Seat 2: king10clubs (big blind) folded before Flop
Seat 5: vjxbkf (button) (small blind) collected ($12)


PokerStars Game #102596278292:  Hold'em No Limit ($3/$6 USD) - 2013/08/11 4:43:57 ET
Table 'Dnoces II 40-100 bb' 6-max Seat #2 is the button
Seat 2: king10clubs ($1460.50 in chips) 
Seat 5: vjxbkf ($851.50 in chips) 
king10clubs: posts small blind $3
vjxbkf: posts big blind $6
*** HOLE CARDS ***
king10clubs: raises $6 to $12
vjxbkf: raises $33 to $45
king10clubs: folds 
Uncalled bet ($33) returned to vjxbkf
vjxbkf collected $24 from pot
vjxbkf: doesn't show hand 
*** SUMMARY ***
Total pot $24 | Rake $0 
Seat 2: king10clubs (button) (small blind) folded before Flop
Seat 5: vjxbkf (big blind) collected ($24)


PokerStars Game #102596288262:  Hold'em No Limit ($3/$6 USD) - 2013/08/11 4:44:25 ET
Table 'Dnoces II 40-100 bb' 6-max Seat #5 is the button
Seat 2: king10clubs ($1448.50 in chips) 
Seat 5: vjxbkf ($863.50 in chips) 
vjxbkf: posts small blind $3
king10clubs: posts big blind $6
*** HOLE CARDS ***
vjxbkf: raises $6 to $12
king10clubs: raises $33 to $45
vjxbkf: folds 
Uncalled bet ($33) returned to king10clubs
king10clubs collected $24 from pot
king10clubs: doesn't show hand 
*** SUMMARY ***
Total pot $24 | Rake $0 
Seat 2: king10clubs (big blind) collected ($24)
Seat 5: vjxbkf (button) (small blind) folded before Flop


PokerStars Game #102596093076:  Hold'em No Limit ($3/$6 USD) - 2013/08/11 4:35:17 ET
Table 'Dnoces II 40-100 bb' 6-max Seat #2 is the button
Seat 2: king10clubs ($1653.50 in chips) 
Seat 5: vjxbkf ($600 in chips) 
king10clubs: posts small blind $3
vjxbkf: posts big blind $6
*** HOLE CARDS ***
king10clubs: raises $6 to $12
vjxbkf: folds 
Uncalled bet ($6) returned to king10clubs
king10clubs collected $12 from pot
king10clubs: doesn't show hand 
*** SUMMARY ***
Total pot $12 | Rake $0 
Seat 2: king10clubs (button) (small blind) collected ($12)
Seat 5: vjxbkf (big blind) folded before Flop


PokerStars Game #102596106148:  Hold'em No Limit ($3/$6 USD) - 2013/08/11 4:35:53 ET
Table 'Dnoces II 40-100 bb' 6-max Seat #5 is the button
Seat 2: king10clubs ($1659.50 in chips) 
Seat 5: vjxbkf ($600 in chips) 
vjxbkf: posts small blind $3
king10clubs: posts big blind $6
*** HOLE CARDS ***
vjxbkf: raises $6 to $12
king10clubs: calls $6
*** FLOP *** [4c 5c 4s]
king10clubs: checks 
vjxbkf: checks 
*** TURN *** [4c 5c 4s] [Js]
king10clubs: bets $18
vjxbkf: calls $18
*** RIVER *** [4c 5c 4s Js] [8c]
king10clubs: bets $50
vjxbkf: folds 
Uncalled bet ($50) returned to king10clubs
king10clubs collected $59.50 from pot
king10clubs: doesn't show hand 
*** SUMMARY ***
Total pot $60 | Rake $0.50 
Board [4c 5c 4s Js 8c]
Seat 2: king10clubs (big blind) collected ($59.50)
Seat 5: vjxbkf (button) (small blind) folded on the River


PokerStars Game #102596149422:  Hold'em No Limit ($3/$6 USD) - 2013/08/11 4:37:54 ET
Table 'Dnoces II 40-100 bb' 6-max Seat #2 is the button
Seat 2: king10clubs ($1689 in chips) 
Seat 5: vjxbkf ($600 in chips) 
king10clubs: posts small blind $3
vjxbkf: posts big blind $6
*** HOLE CARDS ***
king10clubs: raises $6 to $12
vjxbkf: folds 
Uncalled bet ($6) returned to king10clubs
king10clubs collected $12 from pot
king10clubs: doesn't show hand 
*** SUMMARY ***
Total pot $12 | Rake $0 
Seat 2: king10clubs (button) (small blind) collected ($12)
Seat 5: vjxbkf (big blind) folded before Flop


PokerStars Game #102596155436:  Hold'em No Limit ($3/$6 USD) - 2013/08/11 4:38:11 ET
Table 'Dnoces II 40-100 bb' 6-max Seat #5 is the button
Seat 2: king10clubs ($1695 in chips) 
Seat 5: vjxbkf ($600 in chips) 
vjxbkf: posts small blind $3
king10clubs: posts big blind $6
*** HOLE CARDS ***
vjxbkf: raises $6 to $12
king10clubs: folds 
Uncalled bet ($6) returned to vjxbkf
vjxbkf collected $12 from pot
vjxbkf: doesn't show hand 
*** SUMMARY ***
Total pot $12 | Rake $0 
Seat 2: king10clubs (big blind) folded before Flop
Seat 5: vjxbkf (button) (small blind) collected ($12)


PokerStars Game #102596158998:  Hold'em No Limit ($3/$6 USD) - 2013/08/11 4:38:21 ET
Table 'Dnoces II 40-100 bb' 6-max Seat #2 is the button
Seat 2: king10clubs ($1689 in chips) 
Seat 5: vjxbkf ($606 in chips) 
king10clubs: posts small blind $3
vjxbkf: posts big blind $6
*** HOLE CARDS ***
king10clubs: raises $6 to $12
vjxbkf: folds 
Uncalled bet ($6) returned to king10clubs
king10clubs collected $12 from pot
king10clubs: doesn't show hand 
*** SUMMARY ***
Total pot $12 | Rake $0 
Seat 2: king10clubs (button) (small blind) collected ($12)
Seat 5: vjxbkf (big blind) folded before Flop


PokerStars Game #102596165115:  Hold'em No Limit ($3/$6 USD) - 2013/08/11 4:38:38 ET
Table 'Dnoces II 40-100 bb' 6-max Seat #5 is the button
Seat 2: king10clubs ($1695 in chips) 
Seat 5: vjxbkf ($600 in chips) 
vjxbkf: posts small blind $3
king10clubs: posts big blind $6
*** HOLE CARDS ***
vjxbkf: raises $6 to $12
king10clubs: calls $6
*** FLOP *** [Jh 2d Jc]
king10clubs: checks 
vjxbkf: checks 
*** TURN *** [Jh 2d Jc] [Qs]
king10clubs: checks 
vjxbkf: checks 
*** RIVER *** [Jh 2d Jc Qs] [6h]
king10clubs: bets $20
vjxbkf: folds 
Uncalled bet ($20) returned to king10clubs
king10clubs collected $23.50 from pot
king10clubs: doesn't show hand 
*** SUMMARY ***
Total pot $24 | Rake $0.50 
Board [Jh 2d Jc Qs 6h]
Seat 2: king10clubs (big blind) collected ($23.50)
Seat 5: vjxbkf (button) (small blind) folded on the River


PokerStars Game #102596184535:  Hold'em No Limit ($3/$6 USD) - 2013/08/11 4:39:33 ET
Table 'Dnoces II 40-100 bb' 6-max Seat #2 is the button
Seat 2: king10clubs ($1706.50 in chips) 
Seat 5: vjxbkf ($600 in chips) 
king10clubs: posts small blind $3
vjxbkf: posts big blind $6
*** HOLE CARDS ***
king10clubs: raises $6 to $12
vjxbkf: folds 
Uncalled bet ($6) returned to king10clubs
king10clubs collected $12 from pot
king10clubs: doesn't show hand 
*** SUMMARY ***
Total pot $12 | Rake $0 
Seat 2: king10clubs (button) (small blind) collected ($12)
Seat 5: vjxbkf (big blind) folded before Flop


PokerStars Game #102596188017:  Hold'em No Limit ($3/$6 USD) - 2013/08/11 4:39:43 ET
Table 'Dnoces II 40-100 bb' 6-max Seat #5 is the button
Seat 2: king10clubs ($1712.50 in chips) 
Seat 5: vjxbkf ($600 in chips) 
vjxbkf: posts small blind $3
king10clubs: posts big blind $6
*** HOLE CARDS ***
vjxbkf: raises $6 to $12
king10clubs: folds 
Uncalled bet ($6) returned to vjxbkf
vjxbkf collected $12 from pot
vjxbkf: doesn't show hand 
*** SUMMARY ***
Total pot $12 | Rake $0 
Seat 2: king10clubs (big blind) folded before Flop
Seat 5: vjxbkf (button) (small blind) collected ($12)


PokerStars Game #102596191018:  Hold'em No Limit ($3/$6 USD) - 2013/08/11 4:39:52 ET
Table 'Dnoces II 40-100 bb' 6-max Seat #2 is the button
Seat 2: king10clubs ($1706.50 in chips) 
Seat 5: vjxbkf ($606 in chips) 
king10clubs: posts small blind $3
vjxbkf: posts big blind $6
*** HOLE CARDS ***
king10clubs: raises $6 to $12
vjxbkf: folds 
Uncalled bet ($6) returned to king10clubs
king10clubs collected $12 from pot
king10clubs: doesn't show hand 
*** SUMMARY ***
Total pot $12 | Rake $0 
Seat 2: king10clubs (button) (small blind) collected ($12)
Seat 5: vjxbkf (big blind) folded before Flop


PokerStars Game #102596443447:  Hold'em No Limit ($3/$6 USD) - 2013/08/11 4:51:43 ET
Table 'Dnoces II 40-100 bb' 6-max Seat #5 is the button
Seat 2: king10clubs ($1193 in chips) 
Seat 3: QB0970016888 ($240 in chips) 
Seat 5: vjxbkf ($1116.50 in chips) 
king10clubs: posts small blind $3
QB0970016888: posts big blind $6
*** HOLE CARDS ***
floriiiiider joins the table at seat #4 
ZarubaNT joins the table at seat #1 
uripeleg joins the table at seat #6 
vjxbkf: raises $6 to $12
king10clubs: folds 
QB0970016888: folds 
Uncalled bet ($6) returned to vjxbkf
vjxbkf collected $15 from pot
vjxbkf: doesn't show hand 
*** SUMMARY ***
Total pot $15 | Rake $0 
Seat 2: king10clubs (small blind) folded before Flop
Seat 3: QB0970016888 (big blind) folded before Flop
Seat 5: vjxbkf (button) collected ($15)


PokerStars Game #102596452843:  Hold'em No Limit ($3/$6 USD) - 2013/08/11 4:52:10 ET
Table 'Dnoces II 40-100 bb' 6-max Seat #2 is the button
Seat 2: king10clubs ($1190 in chips) 
Seat 3: QB0970016888 ($234 in chips) 
Seat 4: floriiiiider ($600 in chips) 
Seat 5: vjxbkf ($1125.50 in chips) 
QB0970016888: posts small blind $3
floriiiiider: posts big blind $6
uripeleg: sits out 
ZarubaNT: sits out 
*** HOLE CARDS ***
vjxbkf: folds 
king10clubs: raises $6 to $12
QB0970016888: folds 
floriiiiider: calls $6
*** FLOP *** [5s 8c 4d]
floriiiiider: checks 
king10clubs: bets $18
floriiiiider: calls $18
*** TURN *** [5s 8c 4d] [7s]
floriiiiider: checks 
king10clubs: bets $45
floriiiiider: calls $45
*** RIVER *** [5s 8c 4d 7s] [Td]
floriiiiider: checks 
king10clubs: checks 
*** SHOW DOWN ***
floriiiiider: shows [6d Ad] (a straight, Four to Eight)
king10clubs: mucks hand 
floriiiiider collected $151.50 from pot
*** SUMMARY ***
Total pot $153 | Rake $1.50 
Board [5s 8c 4d 7s Td]
Seat 2: king10clubs (button) mucked
Seat 3: QB0970016888 (small blind) folded before Flop
Seat 4: floriiiiider (big blind) showed [6d Ad] and won ($151.50) with a straight, Four to Eight
Seat 5: vjxbkf folded before Flop (didn't bet)


PokerStars Game #102596472049:  Hold'em No Limit ($3/$6 USD) - 2013/08/11 4:53:04 ET
Table 'Dnoces II 40-100 bb' 6-max Seat #3 is the button
Seat 2: king10clubs ($1115 in chips) 
Seat 3: QB0970016888 ($231 in chips) 
Seat 4: floriiiiider ($676.50 in chips) 
Seat 5: vjxbkf ($1125.50 in chips) 
floriiiiider: posts small blind $3
vjxbkf: posts big blind $6
uripeleg: sits out 
ZarubaNT: sits out 
*** HOLE CARDS ***
king10clubs: raises $9 to $15
QB0970016888: folds 
floriiiiider: folds 
vjxbkf: calls $9
*** FLOP *** [Qh 8c Jc]
vjxbkf: bets $24
king10clubs: calls $24
*** TURN *** [Qh 8c Jc] [Th]
vjxbkf: bets $63
king10clubs: calls $63
*** RIVER *** [Qh 8c Jc Th] [8s]
vjxbkf: checks 
king10clubs: checks 
*** SHOW DOWN ***
vjxbkf: shows [9d 9h] (a straight, Eight to Queen)
king10clubs: shows [Qc 9s] (a straight, Eight to Queen)
vjxbkf collected $102.75 from pot
king10clubs collected $102.75 from pot
*** SUMMARY ***
Total pot $207 | Rake $1.50 
Board [Qh 8c Jc Th 8s]
Seat 2: king10clubs showed [Qc 9s] and won ($102.75) with a straight, Eight to Queen
Seat 3: QB0970016888 (button) folded before Flop (didn't bet)
Seat 4: floriiiiider (small blind) folded before Flop
Seat 5: vjxbkf (big blind) showed [9d 9h] and won ($102.75) with a straight, Eight to Queen


PokerStars Game #102596507588:  Hold'em No Limit ($3/$6 USD) - 2013/08/11 4:54:44 ET
Table 'Dnoces II 40-100 bb' 6-max Seat #4 is the button
Seat 2: king10clubs ($1115.75 in chips) 
Seat 3: QB0970016888 ($231 in chips) 
Seat 4: floriiiiider ($673.50 in chips) 
Seat 5: vjxbkf ($1126.25 in chips) 
Seat 6: uripeleg ($600 in chips) 
vjxbkf: posts small blind $3
uripeleg: posts big blind $6
ZarubaNT: sits out 
*** HOLE CARDS ***
king10clubs: folds 
QB0970016888: raises $9 to $15
floriiiiider: folds 
vjxbkf: folds 
uripeleg: folds 
Uncalled bet ($9) returned to QB0970016888
QB0970016888 collected $15 from pot
QB0970016888: doesn't show hand 
*** SUMMARY ***
Total pot $15 | Rake $0 
Seat 2: king10clubs folded before Flop (didn't bet)
Seat 3: QB0970016888 collected ($15)
Seat 4: floriiiiider (button) folded before Flop (didn't bet)
Seat 5: vjxbkf (small blind) folded before Flop
Seat 6: uripeleg (big blind) folded before Flop


PokerStars Game #102596411908:  Hold'em No Limit ($3/$6 USD) - 2013/08/11 4:50:14 ET
Table 'Dnoces II 40-100 bb' 6-max Seat #5 is the button
Seat 2: king10clubs ($1229 in chips) 
Seat 5: vjxbkf ($1081.50 in chips) 
vjxbkf: posts small blind $3
king10clubs: posts big blind $6
*** HOLE CARDS ***
vjxbkf: raises $6 to $12
king10clubs: calls $6
*** FLOP *** [2s 7s 4d]
king10clubs: checks 
vjxbkf: bets $15
king10clubs: calls $15
*** TURN *** [2s 7s 4d] [8s]
king10clubs: checks 
vjxbkf: bets $36
king10clubs: folds 
Uncalled bet ($36) returned to vjxbkf
vjxbkf collected $53.50 from pot
vjxbkf: doesn't show hand 
*** SUMMARY ***
Total pot $54 | Rake $0.50 
Board [2s 7s 4d 8s]
Seat 2: king10clubs (big blind) folded on the Turn
Seat 5: vjxbkf (button) (small blind) collected ($53.50)


PokerStars Game #102596426116:  Hold'em No Limit ($3/$6 USD) - 2013/08/11 4:50:54 ET
Table 'Dnoces II 40-100 bb' 6-max Seat #2 is the button
Seat 2: king10clubs ($1202 in chips) 
Seat 5: vjxbkf ($1108 in chips) 
king10clubs: posts small blind $3
vjxbkf: posts big blind $6
*** HOLE CARDS ***
king10clubs: raises $6 to $12
vjxbkf: calls $6
*** FLOP *** [Kh 7s 6h]
vjxbkf: bets $18
king10clubs: folds 
Uncalled bet ($18) returned to vjxbkf
vjxbkf collected $23.50 from pot
vjxbkf: doesn't show hand 
*** SUMMARY ***
Total pot $24 | Rake $0.50 
Board [Kh 7s 6h]
Seat 2: king10clubs (button) (small blind) folded on the Flop
Seat 5: vjxbkf (big blind) collected ($23.50)


PokerStars Game #102596440022:  Hold'em No Limit ($3/$6 USD) - 2013/08/11 4:51:33 ET
Table 'Dnoces II 40-100 bb' 6-max Seat #5 is the button
Seat 2: king10clubs ($1190 in chips) 
Seat 5: vjxbkf ($1119.50 in chips) 
QB0970016888 joins the table at seat #3 
vjxbkf: posts small blind $3
king10clubs: posts big blind $6
*** HOLE CARDS ***
vjxbkf: folds 
Uncalled bet ($3) returned to king10clubs
king10clubs collected $6 from pot
king10clubs: doesn't show hand 
*** SUMMARY ***
Total pot $6 | Rake $0 
Seat 2: king10clubs (big blind) collected ($6)
Seat 5: vjxbkf (button) (small blind) folded before Flop


PokerStars Game #102596303493:  Hold'em No Limit ($3/$6 USD) - 2013/08/11 4:45:08 ET
Table 'Dnoces II 40-100 bb' 6-max Seat #2 is the button
Seat 2: king10clubs ($1460.50 in chips) 
Seat 5: vjxbkf ($851.50 in chips) 
king10clubs: posts small blind $3
vjxbkf: posts big blind $6
*** HOLE CARDS ***
king10clubs: raises $6 to $12
vjxbkf: raises $33 to $45
king10clubs: calls $33
*** FLOP *** [6d Kc Jd]
vjxbkf: bets $72
king10clubs: calls $72
*** TURN *** [6d Kc Jd] [5c]
vjxbkf: bets $186
king10clubs: folds 
Uncalled bet ($186) returned to vjxbkf
vjxbkf collected $233.50 from pot
vjxbkf: doesn't show hand 
*** SUMMARY ***
Total pot $234 | Rake $0.50 
Board [6d Kc Jd 5c]
Seat 2: king10clubs (button) (small blind) folded on the Turn
Seat 5: vjxbkf (big blind) collected ($233.50)


PokerStars Game #102596341584:  Hold'em No Limit ($3/$6 USD) - 2013/08/11 4:46:55 ET
Table 'Dnoces II 40-100 bb' 6-max Seat #5 is the button
Seat 2: king10clubs ($1343.50 in chips) 
Seat 5: vjxbkf ($968 in chips) 
vjxbkf: posts small blind $3
king10clubs: posts big blind $6
*** HOLE CARDS ***
vjxbkf: raises $6 to $12
king10clubs: calls $6
*** FLOP *** [4h Js 3s]
king10clubs: checks 
vjxbkf: bets $15
king10clubs: calls $15
*** TURN *** [4h Js 3s] [Jh]
king10clubs: checks 
vjxbkf: bets $36
king10clubs: calls $36
*** RIVER *** [4h Js 3s Jh] [Jc]
king10clubs: checks 
vjxbkf: bets $99
king10clubs: calls $99
*** SHOW DOWN ***
vjxbkf: shows [6c Jd] (four of a kind, Jacks)
king10clubs: mucks hand 
vjxbkf collected $323.50 from pot
*** SUMMARY ***
Total pot $324 | Rake $0.50 
Board [4h Js 3s Jh Jc]
Seat 2: king10clubs (big blind) mucked
Seat 5: vjxbkf (button) (small blind) showed [6c Jd] and won ($323.50) with four of a kind, Jacks


PokerStars Game #102596376171:  Hold'em No Limit ($3/$6 USD) - 2013/08/11 4:48:33 ET
Table 'Dnoces II 40-100 bb' 6-max Seat #2 is the button
Seat 2: king10clubs ($1181.50 in chips) 
Seat 5: vjxbkf ($1129.50 in chips) 
king10clubs: posts small blind $3
vjxbkf: posts big blind $6
*** HOLE CARDS ***
king10clubs: raises $6 to $12
vjxbkf: folds 
Uncalled bet ($6) returned to king10clubs
king10clubs collected $12 from pot
king10clubs: doesn't show hand 
*** SUMMARY ***
Total pot $12 | Rake $0 
Seat 2: king10clubs (button) (small blind) collected ($12)
Seat 5: vjxbkf (big blind) folded before Flop


PokerStars Game #102596378906:  Hold'em No Limit ($3/$6 USD) - 2013/08/11 4:48:40 ET
Table 'Dnoces II 40-100 bb' 6-max Seat #5 is the button
Seat 2: king10clubs ($1187.50 in chips) 
Seat 5: vjxbkf ($1123.50 in chips) 
vjxbkf: posts small blind $3
king10clubs: posts big blind $6
*** HOLE CARDS ***
vjxbkf: raises $6 to $12
king10clubs: folds 
Uncalled bet ($6) returned to vjxbkf
vjxbkf collected $12 from pot
vjxbkf: doesn't show hand 
*** SUMMARY ***
Total pot $12 | Rake $0 
Seat 2: king10clubs (big blind) folded before Flop
Seat 5: vjxbkf (button) (small blind) collected ($12)


PokerStars Game #102596381351:  Hold'em No Limit ($3/$6 USD) - 2013/08/11 4:48:47 ET
Table 'Dnoces II 40-100 bb' 6-max Seat #2 is the button
Seat 2: king10clubs ($1181.50 in chips) 
Seat 5: vjxbkf ($1129.50 in chips) 
king10clubs: posts small blind $3
vjxbkf: posts big blind $6
*** HOLE CARDS ***
king10clubs: raises $6 to $12
vjxbkf: folds 
Uncalled bet ($6) returned to king10clubs
king10clubs collected $12 from pot
king10clubs: doesn't show hand 
*** SUMMARY ***
Total pot $12 | Rake $0 
Seat 2: king10clubs (button) (small blind) collected ($12)
Seat 5: vjxbkf (big blind) folded before Flop


PokerStars Game #102596387338:  Hold'em No Limit ($3/$6 USD) - 2013/08/11 4:49:04 ET
Table 'Dnoces II 40-100 bb' 6-max Seat #5 is the button
Seat 2: king10clubs ($1187.50 in chips) 
Seat 5: vjxbkf ($1123.50 in chips) 
vjxbkf: posts small blind $3
king10clubs: posts big blind $6
*** HOLE CARDS ***
vjxbkf: raises $6 to $12
king10clubs: raises $36 to $48
vjxbkf: folds 
Uncalled bet ($36) returned to king10clubs
king10clubs collected $24 from pot
king10clubs: doesn't show hand 
*** SUMMARY ***
Total pot $24 | Rake $0 
Seat 2: king10clubs (big blind) collected ($24)
Seat 5: vjxbkf (button) (small blind) folded before Flop


PokerStars Game #102596392814:  Hold'em No Limit ($3/$6 USD) - 2013/08/11 4:49:20 ET
Table 'Dnoces II 40-100 bb' 6-max Seat #2 is the button
Seat 2: king10clubs ($1199.50 in chips) 
Seat 5: vjxbkf ($1111.50 in chips) 
king10clubs: posts small blind $3
vjxbkf: posts big blind $6
*** HOLE CARDS ***
king10clubs: raises $6 to $12
vjxbkf: calls $6
*** FLOP *** [As Qs Ah]
vjxbkf: bets $18
king10clubs: raises $42 to $60
vjxbkf: folds 
Uncalled bet ($42) returned to king10clubs
king10clubs collected $59.50 from pot
king10clubs: doesn't show hand 
*** SUMMARY ***
Total pot $60 | Rake $0.50 
Board [As Qs Ah]
Seat 2: king10clubs (button) (small blind) collected ($59.50)
Seat 5: vjxbkf (big blind) folded on the Flop


PokerStars Game #102596835091:  Hold'em No Limit ($3/$6 USD) - 2013/08/11 5:10:17 ET
Table 'Dnoces II 40-100 bb' 6-max Seat #6 is the button
Seat 1: ZarubaNT ($612 in chips) 
Seat 2: Ratatuj ($209.10 in chips) 
Seat 3: QB0970016888 ($260.34 in chips) 
Seat 4: floriiiiider ($776.54 in chips) 
Seat 5: vjxbkf ($1051.45 in chips) 
Seat 6: uripeleg ($600 in chips) 
ZarubaNT: posts small blind $3
Ratatuj: posts big blind $6
*** HOLE CARDS ***
QB0970016888: folds 
floriiiiider: raises $12 to $18
vjxbkf: folds 
uripeleg: folds 
ZarubaNT: folds 
Ratatuj: raises $25.20 to $43.20
floriiiiider: raises $34.80 to $78
Ratatuj: raises $131.10 to $209.10 and is all-in
floriiiiider: calls $131.10
*** FLOP *** [3c 2c Ah]
*** TURN *** [3c 2c Ah] [Ac]
*** RIVER *** [3c 2c Ah Ac] [9c]
*** SHOW DOWN ***
Ratatuj: shows [Jc Jh] (a flush, Ace high)
floriiiiider: shows [Qc Qs] (a flush, Ace high - Queen higher)
floriiiiider collected $418.40 from pot
*** SUMMARY ***
Total pot $421.20 | Rake $2.80 
Board [3c 2c Ah Ac 9c]
Seat 1: ZarubaNT (small blind) folded before Flop
Seat 2: Ratatuj (big blind) showed [Jc Jh] and lost with a flush, Ace high
Seat 3: QB0970016888 folded before Flop (didn't bet)
Seat 4: floriiiiider showed [Qc Qs] and won ($418.40) with a flush, Ace high
Seat 5: vjxbkf folded before Flop (didn't bet)
Seat 6: uripeleg (button) folded before Flop (didn't bet)


PokerStars Game #102596853891:  Hold'em No Limit ($3/$6 USD) - 2013/08/11 5:11:05 ET
Table 'Dnoces II 40-100 bb' 6-max Seat #1 is the button
Seat 1: ZarubaNT ($609 in chips) 
Seat 2: Ratatuj ($240 in chips) 
Seat 3: QB0970016888 ($260.34 in chips) 
Seat 4: floriiiiider ($985.84 in chips) 
Seat 5: vjxbkf ($1051.45 in chips) 
Seat 6: uripeleg ($600 in chips) 
Ratatuj: posts small blind $3
QB0970016888: posts big blind $6
*** HOLE CARDS ***
floriiiiider: folds 
vjxbkf: folds 
uripeleg: raises $6 to $12
ZarubaNT: folds 
Ratatuj: folds 
QB0970016888: calls $6
*** FLOP *** [As Ts 8s]
QB0970016888: checks 
uripeleg: checks 
*** TURN *** [As Ts 8s] [Js]
QB0970016888: checks 
uripeleg: checks 
*** RIVER *** [As Ts 8s Js] [Jc]
QB0970016888: bets $18
uripeleg: raises $60 to $78
QB0970016888: calls $60
*** SHOW DOWN ***
uripeleg: shows [Td Jd] (a full house, Jacks full of Tens)
QB0970016888: mucks hand 
uripeleg collected $180.20 from pot
*** SUMMARY ***
Total pot $183 | Rake $2.80 
Board [As Ts 8s Js Jc]
Seat 1: ZarubaNT (button) folded before Flop (didn't bet)
Seat 2: Ratatuj (small blind) folded before Flop
Seat 3: QB0970016888 (big blind) mucked
Seat 4: floriiiiider folded before Flop (didn't bet)
Seat 5: vjxbkf folded before Flop (didn't bet)
Seat 6: uripeleg showed [Td Jd] and won ($180.20) with a full house, Jacks full of Tens


PokerStars Game #102596900423:  Hold'em No Limit ($3/$6 USD) - 2013/08/11 5:13:04 ET
Table 'Dnoces II 40-100 bb' 6-max Seat #2 is the button
Seat 1: ZarubaNT ($609 in chips) 
Seat 2: Ratatuj ($237 in chips) 
Seat 3: QB0970016888 ($170.34 in chips) 
Seat 4: floriiiiider ($985.84 in chips) 
Seat 5: vjxbkf ($1051.45 in chips) 
Seat 6: uripeleg ($690.20 in chips) 
QB0970016888: posts small blind $3
floriiiiider: posts big blind $6
*** HOLE CARDS ***
vjxbkf: folds 
uripeleg: folds 
ZarubaNT: folds 
Ratatuj: raises $6.42 to $12.42
QB0970016888: calls $9.42
floriiiiider: calls $6.42
*** FLOP *** [9s 7h 6s]
QB0970016888: checks 
floriiiiider: checks 
Ratatuj: checks 
*** TURN *** [9s 7h 6s] [5s]
QB0970016888: checks 
floriiiiider: bets $27
Ratatuj: folds 
QB0970016888: calls $27
*** RIVER *** [9s 7h 6s 5s] [8d]
QB0970016888: checks 
floriiiiider: bets $66
QB0970016888: calls $66
*** SHOW DOWN ***
floriiiiider: shows [8s Js] (a flush, Jack high)
QB0970016888: mucks hand 
floriiiiider collected $220.46 from pot
*** SUMMARY ***
Total pot $223.26 | Rake $2.80 
Board [9s 7h 6s 5s 8d]
Seat 1: ZarubaNT folded before Flop (didn't bet)
Seat 2: Ratatuj (button) folded on the Turn
Seat 3: QB0970016888 (small blind) mucked
Seat 4: floriiiiider (big blind) showed [8s Js] and won ($220.46) with a flush, Jack high
Seat 5: vjxbkf folded before Flop (didn't bet)
Seat 6: uripeleg folded before Flop (didn't bet)


PokerStars Game #102596935007:  Hold'em No Limit ($3/$6 USD) - 2013/08/11 5:14:32 ET
Table 'Dnoces II 40-100 bb' 6-max Seat #3 is the button
Seat 1: ZarubaNT ($609 in chips) 
Seat 2: Ratatuj ($224.58 in chips) 
Seat 3: QB0970016888 ($64.92 in chips) 
Seat 4: floriiiiider ($1100.88 in chips) 
Seat 5: vjxbkf ($1051.45 in chips) 
Seat 6: uripeleg ($690.20 in chips) 
floriiiiider: posts small blind $3
vjxbkf: posts big blind $6
*** HOLE CARDS ***
uripeleg: folds 
ZarubaNT: folds 
Ratatuj: raises $6 to $12
QB0970016888: folds 
floriiiiider: folds 
vjxbkf: folds 
Uncalled bet ($6) returned to Ratatuj
Ratatuj collected $15 from pot
Ratatuj: doesn't show hand 
*** SUMMARY ***
Total pot $15 | Rake $0 
Seat 1: ZarubaNT folded before Flop (didn't bet)
Seat 2: Ratatuj collected ($15)
Seat 3: QB0970016888 (button) folded before Flop (didn't bet)
Seat 4: floriiiiider (small blind) folded before Flop
Seat 5: vjxbkf (big blind) folded before Flop
Seat 6: uripeleg folded before Flop (didn't bet)


PokerStars Game #102596722614:  Hold'em No Limit ($3/$6 USD) - 2013/08/11 5:05:30 ET
Table 'Dnoces II 40-100 bb' 6-max Seat #3 is the button
Seat 1: ZarubaNT ($606 in chips) 
Seat 3: QB0970016888 ($275.34 in chips) 
Seat 4: floriiiiider ($650.34 in chips) 
Seat 5: vjxbkf ($1168.45 in chips) 
Seat 6: uripeleg ($600 in chips) 
floriiiiider: posts small blind $3
vjxbkf: posts big blind $6
*** HOLE CARDS ***
uripeleg: folds 
ZarubaNT: folds 
QB0970016888: raises $9 to $15
floriiiiider: raises $33 to $48
vjxbkf: folds 
QB0970016888: folds 
Uncalled bet ($33) returned to floriiiiider
floriiiiider collected $36 from pot
floriiiiider: doesn't show hand 
*** SUMMARY ***
Total pot $36 | Rake $0 
Seat 1: ZarubaNT folded before Flop (didn't bet)
Seat 3: QB0970016888 (button) folded before Flop
Seat 4: floriiiiider (small blind) collected ($36)
Seat 5: vjxbkf (big blind) folded before Flop
Seat 6: uripeleg folded before Flop (didn't bet)


PokerStars Game #102596735195:  Hold'em No Limit ($3/$6 USD) - 2013/08/11 5:06:03 ET
Table 'Dnoces II 40-100 bb' 6-max Seat #4 is the button
Seat 1: ZarubaNT ($606 in chips) 
Seat 3: QB0970016888 ($260.34 in chips) 
Seat 4: floriiiiider ($671.34 in chips) 
Seat 5: vjxbkf ($1162.45 in chips) 
Seat 6: uripeleg ($600 in chips) 
vjxbkf: posts small blind $3
uripeleg: posts big blind $6
*** HOLE CARDS ***
ZarubaNT: folds 
QB0970016888: folds 
floriiiiider: folds 
vjxbkf: folds 
Uncalled bet ($3) returned to uripeleg
uripeleg collected $6 from pot
*** SUMMARY ***
Total pot $6 | Rake $0 
Seat 1: ZarubaNT folded before Flop (didn't bet)
Seat 3: QB0970016888 folded before Flop (didn't bet)
Seat 4: floriiiiider (button) folded before Flop (didn't bet)
Seat 5: vjxbkf (small blind) folded before Flop
Seat 6: uripeleg (big blind) collected ($6)


PokerStars Game #102596738863:  Hold'em No Limit ($3/$6 USD) - 2013/08/11 5:06:12 ET
Table 'Dnoces II 40-100 bb' 6-max Seat #5 is the button
Seat 1: ZarubaNT ($606 in chips) 
Seat 3: QB0970016888 ($260.34 in chips) 
Seat 4: floriiiiider ($671.34 in chips) 
Seat 5: vjxbkf ($1159.45 in chips) 
Seat 6: uripeleg ($603 in chips) 
uripeleg: posts small blind $3
ZarubaNT: posts big blind $6
*** HOLE CARDS ***
QB0970016888: folds 
floriiiiider: raises $9 to $15
vjxbkf: calls $15
uripeleg: folds 
ZarubaNT: folds 
*** FLOP *** [2s Js Ad]
floriiiiider: bets $27
vjxbkf: calls $27
*** TURN *** [2s Js Ad] [9s]
floriiiiider: bets $66
vjxbkf: calls $66
*** RIVER *** [2s Js Ad 9s] [7s]
floriiiiider: bets $144
vjxbkf: folds 
Uncalled bet ($144) returned to floriiiiider
floriiiiider collected $222.20 from pot
floriiiiider: doesn't show hand 
*** SUMMARY ***
Total pot $225 | Rake $2.80 
Board [2s Js Ad 9s 7s]
Seat 1: ZarubaNT (big blind) folded before Flop
Seat 3: QB0970016888 folded before Flop (didn't bet)
Seat 4: floriiiiider collected ($222.20)
Seat 5: vjxbkf (button) folded on the River
Seat 6: uripeleg (small blind) folded before Flop


PokerStars Game #102596775996:  Hold'em No Limit ($3/$6 USD) - 2013/08/11 5:07:46 ET
Table 'Dnoces II 40-100 bb' 6-max Seat #6 is the button
Seat 1: ZarubaNT ($600 in chips) 
Seat 2: Ratatuj ($200.10 in chips) 
Seat 3: QB0970016888 ($260.34 in chips) 
Seat 4: floriiiiider ($785.54 in chips) 
Seat 5: vjxbkf ($1051.45 in chips) 
Seat 6: uripeleg ($600 in chips) 
ZarubaNT: posts small blind $3
Ratatuj: posts big blind $6
*** HOLE CARDS ***
QB0970016888: folds 
floriiiiider: folds 
vjxbkf: folds 
uripeleg: folds 
ZarubaNT: folds 
Uncalled bet ($3) returned to Ratatuj
Ratatuj collected $6 from pot
Ratatuj: doesn't show hand 
*** SUMMARY ***
Total pot $6 | Rake $0 
Seat 1: ZarubaNT (small blind) folded before Flop
Seat 2: Ratatuj (big blind) collected ($6)
Seat 3: QB0970016888 folded before Flop (didn't bet)
Seat 4: floriiiiider folded before Flop (didn't bet)
Seat 5: vjxbkf folded before Flop (didn't bet)
Seat 6: uripeleg (button) folded before Flop (didn't bet)


PokerStars Game #102596788619:  Hold'em No Limit ($3/$6 USD) - 2013/08/11 5:08:19 ET
Table 'Dnoces II 40-100 bb' 6-max Seat #1 is the button
Seat 1: ZarubaNT ($600 in chips) 
Seat 2: Ratatuj ($203.10 in chips) 
Seat 3: QB0970016888 ($260.34 in chips) 
Seat 4: floriiiiider ($785.54 in chips) 
Seat 5: vjxbkf ($1051.45 in chips) 
Seat 6: uripeleg ($600 in chips) 
Ratatuj: posts small blind $3
QB0970016888: posts big blind $6
*** HOLE CARDS ***
floriiiiider: folds 
vjxbkf: raises $15 to $21
uripeleg: folds 
ZarubaNT: folds 
Ratatuj: folds 
QB0970016888: folds 
Uncalled bet ($15) returned to vjxbkf
vjxbkf collected $15 from pot
vjxbkf: doesn't show hand 
*** SUMMARY ***
Total pot $15 | Rake $0 
Seat 1: ZarubaNT (button) folded before Flop (didn't bet)
Seat 2: Ratatuj (small blind) folded before Flop
Seat 3: QB0970016888 (big blind) folded before Flop
Seat 4: floriiiiider folded before Flop (didn't bet)
Seat 5: vjxbkf collected ($15)
Seat 6: uripeleg folded before Flop (didn't bet)


PokerStars Game #102596798240:  Hold'em No Limit ($3/$6 USD) - 2013/08/11 5:08:43 ET
Table 'Dnoces II 40-100 bb' 6-max Seat #2 is the button
Seat 1: ZarubaNT ($600 in chips) 
Seat 2: Ratatuj ($200.10 in chips) 
Seat 3: QB0970016888 ($254.34 in chips) 
Seat 4: floriiiiider ($785.54 in chips) 
Seat 5: vjxbkf ($1060.45 in chips) 
Seat 6: uripeleg ($600 in chips) 
QB0970016888: posts small blind $3
floriiiiider: posts big blind $6
*** HOLE CARDS ***
vjxbkf: folds 
uripeleg: folds 
ZarubaNT: folds 
Ratatuj: raises $6.42 to $12.42
QB0970016888: folds 
floriiiiider: folds 
Uncalled bet ($6.42) returned to Ratatuj
Ratatuj collected $15 from pot
Ratatuj: doesn't show hand 
*** SUMMARY ***
Total pot $15 | Rake $0 
Seat 1: ZarubaNT folded before Flop (didn't bet)
Seat 2: Ratatuj (button) collected ($15)
Seat 3: QB0970016888 (small blind) folded before Flop
Seat 4: floriiiiider (big blind) folded before Flop
Seat 5: vjxbkf folded before Flop (didn't bet)
Seat 6: uripeleg folded before Flop (didn't bet)


PokerStars Game #102596806565:  Hold'em No Limit ($3/$6 USD) - 2013/08/11 5:09:04 ET
Table 'Dnoces II 40-100 bb' 6-max Seat #3 is the button
Seat 1: ZarubaNT ($600 in chips) 
Seat 2: Ratatuj ($209.10 in chips) 
Seat 3: QB0970016888 ($251.34 in chips) 
Seat 4: floriiiiider ($779.54 in chips) 
Seat 5: vjxbkf ($1060.45 in chips) 
Seat 6: uripeleg ($600 in chips) 
floriiiiider: posts small blind $3
vjxbkf: posts big blind $6
*** HOLE CARDS ***
uripeleg: folds 
ZarubaNT: folds 
Ratatuj: folds 
QB0970016888: raises $9 to $15
floriiiiider: folds 
vjxbkf: folds 
Uncalled bet ($9) returned to QB0970016888
QB0970016888 collected $15 from pot
*** SUMMARY ***
Total pot $15 | Rake $0 
Seat 1: ZarubaNT folded before Flop (didn't bet)
Seat 2: Ratatuj folded before Flop (didn't bet)
Seat 3: QB0970016888 (button) collected ($15)
Seat 4: floriiiiider (small blind) folded before Flop
Seat 5: vjxbkf (big blind) folded before Flop
Seat 6: uripeleg folded before Flop (didn't bet)


PokerStars Game #102596817091:  Hold'em No Limit ($3/$6 USD) - 2013/08/11 5:09:31 ET
Table 'Dnoces II 40-100 bb' 6-max Seat #4 is the button
Seat 1: ZarubaNT ($600 in chips) 
Seat 2: Ratatuj ($209.10 in chips) 
Seat 3: QB0970016888 ($260.34 in chips) 
Seat 4: floriiiiider ($776.54 in chips) 
Seat 5: vjxbkf ($1054.45 in chips) 
Seat 6: uripeleg ($600 in chips) 
vjxbkf: posts small blind $3
uripeleg: posts big blind $6
*** HOLE CARDS ***
ZarubaNT: raises $12 to $18
Ratatuj: folds 
QB0970016888: folds 
floriiiiider: folds 
vjxbkf: folds 
uripeleg: folds 
Uncalled bet ($12) returned to ZarubaNT
ZarubaNT collected $15 from pot
ZarubaNT: doesn't show hand 
*** SUMMARY ***
Total pot $15 | Rake $0 
Seat 1: ZarubaNT collected ($15)
Seat 2: Ratatuj folded before Flop (didn't bet)
Seat 3: QB0970016888 folded before Flop (didn't bet)
Seat 4: floriiiiider (button) folded before Flop (didn't bet)
Seat 5: vjxbkf (small blind) folded before Flop
Seat 6: uripeleg (big blind) folded before Flop


PokerStars Game #102596826653:  Hold'em No Limit ($3/$6 USD) - 2013/08/11 5:09:56 ET
Table 'Dnoces II 40-100 bb' 6-max Seat #5 is the button
Seat 1: ZarubaNT ($609 in chips) 
Seat 2: Ratatuj ($209.10 in chips) 
Seat 3: QB0970016888 ($260.34 in chips) 
Seat 4: floriiiiider ($776.54 in chips) 
Seat 5: vjxbkf ($1051.45 in chips) 
Seat 6: uripeleg ($600 in chips) 
uripeleg: posts small blind $3
ZarubaNT: posts big blind $6
*** HOLE CARDS ***
Ratatuj: folds 
QB0970016888: folds 
floriiiiider: folds 
vjxbkf: folds 
uripeleg: folds 
Uncalled bet ($3) returned to ZarubaNT
ZarubaNT collected $6 from pot
ZarubaNT: doesn't show hand 
*** SUMMARY ***
Total pot $6 | Rake $0 
Seat 1: ZarubaNT (big blind) collected ($6)
Seat 2: Ratatuj folded before Flop (didn't bet)
Seat 3: QB0970016888 folded before Flop (didn't bet)
Seat 4: floriiiiider folded before Flop (didn't bet)
Seat 5: vjxbkf (button) folded before Flop (didn't bet)
Seat 6: uripeleg (small blind) folded before Flop


PokerStars Game #102596517372:  Hold'em No Limit ($3/$6 USD) - 2013/08/11 4:55:12 ET
Table 'Dnoces II 40-100 bb' 6-max Seat #5 is the button
Seat 1: ZarubaNT ($600 in chips) 
Seat 2: king10clubs ($1115.75 in chips) 
Seat 3: QB0970016888 ($240 in chips) 
Seat 4: floriiiiider ($673.50 in chips) 
Seat 5: vjxbkf ($1123.25 in chips) 
Seat 6: uripeleg ($600 in chips) 
uripeleg: posts small blind $3
ZarubaNT: posts big blind $6
*** HOLE CARDS ***
king10clubs: folds 
QB0970016888: folds 
floriiiiider: folds 
vjxbkf: raises $6 to $12
uripeleg: folds 
ZarubaNT: calls $6
*** FLOP *** [7s 5h 8h]
ZarubaNT: checks 
vjxbkf: bets $15
ZarubaNT: calls $15
*** TURN *** [7s 5h 8h] [Ac]
ZarubaNT: checks 
vjxbkf: bets $39
ZarubaNT: calls $39
*** RIVER *** [7s 5h 8h Ac] [Qh]
ZarubaNT: checks 
vjxbkf: bets $93
ZarubaNT: folds 
Uncalled bet ($93) returned to vjxbkf
vjxbkf collected $132.20 from pot
vjxbkf: doesn't show hand 
*** SUMMARY ***
Total pot $135 | Rake $2.80 
Board [7s 5h 8h Ac Qh]
Seat 1: ZarubaNT (big blind) folded on the River
Seat 2: king10clubs folded before Flop (didn't bet)
Seat 3: QB0970016888 folded before Flop (didn't bet)
Seat 4: floriiiiider folded before Flop (didn't bet)
Seat 5: vjxbkf (button) collected ($132.20)
Seat 6: uripeleg (small blind) folded before Flop


PokerStars Game #102596544072:  Hold'em No Limit ($3/$6 USD) - 2013/08/11 4:56:47 ET
Table 'Dnoces II 40-100 bb' 6-max Seat #6 is the button
Seat 1: ZarubaNT ($600 in chips) 
Seat 2: king10clubs ($1115.75 in chips) 
Seat 3: QB0970016888 ($240 in chips) 
Seat 4: floriiiiider ($673.50 in chips) 
Seat 5: vjxbkf ($1189.45 in chips) 
Seat 6: uripeleg ($600 in chips) 
ZarubaNT: posts small blind $3
king10clubs: posts big blind $6
*** HOLE CARDS ***
QB0970016888: folds 
floriiiiider: raises $12 to $18
vjxbkf: folds 
uripeleg: folds 
ZarubaNT: calls $15
king10clubs: calls $12
*** FLOP *** [4s 3d 3h]
ZarubaNT: checks 
king10clubs: bets $36
floriiiiider: calls $36
ZarubaNT: calls $36
*** TURN *** [4s 3d 3h] [Js]
ZarubaNT: checks 
king10clubs: checks 
floriiiiider: checks 
*** RIVER *** [4s 3d 3h Js] [2c]
ZarubaNT: checks 
king10clubs: bets $125
floriiiiider: folds 
ZarubaNT: folds 
Uncalled bet ($125) returned to king10clubs
king10clubs collected $159.20 from pot
king10clubs: doesn't show hand 
*** SUMMARY ***
Total pot $162 | Rake $2.80 
Board [4s 3d 3h Js 2c]
Seat 1: ZarubaNT (small blind) folded on the River
Seat 2: king10clubs (big blind) collected ($159.20)
Seat 3: QB0970016888 folded before Flop (didn't bet)
Seat 4: floriiiiider folded on the River
Seat 5: vjxbkf folded before Flop (didn't bet)
Seat 6: uripeleg (button) folded before Flop (didn't bet)


PokerStars Game #102596576672:  Hold'em No Limit ($3/$6 USD) - 2013/08/11 4:58:44 ET
Table 'Dnoces II 40-100 bb' 6-max Seat #1 is the button
Seat 1: ZarubaNT ($600 in chips) 
Seat 2: king10clubs ($1220.95 in chips) 
Seat 3: QB0970016888 ($240 in chips) 
Seat 4: floriiiiider ($619.50 in chips) 
Seat 5: vjxbkf ($1189.45 in chips) 
Seat 6: uripeleg ($600 in chips) 
king10clubs: posts small blind $3
QB0970016888: posts big blind $6
*** HOLE CARDS ***
floriiiiider: folds 
vjxbkf: folds 
uripeleg: folds 
ZarubaNT: folds 
king10clubs: raises $9 to $15
QB0970016888: folds 
Uncalled bet ($9) returned to king10clubs
king10clubs collected $12 from pot
king10clubs: doesn't show hand 
*** SUMMARY ***
Total pot $12 | Rake $0 
Seat 1: ZarubaNT (button) folded before Flop (didn't bet)
Seat 2: king10clubs (small blind) collected ($12)
Seat 3: QB0970016888 (big blind) folded before Flop
Seat 4: floriiiiider folded before Flop (didn't bet)
Seat 5: vjxbkf folded before Flop (didn't bet)
Seat 6: uripeleg folded before Flop (didn't bet)


PokerStars Game #102596583691:  Hold'em No Limit ($3/$6 USD) - 2013/08/11 4:59:10 ET
Table 'Dnoces II 40-100 bb' 6-max Seat #2 is the button
Seat 1: ZarubaNT ($600 in chips) 
Seat 2: king10clubs ($1226.95 in chips) 
Seat 3: QB0970016888 ($234 in chips) 
Seat 4: floriiiiider ($619.50 in chips) 
Seat 5: vjxbkf ($1189.45 in chips) 
Seat 6: uripeleg ($600 in chips) 
QB0970016888: posts small blind $3
floriiiiider: posts big blind $6
*** HOLE CARDS ***
vjxbkf: folds 
uripeleg: folds 
ZarubaNT: folds 
king10clubs: raises $6 to $12
QB0970016888: folds 
floriiiiider: folds 
Uncalled bet ($6) returned to king10clubs
king10clubs collected $15 from pot
king10clubs: doesn't show hand 
*** SUMMARY ***
Total pot $15 | Rake $0 
Seat 1: ZarubaNT folded before Flop (didn't bet)
Seat 2: king10clubs (button) collected ($15)
Seat 3: QB0970016888 (small blind) folded before Flop
Seat 4: floriiiiider (big blind) folded before Flop
Seat 5: vjxbkf folded before Flop (didn't bet)
Seat 6: uripeleg folded before Flop (didn't bet)


PokerStars Game #102596595983:  Hold'em No Limit ($3/$6 USD) - 2013/08/11 4:59:53 ET
Table 'Dnoces II 40-100 bb' 6-max Seat #3 is the button
Seat 1: ZarubaNT ($600 in chips) 
Seat 2: king10clubs ($1235.95 in chips) 
Seat 3: QB0970016888 ($231 in chips) 
Seat 4: floriiiiider ($613.50 in chips) 
Seat 5: vjxbkf ($1189.45 in chips) 
Seat 6: uripeleg ($600 in chips) 
floriiiiider: posts small blind $3
vjxbkf: posts big blind $6
*** HOLE CARDS ***
uripeleg: raises $7.50 to $13.50
ZarubaNT: folds 
king10clubs: folds 
QB0970016888: folds 
floriiiiider: folds 
vjxbkf: folds 
Uncalled bet ($7.50) returned to uripeleg
uripeleg collected $15 from pot
*** SUMMARY ***
Total pot $15 | Rake $0 
Seat 1: ZarubaNT folded before Flop (didn't bet)
Seat 2: king10clubs folded before Flop (didn't bet)
Seat 3: QB0970016888 (button) folded before Flop (didn't bet)
Seat 4: floriiiiider (small blind) folded before Flop
Seat 5: vjxbkf (big blind) folded before Flop
Seat 6: uripeleg collected ($15)


PokerStars Game #102596606180:  Hold'em No Limit ($3/$6 USD) - 2013/08/11 5:00:20 ET
Table 'Dnoces II 40-100 bb' 6-max Seat #4 is the button
Seat 1: ZarubaNT ($600 in chips) 
Seat 2: king10clubs ($1235.95 in chips) 
Seat 3: QB0970016888 ($231 in chips) 
Seat 4: floriiiiider ($610.50 in chips) 
Seat 5: vjxbkf ($1183.45 in chips) 
Seat 6: uripeleg ($609 in chips) 
vjxbkf: posts small blind $3
uripeleg: posts big blind $6
*** HOLE CARDS ***
ZarubaNT: raises $12 to $18
king10clubs: raises $39 to $57
QB0970016888: folds 
floriiiiider: folds 
vjxbkf: folds 
uripeleg: folds 
ZarubaNT: folds 
Uncalled bet ($39) returned to king10clubs
king10clubs collected $45 from pot
king10clubs: doesn't show hand 
*** SUMMARY ***
Total pot $45 | Rake $0 
Seat 1: ZarubaNT folded before Flop
Seat 2: king10clubs collected ($45)
Seat 3: QB0970016888 folded before Flop (didn't bet)
Seat 4: floriiiiider (button) folded before Flop (didn't bet)
Seat 5: vjxbkf (small blind) folded before Flop
Seat 6: uripeleg (big blind) folded before Flop


PokerStars Game #102596613253:  Hold'em No Limit ($3/$6 USD) - 2013/08/11 5:00:43 ET
Table 'Dnoces II 40-100 bb' 6-max Seat #5 is the button
Seat 1: ZarubaNT ($600 in chips) 
Seat 2: king10clubs ($1262.95 in chips) 
Seat 3: QB0970016888 ($231 in chips) 
Seat 4: floriiiiider ($610.50 in chips) 
Seat 5: vjxbkf ($1180.45 in chips) 
Seat 6: uripeleg ($603 in chips) 
uripeleg: posts small blind $3
ZarubaNT: posts big blind $6
*** HOLE CARDS ***
king10clubs: folds 
QB0970016888: raises $9 to $15
floriiiiider: folds 
vjxbkf: calls $15
uripeleg: folds 
ZarubaNT: folds 
*** FLOP *** [Jh 5h Ah]
QB0970016888: bets $24
vjxbkf: folds 
Uncalled bet ($24) returned to QB0970016888
QB0970016888 collected $37.24 from pot
QB0970016888: doesn't show hand 
*** SUMMARY ***
Total pot $39 | Rake $1.76 
Board [Jh 5h Ah]
Seat 1: ZarubaNT (big blind) folded before Flop
Seat 2: king10clubs folded before Flop (didn't bet)
Seat 3: QB0970016888 collected ($37.24)
Seat 4: floriiiiider folded before Flop (didn't bet)
Seat 5: vjxbkf (button) folded on the Flop
Seat 6: uripeleg (small blind) folded before Flop


PokerStars Game #102596635997:  Hold'em No Limit ($3/$6 USD) - 2013/08/11 5:01:48 ET
Table 'Dnoces II 40-100 bb' 6-max Seat #6 is the button
Seat 1: ZarubaNT ($600 in chips) 
Seat 3: QB0970016888 ($253.24 in chips) 
Seat 4: floriiiiider ($610.50 in chips) 
Seat 5: vjxbkf ($1165.45 in chips) 
Seat 6: uripeleg ($600 in chips) 
ZarubaNT: posts small blind $3
king10clubs: is sitting out 
QB0970016888: posts big blind $6
*** HOLE CARDS ***
floriiiiider: folds 
king10clubs leaves the table
vjxbkf: raises $12 to $18
uripeleg: folds 
ZarubaNT: folds 
QB0970016888: folds 
Uncalled bet ($12) returned to vjxbkf
vjxbkf collected $15 from pot
vjxbkf: doesn't show hand 
*** SUMMARY ***
Total pot $15 | Rake $0 
Seat 1: ZarubaNT (small blind) folded before Flop
Seat 3: QB0970016888 (big blind) folded before Flop
Seat 4: floriiiiider folded before Flop (didn't bet)
Seat 5: vjxbkf collected ($15)
Seat 6: uripeleg (button) folded before Flop (didn't bet)


PokerStars Game #102596649130:  Hold'em No Limit ($3/$6 USD) - 2013/08/11 5:02:22 ET
Table 'Dnoces II 40-100 bb' 6-max Seat #1 is the button
Seat 1: ZarubaNT ($600 in chips) 
Seat 3: QB0970016888 ($247.24 in chips) 
Seat 4: floriiiiider ($610.50 in chips) 
Seat 5: vjxbkf ($1174.45 in chips) 
Seat 6: uripeleg ($600 in chips) 
QB0970016888: posts small blind $3
floriiiiider: posts big blind $6
*** HOLE CARDS ***
vjxbkf: folds 
uripeleg: raises $6 to $12
ZarubaNT: calls $12
QB0970016888: calls $9
floriiiiider: calls $6
*** FLOP *** [8c 3s Tc]
QB0970016888: checks 
floriiiiider: bets $33
Ratatuj joins the table at seat #2 
uripeleg: folds 
ZarubaNT: folds 
QB0970016888: folds 
Uncalled bet ($33) returned to floriiiiider
floriiiiider collected $45.84 from pot
floriiiiider: doesn't show hand 
*** SUMMARY ***
Total pot $48 | Rake $2.16 
Board [8c 3s Tc]
Seat 1: ZarubaNT (button) folded on the Flop
Seat 3: QB0970016888 (small blind) folded on the Flop
Seat 4: floriiiiider (big blind) collected ($45.84)
Seat 5: vjxbkf folded before Flop (didn't bet)
Seat 6: uripeleg folded on the Flop


PokerStars Game #102596673526:  Hold'em No Limit ($3/$6 USD) - 2013/08/11 5:03:27 ET
Table 'Dnoces II 40-100 bb' 6-max Seat #3 is the button
Seat 1: ZarubaNT ($600 in chips) 
Seat 3: QB0970016888 ($235.24 in chips) 
Seat 4: floriiiiider ($644.34 in chips) 
Seat 5: vjxbkf ($1174.45 in chips) 
Seat 6: uripeleg ($600 in chips) 
floriiiiider: posts small blind $3
vjxbkf: posts big blind $6
Ratatuj: sits out 
*** HOLE CARDS ***
uripeleg: folds 
ZarubaNT: folds 
QB0970016888: raises $9 to $15
floriiiiider: folds 
vjxbkf is disconnected 
vjxbkf has timed out while disconnected
vjxbkf: folds 
Uncalled bet ($9) returned to QB0970016888
QB0970016888 collected $15 from pot
QB0970016888: doesn't show hand 
*** SUMMARY ***
Total pot $15 | Rake $0 
Seat 1: ZarubaNT folded before Flop (didn't bet)
Seat 3: QB0970016888 (button) collected ($15)
Seat 4: floriiiiider (small blind) folded before Flop
Seat 5: vjxbkf (big blind) folded before Flop
Seat 6: uripeleg folded before Flop (didn't bet)


PokerStars Game #102596690132:  Hold'em No Limit ($3/$6 USD) - 2013/08/11 5:04:07 ET
Table 'Dnoces II 40-100 bb' 6-max Seat #4 is the button
Seat 1: ZarubaNT ($600 in chips) 
Seat 3: QB0970016888 ($244.24 in chips) 
Seat 4: floriiiiider ($641.34 in chips) 
Seat 6: uripeleg ($600 in chips) 
uripeleg: posts small blind $3
ZarubaNT: posts big blind $6
Ratatuj: sits out 
*** HOLE CARDS ***
QB0970016888: folds 
floriiiiider: raises $6 to $12
uripeleg: folds 
ZarubaNT: folds 
Uncalled bet ($6) returned to floriiiiider
floriiiiider collected $15 from pot
floriiiiider: doesn't show hand 
*** SUMMARY ***
Total pot $15 | Rake $0 
Seat 1: ZarubaNT (big blind) folded before Flop
Seat 3: QB0970016888 folded before Flop (didn't bet)
Seat 4: floriiiiider (button) collected ($15)
Seat 6: uripeleg (small blind) folded before Flop


PokerStars Game #102596697801:  Hold'em No Limit ($3/$6 USD) - 2013/08/11 5:04:27 ET
Table 'Dnoces II 40-100 bb' 6-max Seat #6 is the button
Seat 1: ZarubaNT ($600 in chips) 
Seat 2: Ratatuj ($240 in chips) 
Seat 3: QB0970016888 ($244.24 in chips) 
Seat 4: floriiiiider ($650.34 in chips) 
Seat 6: uripeleg ($600 in chips) 
ZarubaNT: posts small blind $3
Ratatuj: posts big blind $6
*** HOLE CARDS ***
QB0970016888: folds 
floriiiiider: folds 
uripeleg: folds 
ZarubaNT: raises $12 to $18
Ratatuj: folds 
Uncalled bet ($12) returned to ZarubaNT
ZarubaNT collected $12 from pot
ZarubaNT: doesn't show hand 
*** SUMMARY ***
Total pot $12 | Rake $0 
Seat 1: ZarubaNT (small blind) collected ($12)
Seat 2: Ratatuj (big blind) folded before Flop
Seat 3: QB0970016888 folded before Flop (didn't bet)
Seat 4: floriiiiider folded before Flop (didn't bet)
Seat 6: uripeleg (button) folded before Flop (didn't bet)


PokerStars Game #102596704738:  Hold'em No Limit ($3/$6 USD) - 2013/08/11 5:04:45 ET
Table 'Dnoces II 40-100 bb' 6-max Seat #1 is the button
Seat 1: ZarubaNT ($606 in chips) 
Seat 2: Ratatuj ($234 in chips) 
Seat 3: QB0970016888 ($244.24 in chips) 
Seat 4: floriiiiider ($650.34 in chips) 
Seat 6: uripeleg ($600 in chips) 
Ratatuj: posts small blind $3
QB0970016888: posts big blind $6
*** HOLE CARDS ***
floriiiiider: folds 
uripeleg: folds 
ZarubaNT: folds 
Ratatuj: raises $9 to $15
QB0970016888: calls $9
*** FLOP *** [9h 9s 4h]
Ratatuj: bets $18.90
QB0970016888: raises $41.10 to $60
Ratatuj: folds 
Uncalled bet ($41.10) returned to QB0970016888
QB0970016888 collected $65 from pot
QB0970016888: doesn't show hand 
*** SUMMARY ***
Total pot $67.80 | Rake $2.80 
Board [9h 9s 4h]
Seat 1: ZarubaNT (button) folded before Flop (didn't bet)
Seat 2: Ratatuj (small blind) folded on the Flop
Seat 3: QB0970016888 (big blind) collected ($65)
Seat 4: floriiiiider folded before Flop (didn't bet)
Seat 6: uripeleg folded before Flop (didn't bet)


PokerStars Game #102597188018:  Hold'em No Limit ($3/$6 USD) - 2013/08/11 5:25:05 ET
Table 'Dnoces II 40-100 bb' 6-max Seat #6 is the button
Seat 1: ZarubaNT ($600 in chips) 
Seat 2: ChowYuenFatt ($591 in chips) 
Seat 3: floriiiiider ($1045.66 in chips) 
Seat 4: EtniX111 ($654.20 in chips) 
Seat 6: uripeleg ($676.98 in chips) 
ZarubaNT: posts small blind $3
ChowYuenFatt: posts big blind $6
shenghu: sits out 
*** HOLE CARDS ***
floriiiiider: folds 
EtniX111: folds 
uripeleg: folds 
ZarubaNT: raises $12 to $18
ChowYuenFatt: folds 
Uncalled bet ($12) returned to ZarubaNT
ZarubaNT collected $12 from pot
ZarubaNT: doesn't show hand 
*** SUMMARY ***
Total pot $12 | Rake $0 
Seat 1: ZarubaNT (small blind) collected ($12)
Seat 2: ChowYuenFatt (big blind) folded before Flop
Seat 3: floriiiiider folded before Flop (didn't bet)
Seat 4: EtniX111 folded before Flop (didn't bet)
Seat 6: uripeleg (button) folded before Flop (didn't bet)


PokerStars Game #102597197642:  Hold'em No Limit ($3/$6 USD) - 2013/08/11 5:25:29 ET
Table 'Dnoces II 40-100 bb' 6-max Seat #1 is the button
Seat 1: ZarubaNT ($606 in chips) 
Seat 2: ChowYuenFatt ($585 in chips) 
Seat 3: floriiiiider ($1045.66 in chips) 
Seat 4: EtniX111 ($654.20 in chips) 
Seat 6: uripeleg ($676.98 in chips) 
ChowYuenFatt: posts small blind $3
floriiiiider: posts big blind $6
shenghu: sits out 
*** HOLE CARDS ***
EtniX111: folds 
uripeleg: raises $6 to $12
ZarubaNT: folds 
ChowYuenFatt: raises $27 to $39
floriiiiider: folds 
uripeleg: folds 
Uncalled bet ($27) returned to ChowYuenFatt
ChowYuenFatt collected $30 from pot
ChowYuenFatt: doesn't show hand 
*** SUMMARY ***
Total pot $30 | Rake $0 
Seat 1: ZarubaNT (button) folded before Flop (didn't bet)
Seat 2: ChowYuenFatt (small blind) collected ($30)
Seat 3: floriiiiider (big blind) folded before Flop
Seat 4: EtniX111 folded before Flop (didn't bet)
Seat 6: uripeleg folded before Flop


PokerStars Game #102597212529:  Hold'em No Limit ($3/$6 USD) - 2013/08/11 5:26:06 ET
Table 'Dnoces II 40-100 bb' 6-max Seat #2 is the button
Seat 1: ZarubaNT ($606 in chips) 
Seat 2: ChowYuenFatt ($603 in chips) 
Seat 3: floriiiiider ($1039.66 in chips) 
Seat 4: EtniX111 ($654.20 in chips) 
Seat 6: uripeleg ($664.98 in chips) 
floriiiiider: posts small blind $3
EtniX111: posts big blind $6
shenghu: sits out 
*** HOLE CARDS ***
uripeleg: folds 
ZarubaNT: folds 
ChowYuenFatt: raises $9 to $15
floriiiiider: folds 
EtniX111: folds 
Uncalled bet ($9) returned to ChowYuenFatt
ChowYuenFatt collected $15 from pot
ChowYuenFatt: doesn't show hand 
*** SUMMARY ***
Total pot $15 | Rake $0 
Seat 1: ZarubaNT folded before Flop (didn't bet)
Seat 2: ChowYuenFatt (button) collected ($15)
Seat 3: floriiiiider (small blind) folded before Flop
Seat 4: EtniX111 (big blind) folded before Flop
Seat 6: uripeleg folded before Flop (didn't bet)


PokerStars Game #102597222198:  Hold'em No Limit ($3/$6 USD) - 2013/08/11 5:26:30 ET
Table 'Dnoces II 40-100 bb' 6-max Seat #3 is the button
Seat 1: ZarubaNT ($606 in chips) 
Seat 2: ChowYuenFatt ($612 in chips) 
Seat 3: floriiiiider ($1036.66 in chips) 
Seat 4: EtniX111 ($648.20 in chips) 
Seat 5: shenghu ($500 in chips) 
Seat 6: uripeleg ($664.98 in chips) 
EtniX111: posts small blind $3
shenghu: posts big blind $6
*** HOLE CARDS ***
uripeleg: folds 
ZarubaNT: folds 
ChowYuenFatt: folds 
floriiiiider: raises $6 to $12
EtniX111: folds 
shenghu: calls $6
*** FLOP *** [2d 5c Kd]
shenghu: bets $12
floriiiiider: calls $12
*** TURN *** [2d 5c Kd] [4h]
shenghu: checks 
floriiiiider: bets $33
shenghu: calls $33
*** RIVER *** [2d 5c Kd 4h] [7s]
shenghu: bets $48
floriiiiider: calls $48
*** SHOW DOWN ***
shenghu: shows [Qh 3d] (high card King)
floriiiiider: shows [5s Ts] (a pair of Fives)
floriiiiider collected $210.20 from pot
*** SUMMARY ***
Total pot $213 | Rake $2.80 
Board [2d 5c Kd 4h 7s]
Seat 1: ZarubaNT folded before Flop (didn't bet)
Seat 2: ChowYuenFatt folded before Flop (didn't bet)
Seat 3: floriiiiider (button) showed [5s Ts] and won ($210.20) with a pair of Fives
Seat 4: EtniX111 (small blind) folded before Flop
Seat 5: shenghu (big blind) showed [Qh 3d] and lost with high card King
Seat 6: uripeleg folded before Flop (didn't bet)


PokerStars Game #102597249403:  Hold'em No Limit ($3/$6 USD) - 2013/08/11 5:27:39 ET
Table 'Dnoces II 40-100 bb' 6-max Seat #4 is the button
Seat 1: ZarubaNT ($606 in chips) 
Seat 2: ChowYuenFatt ($612 in chips) 
Seat 3: floriiiiider ($1141.86 in chips) 
Seat 4: EtniX111 ($645.20 in chips) 
Seat 5: shenghu ($395 in chips) 
Seat 6: uripeleg ($664.98 in chips) 
shenghu: posts small blind $3
uripeleg: posts big blind $6
*** HOLE CARDS ***
ZarubaNT: folds 
ChowYuenFatt: folds 
floriiiiider: folds 
EtniX111: folds 
shenghu: raises $6 to $12
uripeleg: calls $6
*** FLOP *** [8c 6d Kh]
shenghu: checks 
uripeleg: bets $11.46
shenghu: calls $11.46
*** TURN *** [8c 6d Kh] [4s]
shenghu: checks 
uripeleg: bets $36
shenghu: folds 
Uncalled bet ($36) returned to uripeleg
uripeleg collected $44.81 from pot
*** SUMMARY ***
Total pot $46.92 | Rake $2.11 
Board [8c 6d Kh 4s]
Seat 1: ZarubaNT folded before Flop (didn't bet)
Seat 2: ChowYuenFatt folded before Flop (didn't bet)
Seat 3: floriiiiider folded before Flop (didn't bet)
Seat 4: EtniX111 (button) folded before Flop (didn't bet)
Seat 5: shenghu (small blind) folded on the Turn
Seat 6: uripeleg (big blind) collected ($44.81)


PokerStars Game #102597263708:  Hold'em No Limit ($3/$6 USD) - 2013/08/11 5:28:15 ET
Table 'Dnoces II 40-100 bb' 6-max Seat #5 is the button
Seat 2: ChowYuenFatt ($612 in chips) 
Seat 3: floriiiiider ($1141.86 in chips) 
Seat 4: EtniX111 ($645.20 in chips) 
Seat 5: shenghu ($371.54 in chips) 
Seat 6: uripeleg ($686.33 in chips) 
uripeleg: posts small blind $3
ZarubaNT: is sitting out 
ChowYuenFatt: posts big blind $6
*** HOLE CARDS ***
floriiiiider: folds 
EtniX111: folds 
shenghu: raises $6 to $12
uripeleg: folds 
ChowYuenFatt: folds 
Uncalled bet ($6) returned to shenghu
shenghu collected $15 from pot
*** SUMMARY ***
Total pot $15 | Rake $0 
Seat 2: ChowYuenFatt (big blind) folded before Flop
Seat 3: floriiiiider folded before Flop (didn't bet)
Seat 4: EtniX111 folded before Flop (didn't bet)
Seat 5: shenghu (button) collected ($15)
Seat 6: uripeleg (small blind) folded before Flop


PokerStars Game #102597269609:  Hold'em No Limit ($3/$6 USD) - 2013/08/11 5:28:30 ET
Table 'Dnoces II 40-100 bb' 6-max Seat #6 is the button
Seat 2: ChowYuenFatt ($606 in chips) 
Seat 3: floriiiiider ($1141.86 in chips) 
Seat 4: EtniX111 ($645.20 in chips) 
Seat 5: shenghu ($380.54 in chips) 
Seat 6: uripeleg ($683.33 in chips) 
ZarubaNT will be allowed to play after the button
ChowYuenFatt: posts small blind $3
floriiiiider: posts big blind $6
*** HOLE CARDS ***
EtniX111: raises $12 to $18
shenghu: folds 
uripeleg: folds 
ChowYuenFatt: raises $31 to $49
floriiiiider: folds 
EtniX111: calls $31
*** FLOP *** [Jd 5c 3c]
ChowYuenFatt: bets $79
EtniX111: folds 
Uncalled bet ($79) returned to ChowYuenFatt
ChowYuenFatt collected $101.20 from pot
ChowYuenFatt: doesn't show hand 
*** SUMMARY ***
Total pot $104 | Rake $2.80 
Board [Jd 5c 3c]
Seat 2: ChowYuenFatt (small blind) collected ($101.20)
Seat 3: floriiiiider (big blind) folded before Flop
Seat 4: EtniX111 folded on the Flop
Seat 5: shenghu folded before Flop (didn't bet)
Seat 6: uripeleg (button) folded before Flop (didn't bet)


PokerStars Game #102597284250:  Hold'em No Limit ($3/$6 USD) - 2013/08/11 5:29:07 ET
Table 'Dnoces II 40-100 bb' 6-max Seat #2 is the button
Seat 2: ChowYuenFatt ($658.20 in chips) 
Seat 3: floriiiiider ($1135.86 in chips) 
Seat 5: shenghu ($380.54 in chips) 
Seat 6: uripeleg ($683.33 in chips) 
floriiiiider: posts small blind $3
EtniX111: is sitting out 
shenghu: posts big blind $6
ZarubaNT: sits out 
*** HOLE CARDS ***
EtniX111 leaves the table
uripeleg: folds 
vjxbkf joins the table at seat #4 
ChowYuenFatt: raises $9 to $15
floriiiiider: raises $33 to $48
shenghu: folds 
ChowYuenFatt: raises $51 to $99
floriiiiider: raises $1036.86 to $1135.86 and is all-in
ChowYuenFatt: folds 
Uncalled bet ($1036.86) returned to floriiiiider
floriiiiider collected $204 from pot
floriiiiider: doesn't show hand 
*** SUMMARY ***
Total pot $204 | Rake $0 
Seat 2: ChowYuenFatt (button) folded before Flop
Seat 3: floriiiiider (small blind) collected ($204)
Seat 5: shenghu (big blind) folded before Flop
Seat 6: uripeleg folded before Flop (didn't bet)


PokerStars Game #102597301126:  Hold'em No Limit ($3/$6 USD) - 2013/08/11 5:29:50 ET
Table 'Dnoces II 40-100 bb' 6-max Seat #3 is the button
Seat 2: ChowYuenFatt ($559.20 in chips) 
Seat 3: floriiiiider ($1240.86 in chips) 
Seat 5: shenghu ($374.54 in chips) 
Seat 6: uripeleg ($683.33 in chips) 
vjxbkf will be allowed to play after the button
shenghu: posts small blind $3
uripeleg: posts big blind $6
ZarubaNT: sits out 
*** HOLE CARDS ***
ChowYuenFatt: folds 
floriiiiider: raises $6 to $12
shenghu: raises $6 to $18
uripeleg: folds 
floriiiiider: calls $6
*** FLOP *** [5h 4s 8c]
shenghu: checks 
floriiiiider: checks 
*** TURN *** [5h 4s 8c] [6s]
shenghu: bets $12
floriiiiider: calls $12
*** RIVER *** [5h 4s 8c 6s] [Ac]
shenghu: bets $12
floriiiiider: folds 
Uncalled bet ($12) returned to shenghu
shenghu collected $64.50 from pot
*** SUMMARY ***
Total pot $66 | Rake $1.50 
Board [5h 4s 8c 6s Ac]
Seat 2: ChowYuenFatt folded before Flop (didn't bet)
Seat 3: floriiiiider (button) folded on the River
Seat 5: shenghu (small blind) collected ($64.50)
Seat 6: uripeleg (big blind) folded before Flop


PokerStars Game #102597128458:  Hold'em No Limit ($3/$6 USD) - 2013/08/11 5:22:37 ET
Table 'Dnoces II 40-100 bb' 6-max Seat #5 is the button
Seat 1: ZarubaNT ($600 in chips) 
Seat 2: ChowYuenFatt ($600 in chips) 
Seat 5: vjxbkf ($1170.95 in chips) 
uripeleg will be allowed to play after the button
ZarubaNT: posts small blind $3
ChowYuenFatt: posts big blind $6
floriiiiider: sits out 
EtniX111: sits out 
*** HOLE CARDS ***
vjxbkf: raises $6 to $12
ZarubaNT: folds 
ChowYuenFatt: folds 
Uncalled bet ($6) returned to vjxbkf
vjxbkf collected $15 from pot
vjxbkf: doesn't show hand 
*** SUMMARY ***
Total pot $15 | Rake $0 
Seat 1: ZarubaNT (small blind) folded before Flop
Seat 2: ChowYuenFatt (big blind) folded before Flop
Seat 5: vjxbkf (button) collected ($15)


PokerStars Game #102597137025:  Hold'em No Limit ($3/$6 USD) - 2013/08/11 5:22:58 ET
Table 'Dnoces II 40-100 bb' 6-max Seat #1 is the button
Seat 1: ZarubaNT ($600 in chips) 
Seat 2: ChowYuenFatt ($594 in chips) 
Seat 3: floriiiiider ($1088.88 in chips) 
Seat 5: vjxbkf ($1179.95 in chips) 
ChowYuenFatt: posts small blind $3
floriiiiider: posts big blind $6
EtniX111: sits out 
uripeleg: sits out 
*** HOLE CARDS ***
vjxbkf: raises $12 to $18
ZarubaNT: folds 
ChowYuenFatt: folds 
floriiiiider: folds 
Uncalled bet ($12) returned to vjxbkf
vjxbkf collected $15 from pot
vjxbkf: doesn't show hand 
*** SUMMARY ***
Total pot $15 | Rake $0 
Seat 1: ZarubaNT (button) folded before Flop (didn't bet)
Seat 2: ChowYuenFatt (small blind) folded before Flop
Seat 3: floriiiiider (big blind) folded before Flop
Seat 5: vjxbkf collected ($15)


PokerStars Game #102597143758:  Hold'em No Limit ($3/$6 USD) - 2013/08/11 5:23:15 ET
Table 'Dnoces II 40-100 bb' 6-max Seat #2 is the button
Seat 1: ZarubaNT ($600 in chips) 
Seat 2: ChowYuenFatt ($591 in chips) 
Seat 3: floriiiiider ($1082.88 in chips) 
Seat 4: EtniX111 ($600 in chips) 
Seat 5: vjxbkf ($1188.95 in chips) 
floriiiiider: posts small blind $3
EtniX111: posts big blind $6
uripeleg: sits out 
*** HOLE CARDS ***
vjxbkf: folds 
ZarubaNT: folds 
ChowYuenFatt: folds 
floriiiiider: folds 
Uncalled bet ($3) returned to EtniX111
EtniX111 collected $6 from pot
EtniX111: doesn't show hand 
*** SUMMARY ***
Total pot $6 | Rake $0 
Seat 1: ZarubaNT folded before Flop (didn't bet)
Seat 2: ChowYuenFatt (button) folded before Flop (didn't bet)
Seat 3: floriiiiider (small blind) folded before Flop
Seat 4: EtniX111 (big blind) collected ($6)
Seat 5: vjxbkf folded before Flop (didn't bet)


PokerStars Game #102597149648:  Hold'em No Limit ($3/$6 USD) - 2013/08/11 5:23:30 ET
Table 'Dnoces II 40-100 bb' 6-max Seat #3 is the button
Seat 1: ZarubaNT ($600 in chips) 
Seat 2: ChowYuenFatt ($591 in chips) 
Seat 3: floriiiiider ($1079.88 in chips) 
Seat 4: EtniX111 ($603 in chips) 
Seat 6: uripeleg ($691.98 in chips) 
EtniX111: posts small blind $3
vjxbkf: is sitting out 
uripeleg: posts big blind $6
*** HOLE CARDS ***
ZarubaNT: folds 
ChowYuenFatt: folds 
vjxbkf leaves the table
floriiiiider: raises $6 to $12
EtniX111: folds 
uripeleg: calls $6
*** FLOP *** [4d Jd 2h]
uripeleg: checks 
floriiiiider: bets $21
uripeleg: folds 
Uncalled bet ($21) returned to floriiiiider
floriiiiider collected $25.78 from pot
floriiiiider: doesn't show hand 
*** SUMMARY ***
Total pot $27 | Rake $1.22 
Board [4d Jd 2h]
Seat 1: ZarubaNT folded before Flop (didn't bet)
Seat 2: ChowYuenFatt folded before Flop (didn't bet)
Seat 3: floriiiiider (button) collected ($25.78)
Seat 4: EtniX111 (small blind) folded before Flop
Seat 6: uripeleg (big blind) folded on the Flop


PokerStars Game #102597163544:  Hold'em No Limit ($3/$6 USD) - 2013/08/11 5:24:04 ET
Table 'Dnoces II 40-100 bb' 6-max Seat #4 is the button
Seat 1: ZarubaNT ($600 in chips) 
Seat 2: ChowYuenFatt ($591 in chips) 
Seat 3: floriiiiider ($1093.66 in chips) 
Seat 4: EtniX111 ($600 in chips) 
Seat 6: uripeleg ($679.98 in chips) 
uripeleg: posts small blind $3
ZarubaNT: posts big blind $6
*** HOLE CARDS ***
ChowYuenFatt: folds 
Ratatuj joins the table at seat #5 
floriiiiider: raises $9 to $15
Ratatuj leaves the table
EtniX111: raises $33 to $48
uripeleg: folds 
ZarubaNT: folds 
floriiiiider: calls $33
*** FLOP *** [5d 5h 2d]
floriiiiider: checks 
shenghu joins the table at seat #5 
EtniX111: checks 
*** TURN *** [5d 5h 2d] [Qs]
floriiiiider: checks 
EtniX111: bets $68
floriiiiider: folds 
Uncalled bet ($68) returned to EtniX111
EtniX111 collected $102.20 from pot
EtniX111: doesn't show hand 
*** SUMMARY ***
Total pot $105 | Rake $2.80 
Board [5d 5h 2d Qs]
Seat 1: ZarubaNT (big blind) folded before Flop
Seat 2: ChowYuenFatt folded before Flop (didn't bet)
Seat 3: floriiiiider folded on the Turn
Seat 4: EtniX111 (button) collected ($102.20)
Seat 6: uripeleg (small blind) folded before Flop


PokerStars Game #102597093329:  Hold'em No Limit ($3/$6 USD) - 2013/08/11 5:21:11 ET
Table 'Dnoces II 40-100 bb' 6-max Seat #5 is the button
Seat 1: ZarubaNT ($630.98 in chips) 
Seat 5: vjxbkf ($1021.45 in chips) 
ChowYuenFatt will be allowed to play after the button
floriiiiider will be allowed to play after the button
vjxbkf: posts small blind $3
uripeleg: is sitting out 
ZarubaNT: posts big blind $6
*** HOLE CARDS ***
vjxbkf: raises $6 to $12
ZarubaNT: calls $6
*** FLOP *** [9d 4s 5c]
ZarubaNT: checks 
vjxbkf: bets $15
ZarubaNT: calls $15
*** TURN *** [9d 4s 5c] [3d]
ZarubaNT: checks 
EtniX111 joins the table at seat #4 
vjxbkf: bets $36
ZarubaNT: calls $36
*** RIVER *** [9d 4s 5c 3d] [Jc]
ZarubaNT: checks 
vjxbkf: bets $87
ZarubaNT: calls $87
*** SHOW DOWN ***
vjxbkf: shows [6s 7d] (a straight, Three to Seven)
ZarubaNT: mucks hand 
vjxbkf collected $299.50 from pot
*** SUMMARY ***
Total pot $300 | Rake $0.50 
Board [9d 4s 5c 3d Jc]
Seat 1: ZarubaNT (big blind) mucked
Seat 5: vjxbkf (button) (small blind) showed [6s 7d] and won ($299.50) with a straight, Three to Seven


PokerStars Game #102596946151:  Hold'em No Limit ($3/$6 USD) - 2013/08/11 5:15:00 ET
Table 'Dnoces II 40-100 bb' 6-max Seat #4 is the button
Seat 1: ZarubaNT ($609 in chips) 
Seat 2: Ratatuj ($233.58 in chips) 
Seat 3: QB0970016888 ($64.92 in chips) 
Seat 4: floriiiiider ($1097.88 in chips) 
Seat 5: vjxbkf ($1045.45 in chips) 
Seat 6: uripeleg ($690.20 in chips) 
vjxbkf: posts small blind $3
uripeleg: posts big blind $6
*** HOLE CARDS ***
ZarubaNT: raises $12 to $18
Ratatuj: folds 
QB0970016888: folds 
floriiiiider: folds 
vjxbkf: folds 
uripeleg: folds 
Uncalled bet ($12) returned to ZarubaNT
ZarubaNT collected $15 from pot
ZarubaNT: doesn't show hand 
*** SUMMARY ***
Total pot $15 | Rake $0 
Seat 1: ZarubaNT collected ($15)
Seat 2: Ratatuj folded before Flop (didn't bet)
Seat 3: QB0970016888 folded before Flop (didn't bet)
Seat 4: floriiiiider (button) folded before Flop (didn't bet)
Seat 5: vjxbkf (small blind) folded before Flop
Seat 6: uripeleg (big blind) folded before Flop


PokerStars Game #102596958498:  Hold'em No Limit ($3/$6 USD) - 2013/08/11 5:15:31 ET
Table 'Dnoces II 40-100 bb' 6-max Seat #5 is the button
Seat 1: ZarubaNT ($618 in chips) 
Seat 2: Ratatuj ($233.58 in chips) 
Seat 3: QB0970016888 ($64.92 in chips) 
Seat 4: floriiiiider ($1097.88 in chips) 
Seat 5: vjxbkf ($1042.45 in chips) 
Seat 6: uripeleg ($684.20 in chips) 
uripeleg: posts small blind $3
ZarubaNT: posts big blind $6
*** HOLE CARDS ***
Ratatuj: raises $7.38 to $13.38
QB0970016888: folds 
floriiiiider: folds 
vjxbkf: folds 
uripeleg: folds 
ZarubaNT: folds 
Uncalled bet ($7.38) returned to Ratatuj
Ratatuj collected $15 from pot
Ratatuj: doesn't show hand 
*** SUMMARY ***
Total pot $15 | Rake $0 
Seat 1: ZarubaNT (big blind) folded before Flop
Seat 2: Ratatuj collected ($15)
Seat 3: QB0970016888 folded before Flop (didn't bet)
Seat 4: floriiiiider folded before Flop (didn't bet)
Seat 5: vjxbkf (button) folded before Flop (didn't bet)
Seat 6: uripeleg (small blind) folded before Flop


PokerStars Game #102596970132:  Hold'em No Limit ($3/$6 USD) - 2013/08/11 5:16:00 ET
Table 'Dnoces II 40-100 bb' 6-max Seat #6 is the button
Seat 1: ZarubaNT ($612 in chips) 
Seat 2: Ratatuj ($242.58 in chips) 
Seat 3: QB0970016888 ($64.92 in chips) 
Seat 4: floriiiiider ($1097.88 in chips) 
Seat 5: vjxbkf ($1042.45 in chips) 
Seat 6: uripeleg ($681.20 in chips) 
ZarubaNT: posts small blind $3
Ratatuj: posts big blind $6
*** HOLE CARDS ***
QB0970016888: folds 
floriiiiider: folds 
vjxbkf: folds 
uripeleg: raises $6 to $12
ZarubaNT: folds 
Ratatuj: folds 
Uncalled bet ($6) returned to uripeleg
uripeleg collected $15 from pot
*** SUMMARY ***
Total pot $15 | Rake $0 
Seat 1: ZarubaNT (small blind) folded before Flop
Seat 2: Ratatuj (big blind) folded before Flop
Seat 3: QB0970016888 folded before Flop (didn't bet)
Seat 4: floriiiiider folded before Flop (didn't bet)
Seat 5: vjxbkf folded before Flop (didn't bet)
Seat 6: uripeleg (button) collected ($15)


PokerStars Game #102596981981:  Hold'em No Limit ($3/$6 USD) - 2013/08/11 5:16:30 ET
Table 'Dnoces II 40-100 bb' 6-max Seat #1 is the button
Seat 1: ZarubaNT ($609 in chips) 
Seat 2: Ratatuj ($236.58 in chips) 
Seat 3: QB0970016888 ($64.92 in chips) 
Seat 4: floriiiiider ($1097.88 in chips) 
Seat 5: vjxbkf ($1042.45 in chips) 
Seat 6: uripeleg ($690.20 in chips) 
Ratatuj: posts small blind $3
QB0970016888: posts big blind $6
*** HOLE CARDS ***
floriiiiider: folds 
vjxbkf: folds 
uripeleg: folds 
ZarubaNT: raises $6 to $12
Ratatuj: folds 
QB0970016888: raises $52.92 to $64.92 and is all-in
ZarubaNT: folds 
Uncalled bet ($52.92) returned to QB0970016888
QB0970016888 collected $27 from pot
*** SUMMARY ***
Total pot $27 | Rake $0 
Seat 1: ZarubaNT (button) folded before Flop
Seat 2: Ratatuj (small blind) folded before Flop
Seat 3: QB0970016888 (big blind) collected ($27)
Seat 4: floriiiiider folded before Flop (didn't bet)
Seat 5: vjxbkf folded before Flop (didn't bet)
Seat 6: uripeleg folded before Flop (didn't bet)


PokerStars Game #102596995916:  Hold'em No Limit ($3/$6 USD) - 2013/08/11 5:17:06 ET
Table 'Dnoces II 40-100 bb' 6-max Seat #2 is the button
Seat 1: ZarubaNT ($600 in chips) 
Seat 2: Ratatuj ($233.58 in chips) 
Seat 3: QB0970016888 ($79.92 in chips) 
Seat 4: floriiiiider ($1097.88 in chips) 
Seat 5: vjxbkf ($1042.45 in chips) 
Seat 6: uripeleg ($690.20 in chips) 
QB0970016888: posts small blind $3
floriiiiider: posts big blind $6
*** HOLE CARDS ***
vjxbkf: folds 
uripeleg: raises $6 to $12
ZarubaNT: calls $12
Ratatuj: calls $12
QB0970016888: folds 
floriiiiider: folds 
*** FLOP *** [6h Jh Qd]
uripeleg: checks 
ZarubaNT: bets $27
Ratatuj: folds 
uripeleg: folds 
Uncalled bet ($27) returned to ZarubaNT
ZarubaNT collected $42.98 from pot
ZarubaNT: doesn't show hand 
*** SUMMARY ***
Total pot $45 | Rake $2.02 
Board [6h Jh Qd]
Seat 1: ZarubaNT collected ($42.98)
Seat 2: Ratatuj (button) folded on the Flop
Seat 3: QB0970016888 (small blind) folded before Flop
Seat 4: floriiiiider (big blind) folded before Flop
Seat 5: vjxbkf folded before Flop (didn't bet)
Seat 6: uripeleg folded on the Flop


PokerStars Game #102597021689:  Hold'em No Limit ($3/$6 USD) - 2013/08/11 5:18:10 ET
Table 'Dnoces II 40-100 bb' 6-max Seat #3 is the button
Seat 1: ZarubaNT ($630.98 in chips) 
Seat 2: Ratatuj ($221.58 in chips) 
Seat 3: QB0970016888 ($76.92 in chips) 
Seat 4: floriiiiider ($1091.88 in chips) 
Seat 5: vjxbkf ($1042.45 in chips) 
Seat 6: uripeleg ($678.20 in chips) 
floriiiiider: posts small blind $3
vjxbkf: posts big blind $6
*** HOLE CARDS ***
uripeleg: folds 
ZarubaNT: folds 
Ratatuj: raises $6 to $12
QB0970016888: raises $64.92 to $76.92 and is all-in
floriiiiider: folds 
vjxbkf: folds 
Ratatuj: calls $64.92
*** FLOP *** [9d 7d 8d]
*** TURN *** [9d 7d 8d] [2c]
*** RIVER *** [9d 7d 8d 2c] [Ts]
*** SHOW DOWN ***
Ratatuj: shows [Qd Kd] (a flush, King high)
QB0970016888: shows [9c As] (a pair of Nines)
Ratatuj collected $160.04 from pot
*** SUMMARY ***
Total pot $162.84 | Rake $2.80 
Board [9d 7d 8d 2c Ts]
Seat 1: ZarubaNT folded before Flop (didn't bet)
Seat 2: Ratatuj showed [Qd Kd] and won ($160.04) with a flush, King high
Seat 3: QB0970016888 (button) showed [9c As] and lost with a pair of Nines
Seat 4: floriiiiider (small blind) folded before Flop
Seat 5: vjxbkf (big blind) folded before Flop
Seat 6: uripeleg folded before Flop (didn't bet)


PokerStars Game #102597038582:  Hold'em No Limit ($3/$6 USD) - 2013/08/11 5:18:53 ET
Table 'Dnoces II 40-100 bb' 6-max Seat #4 is the button
Seat 1: ZarubaNT ($630.98 in chips) 
Seat 2: Ratatuj ($304.70 in chips) 
Seat 4: floriiiiider ($1088.88 in chips) 
Seat 5: vjxbkf ($1036.45 in chips) 
Seat 6: uripeleg ($678.20 in chips) 
vjxbkf: posts small blind $3
uripeleg: posts big blind $6
*** HOLE CARDS ***
ZarubaNT: folds 
QB0970016888 leaves the table
Ratatuj: folds 
floriiiiider: folds 
vjxbkf: folds 
Uncalled bet ($3) returned to uripeleg
uripeleg collected $6 from pot
*** SUMMARY ***
Total pot $6 | Rake $0 
Seat 1: ZarubaNT folded before Flop (didn't bet)
Seat 2: Ratatuj folded before Flop (didn't bet)
Seat 4: floriiiiider (button) folded before Flop (didn't bet)
Seat 5: vjxbkf (small blind) folded before Flop
Seat 6: uripeleg (big blind) collected ($6)


PokerStars Game #102597047790:  Hold'em No Limit ($3/$6 USD) - 2013/08/11 5:19:16 ET
Table 'Dnoces II 40-100 bb' 6-max Seat #5 is the button
Seat 1: ZarubaNT ($630.98 in chips) 
Seat 2: Ratatuj ($304.70 in chips) 
Seat 4: floriiiiider ($1088.88 in chips) 
Seat 5: vjxbkf ($1033.45 in chips) 
Seat 6: uripeleg ($681.20 in chips) 
uripeleg: posts small blind $3
ZarubaNT: posts big blind $6
*** HOLE CARDS ***
Ratatuj: folds 
floriiiiider: folds 
vjxbkf: folds 
uripeleg: folds 
Uncalled bet ($3) returned to ZarubaNT
ZarubaNT collected $6 from pot
ZarubaNT: doesn't show hand 
*** SUMMARY ***
Total pot $6 | Rake $0 
Seat 1: ZarubaNT (big blind) collected ($6)
Seat 2: Ratatuj folded before Flop (didn't bet)
Seat 4: floriiiiider folded before Flop (didn't bet)
Seat 5: vjxbkf (button) folded before Flop (didn't bet)
Seat 6: uripeleg (small blind) folded before Flop


PokerStars Game #102597055622:  Hold'em No Limit ($3/$6 USD) - 2013/08/11 5:19:36 ET
Table 'Dnoces II 40-100 bb' 6-max Seat #6 is the button
Seat 1: ZarubaNT ($633.98 in chips) 
Seat 5: vjxbkf ($1033.45 in chips) 
Seat 6: uripeleg ($678.20 in chips) 
ZarubaNT: posts small blind $3
JulyShort joins the table at seat #3 
Ratatuj: is sitting out 
floriiiiider: is sitting out 
Ratatuj leaves the table
vjxbkf: posts big blind $6
*** HOLE CARDS ***
JulyShort leaves the table
floriiiiider leaves the table
EtniX111 joins the table at seat #2 
uripeleg: raises $6 to $12
EtniX111 leaves the table
ZarubaNT: folds 
ChowYuenFatt joins the table at seat #2 
floriiiiider joins the table at seat #3 
vjxbkf: calls $6
*** FLOP *** [Td Qh Jd]
vjxbkf: checks 
uripeleg: bets $20.62
vjxbkf: folds 
Uncalled bet ($20.62) returned to uripeleg
uripeleg collected $25.78 from pot
*** SUMMARY ***
Total pot $27 | Rake $1.22 
Board [Td Qh Jd]
Seat 1: ZarubaNT (small blind) folded before Flop
Seat 5: vjxbkf (big blind) folded on the Flop
Seat 6: uripeleg (button) collected ($25.78)


PokerStars Game #102597570116:  Hold'em No Limit ($3/$6 USD) - 2013/08/11 5:41:06 ET
Table 'Dnoces II 40-100 bb' 6-max Seat #3 is the button
Seat 1: ZarubaNT ($600 in chips) 
Seat 2: ChowYuenFatt ($751.68 in chips) 
Seat 3: floriiiiider ($1195.96 in chips) 
Seat 4: vjxbkf ($1193.73 in chips) 
Seat 5: shenghu ($247.04 in chips) 
Seat 6: uripeleg ($680.55 in chips) 
vjxbkf: posts small blind $3
shenghu: posts big blind $6
*** HOLE CARDS ***
uripeleg: folds 
ZarubaNT: folds 
ChowYuenFatt: raises $9 to $15
floriiiiider: folds 
vjxbkf: folds 
shenghu: raises $21 to $36
ChowYuenFatt: calls $21
*** FLOP *** [8c 5d Qh]
shenghu: bets $30
ChowYuenFatt: raises $68 to $98
shenghu: raises $113.04 to $211.04 and is all-in
ChowYuenFatt: calls $113.04
*** TURN *** [8c 5d Qh] [9s]
*** RIVER *** [8c 5d Qh 9s] [Kc]
*** SHOW DOWN ***
shenghu: shows [Js Qc] (a pair of Queens)
ChowYuenFatt: shows [Jc Ad] (high card Ace)
shenghu collected $494.28 from pot
*** SUMMARY ***
Total pot $497.08 | Rake $2.80 
Board [8c 5d Qh 9s Kc]
Seat 1: ZarubaNT folded before Flop (didn't bet)
Seat 2: ChowYuenFatt showed [Jc Ad] and lost with high card Ace
Seat 3: floriiiiider (button) folded before Flop (didn't bet)
Seat 4: vjxbkf (small blind) folded before Flop
Seat 5: shenghu (big blind) showed [Js Qc] and won ($494.28) with a pair of Queens
Seat 6: uripeleg folded before Flop (didn't bet)


PokerStars Game #102597597426:  Hold'em No Limit ($3/$6 USD) - 2013/08/11 5:42:12 ET
Table 'Dnoces II 40-100 bb' 6-max Seat #4 is the button
Seat 1: ZarubaNT ($600 in chips) 
Seat 2: ChowYuenFatt ($504.64 in chips) 
Seat 3: floriiiiider ($1195.96 in chips) 
Seat 4: vjxbkf ($1190.73 in chips) 
Seat 5: shenghu ($494.28 in chips) 
Seat 6: uripeleg ($680.55 in chips) 
shenghu: posts small blind $3
uripeleg: posts big blind $6
*** HOLE CARDS ***
ZarubaNT: raises $12 to $18
ChowYuenFatt: raises $24 to $42
floriiiiider: folds 
vjxbkf: folds 
shenghu: folds 
uripeleg: folds 
ZarubaNT: folds 
Uncalled bet ($24) returned to ChowYuenFatt
ChowYuenFatt collected $45 from pot
ChowYuenFatt: doesn't show hand 
*** SUMMARY ***
Total pot $45 | Rake $0 
Seat 1: ZarubaNT folded before Flop
Seat 2: ChowYuenFatt collected ($45)
Seat 3: floriiiiider folded before Flop (didn't bet)
Seat 4: vjxbkf (button) folded before Flop (didn't bet)
Seat 5: shenghu (small blind) folded before Flop
Seat 6: uripeleg (big blind) folded before Flop


PokerStars Game #102597611799:  Hold'em No Limit ($3/$6 USD) - 2013/08/11 5:42:47 ET
Table 'Dnoces II 40-100 bb' 6-max Seat #5 is the button
Seat 1: ZarubaNT ($600 in chips) 
Seat 2: ChowYuenFatt ($531.64 in chips) 
Seat 3: floriiiiider ($1195.96 in chips) 
Seat 4: vjxbkf ($1190.73 in chips) 
Seat 5: shenghu ($491.28 in chips) 
Seat 6: uripeleg ($674.55 in chips) 
uripeleg: posts small blind $3
ZarubaNT: posts big blind $6
*** HOLE CARDS ***
ChowYuenFatt: raises $9 to $15
floriiiiider: folds 
vjxbkf: folds 
shenghu: calls $15
uripeleg: calls $12
ZarubaNT: folds 
*** FLOP *** [Ah Js 6h]
uripeleg: checks 
ChowYuenFatt: bets $36
shenghu: folds 
uripeleg: calls $36
*** TURN *** [Ah Js 6h] [Qh]
uripeleg: checks 
ChowYuenFatt: checks 
*** RIVER *** [Ah Js 6h Qh] [9c]
uripeleg: checks 
ChowYuenFatt: bets $89
uripeleg: calls $89
*** SHOW DOWN ***
ChowYuenFatt: shows [Qc Kc] (a pair of Queens)
uripeleg: shows [Ad 9d] (two pair, Aces and Nines)
uripeleg collected $298.20 from pot
*** SUMMARY ***
Total pot $301 | Rake $2.80 
Board [Ah Js 6h Qh 9c]
Seat 1: ZarubaNT (big blind) folded before Flop
Seat 2: ChowYuenFatt showed [Qc Kc] and lost with a pair of Queens
Seat 3: floriiiiider folded before Flop (didn't bet)
Seat 4: vjxbkf folded before Flop (didn't bet)
Seat 5: shenghu (button) folded on the Flop
Seat 6: uripeleg (small blind) showed [Ad 9d] and won ($298.20) with two pair, Aces and Nines


PokerStars Game #102597649355:  Hold'em No Limit ($3/$6 USD) - 2013/08/11 5:44:19 ET
Table 'Dnoces II 40-100 bb' 6-max Seat #6 is the button
Seat 1: ZarubaNT ($600 in chips) 
Seat 2: ChowYuenFatt ($600 in chips) 
Seat 3: floriiiiider ($1195.96 in chips) 
Seat 4: vjxbkf ($1190.73 in chips) 
Seat 5: shenghu ($476.28 in chips) 
Seat 6: uripeleg ($832.75 in chips) 
ZarubaNT: posts small blind $3
ChowYuenFatt: posts big blind $6
*** HOLE CARDS ***
floriiiiider: folds 
vjxbkf: raises $15 to $21
shenghu: calls $21
uripeleg: folds 
ZarubaNT: folds 
ChowYuenFatt: folds 
*** FLOP *** [4s Ah 5s]
vjxbkf: bets $39
shenghu: folds 
Uncalled bet ($39) returned to vjxbkf
vjxbkf collected $48.70 from pot
vjxbkf: doesn't show hand 
*** SUMMARY ***
Total pot $51 | Rake $2.30 
Board [4s Ah 5s]
Seat 1: ZarubaNT (small blind) folded before Flop
Seat 2: ChowYuenFatt (big blind) folded before Flop
Seat 3: floriiiiider folded before Flop (didn't bet)
Seat 4: vjxbkf collected ($48.70)
Seat 5: shenghu folded on the Flop
Seat 6: uripeleg (button) folded before Flop (didn't bet)


PokerStars Game #102597439384:  Hold'em No Limit ($3/$6 USD) - 2013/08/11 5:35:37 ET
Table 'Dnoces II 40-100 bb' 6-max Seat #5 is the button
Seat 1: ZarubaNT ($600 in chips) 
Seat 2: ChowYuenFatt ($583.38 in chips) 
Seat 3: floriiiiider ($1201.86 in chips) 
Seat 4: vjxbkf ($1179.95 in chips) 
Seat 5: shenghu ($328.04 in chips) 
Seat 6: uripeleg ($773.55 in chips) 
uripeleg: posts small blind $3
ZarubaNT: posts big blind $6
*** HOLE CARDS ***
ChowYuenFatt: raises $10 to $16
floriiiiider: calls $16
vjxbkf: folds 
shenghu: folds 
uripeleg: folds 
ZarubaNT: folds 
*** FLOP *** [9h 5c 9c]
ChowYuenFatt: bets $29
floriiiiider: calls $29
*** TURN *** [9h 5c 9c] [Td]
ChowYuenFatt: checks 
floriiiiider: bets $66
ChowYuenFatt: calls $66
*** RIVER *** [9h 5c 9c Td] [8h]
ChowYuenFatt: checks 
floriiiiider: checks 
*** SHOW DOWN ***
ChowYuenFatt: shows [Qd Ah] (a pair of Nines)
floriiiiider: shows [Qc Ac] (a pair of Nines)
ChowYuenFatt collected $114.10 from pot
floriiiiider collected $114.10 from pot
*** SUMMARY ***
Total pot $231 | Rake $2.80 
Board [9h 5c 9c Td 8h]
Seat 1: ZarubaNT (big blind) folded before Flop
Seat 2: ChowYuenFatt showed [Qd Ah] and won ($114.10) with a pair of Nines
Seat 3: floriiiiider showed [Qc Ac] and won ($114.10) with a pair of Nines
Seat 4: vjxbkf folded before Flop (didn't bet)
Seat 5: shenghu (button) folded before Flop (didn't bet)
Seat 6: uripeleg (small blind) folded before Flop


PokerStars Game #102597473253:  Hold'em No Limit ($3/$6 USD) - 2013/08/11 5:37:01 ET
Table 'Dnoces II 40-100 bb' 6-max Seat #6 is the button
Seat 1: ZarubaNT ($600 in chips) 
Seat 2: ChowYuenFatt ($586.48 in chips) 
Seat 3: floriiiiider ($1204.96 in chips) 
Seat 4: vjxbkf ($1179.95 in chips) 
Seat 5: shenghu ($328.04 in chips) 
Seat 6: uripeleg ($770.55 in chips) 
ZarubaNT: posts small blind $3
ChowYuenFatt: posts big blind $6
*** HOLE CARDS ***
floriiiiider: folds 
vjxbkf: folds 
shenghu is connected 
shenghu: raises $12 to $18
uripeleg: raises $26 to $44
ZarubaNT: folds 
ChowYuenFatt: raises $46 to $90
shenghu: calls $72
uripeleg: calls $46
*** FLOP *** [3h 9d 3c]
ChowYuenFatt: bets $198
shenghu: folds 
uripeleg: folds 
Uncalled bet ($198) returned to ChowYuenFatt
ChowYuenFatt collected $270.20 from pot
ChowYuenFatt: doesn't show hand 
*** SUMMARY ***
Total pot $273 | Rake $2.80 
Board [3h 9d 3c]
Seat 1: ZarubaNT (small blind) folded before Flop
Seat 2: ChowYuenFatt (big blind) collected ($270.20)
Seat 3: floriiiiider folded before Flop (didn't bet)
Seat 4: vjxbkf folded before Flop (didn't bet)
Seat 5: shenghu folded on the Flop
Seat 6: uripeleg (button) folded on the Flop


PokerStars Game #102597510162:  Hold'em No Limit ($3/$6 USD) - 2013/08/11 5:38:35 ET
Table 'Dnoces II 40-100 bb' 6-max Seat #1 is the button
Seat 1: ZarubaNT ($600 in chips) 
Seat 2: ChowYuenFatt ($766.68 in chips) 
Seat 3: floriiiiider ($1204.96 in chips) 
Seat 4: vjxbkf ($1179.95 in chips) 
Seat 5: shenghu ($238.04 in chips) 
Seat 6: uripeleg ($680.55 in chips) 
ChowYuenFatt: posts small blind $3
floriiiiider: posts big blind $6
*** HOLE CARDS ***
vjxbkf: folds 
shenghu: raises $12 to $18
uripeleg: folds 
ZarubaNT: folds 
ChowYuenFatt: folds 
floriiiiider: folds 
Uncalled bet ($12) returned to shenghu
shenghu collected $15 from pot
*** SUMMARY ***
Total pot $15 | Rake $0 
Seat 1: ZarubaNT (button) folded before Flop (didn't bet)
Seat 2: ChowYuenFatt (small blind) folded before Flop
Seat 3: floriiiiider (big blind) folded before Flop
Seat 4: vjxbkf folded before Flop (didn't bet)
Seat 5: shenghu collected ($15)
Seat 6: uripeleg folded before Flop (didn't bet)


PokerStars Game #102597517563:  Hold'em No Limit ($3/$6 USD) - 2013/08/11 5:38:53 ET
Table 'Dnoces II 40-100 bb' 6-max Seat #2 is the button
Seat 1: ZarubaNT ($600 in chips) 
Seat 2: ChowYuenFatt ($763.68 in chips) 
Seat 3: floriiiiider ($1198.96 in chips) 
Seat 4: vjxbkf ($1179.95 in chips) 
Seat 5: shenghu ($247.04 in chips) 
Seat 6: uripeleg ($680.55 in chips) 
floriiiiider: posts small blind $3
vjxbkf: posts big blind $6
*** HOLE CARDS ***
shenghu is disconnected 
shenghu is connected 
shenghu: folds 
uripeleg: folds 
ZarubaNT: folds 
ChowYuenFatt: raises $6 to $12
floriiiiider: folds 
vjxbkf: calls $6
*** FLOP *** [2d 4c 4d]
vjxbkf: bets $21
ChowYuenFatt: folds 
Uncalled bet ($21) returned to vjxbkf
vjxbkf collected $25.78 from pot
vjxbkf: doesn't show hand 
*** SUMMARY ***
Total pot $27 | Rake $1.22 
Board [2d 4c 4d]
Seat 1: ZarubaNT folded before Flop (didn't bet)
Seat 2: ChowYuenFatt (button) folded on the Flop
Seat 3: floriiiiider (small blind) folded before Flop
Seat 4: vjxbkf (big blind) collected ($25.78)
Seat 5: shenghu folded before Flop (didn't bet)
Seat 6: uripeleg folded before Flop (didn't bet)


PokerStars Game #102597324531:  Hold'em No Limit ($3/$6 USD) - 2013/08/11 5:30:48 ET
Table 'Dnoces II 40-100 bb' 6-max Seat #5 is the button
Seat 1: ZarubaNT ($606 in chips) 
Seat 2: ChowYuenFatt ($559.20 in chips) 
Seat 3: floriiiiider ($1210.86 in chips) 
Seat 5: shenghu ($409.04 in chips) 
Seat 6: uripeleg ($677.33 in chips) 
uripeleg: posts small blind $3
ZarubaNT: posts big blind $6
vjxbkf: sits out 
*** HOLE CARDS ***
ChowYuenFatt: folds 
floriiiiider: folds 
shenghu: raises $12 to $18
uripeleg: folds 
ZarubaNT: folds 
Uncalled bet ($12) returned to shenghu
shenghu collected $15 from pot
*** SUMMARY ***
Total pot $15 | Rake $0 
Seat 1: ZarubaNT (big blind) folded before Flop
Seat 2: ChowYuenFatt folded before Flop (didn't bet)
Seat 3: floriiiiider folded before Flop (didn't bet)
Seat 5: shenghu (button) collected ($15)
Seat 6: uripeleg (small blind) folded before Flop


PokerStars Game #102597332703:  Hold'em No Limit ($3/$6 USD) - 2013/08/11 5:31:09 ET
Table 'Dnoces II 40-100 bb' 6-max Seat #6 is the button
Seat 1: ZarubaNT ($600 in chips) 
Seat 2: ChowYuenFatt ($559.20 in chips) 
Seat 3: floriiiiider ($1210.86 in chips) 
Seat 5: shenghu ($418.04 in chips) 
Seat 6: uripeleg ($674.33 in chips) 
ZarubaNT: posts small blind $3
ChowYuenFatt: posts big blind $6
vjxbkf: sits out 
*** HOLE CARDS ***
floriiiiider: folds 
shenghu: folds 
uripeleg: raises $6 to $12
ZarubaNT: folds 
ChowYuenFatt: calls $6
*** FLOP *** [9d 3d 7s]
ChowYuenFatt: checks 
uripeleg: bets $9.02
ChowYuenFatt: calls $9.02
*** TURN *** [9d 3d 7s] [5d]
ChowYuenFatt: checks 
uripeleg: checks 
*** RIVER *** [9d 3d 7s 5d] [4c]
ChowYuenFatt: bets $39
uripeleg: calls $39
*** SHOW DOWN ***
ChowYuenFatt: shows [7c 5s] (two pair, Sevens and Fives)
uripeleg: shows [7d 6h] (a straight, Three to Seven)
uripeleg collected $120.24 from pot
*** SUMMARY ***
Total pot $123.04 | Rake $2.80 
Board [9d 3d 7s 5d 4c]
Seat 1: ZarubaNT (small blind) folded before Flop
Seat 2: ChowYuenFatt (big blind) showed [7c 5s] and lost with two pair, Sevens and Fives
Seat 3: floriiiiider folded before Flop (didn't bet)
Seat 5: shenghu folded before Flop (didn't bet)
Seat 6: uripeleg (button) showed [7d 6h] and won ($120.24) with a straight, Three to Seven


PokerStars Game #102597363917:  Hold'em No Limit ($3/$6 USD) - 2013/08/11 5:32:29 ET
Table 'Dnoces II 40-100 bb' 6-max Seat #1 is the button
Seat 1: ZarubaNT ($600 in chips) 
Seat 2: ChowYuenFatt ($499.18 in chips) 
Seat 3: floriiiiider ($1210.86 in chips) 
Seat 5: shenghu ($418.04 in chips) 
Seat 6: uripeleg ($734.55 in chips) 
ChowYuenFatt: posts small blind $3
floriiiiider: posts big blind $6
vjxbkf: sits out 
*** HOLE CARDS ***
shenghu: folds 
uripeleg: folds 
ZarubaNT: folds 
ChowYuenFatt: raises $6 to $12
floriiiiider: folds 
Uncalled bet ($6) returned to ChowYuenFatt
ChowYuenFatt collected $12 from pot
ChowYuenFatt: doesn't show hand 
*** SUMMARY ***
Total pot $12 | Rake $0 
Seat 1: ZarubaNT (button) folded before Flop (didn't bet)
Seat 2: ChowYuenFatt (small blind) collected ($12)
Seat 3: floriiiiider (big blind) folded before Flop
Seat 5: shenghu folded before Flop (didn't bet)
Seat 6: uripeleg folded before Flop (didn't bet)


PokerStars Game #102597371425:  Hold'em No Limit ($3/$6 USD) - 2013/08/11 5:32:48 ET
Table 'Dnoces II 40-100 bb' 6-max Seat #2 is the button
Seat 1: ZarubaNT ($600 in chips) 
Seat 2: ChowYuenFatt ($505.18 in chips) 
Seat 3: floriiiiider ($1204.86 in chips) 
Seat 4: vjxbkf ($1188.95 in chips) 
Seat 5: shenghu ($418.04 in chips) 
Seat 6: uripeleg ($734.55 in chips) 
floriiiiider: posts small blind $3
vjxbkf: posts big blind $6
*** HOLE CARDS ***
shenghu: raises $12 to $18
uripeleg: folds 
ZarubaNT: folds 
ChowYuenFatt: calls $18
floriiiiider: folds 
vjxbkf: folds 
*** FLOP *** [Qs 3h 2d]
shenghu: bets $24
ChowYuenFatt: calls $24
*** TURN *** [Qs 3h 2d] [Kc]
shenghu: checks 
ChowYuenFatt: bets $48
shenghu: calls $48
*** RIVER *** [Qs 3h 2d Kc] [4h]
shenghu: checks 
ChowYuenFatt: checks 
*** SHOW DOWN ***
shenghu: shows [Jc Td] (high card King)
ChowYuenFatt: shows [5d 5s] (a pair of Fives)
ChowYuenFatt collected $186.20 from pot
*** SUMMARY ***
Total pot $189 | Rake $2.80 
Board [Qs 3h 2d Kc 4h]
Seat 1: ZarubaNT folded before Flop (didn't bet)
Seat 2: ChowYuenFatt (button) showed [5d 5s] and won ($186.20) with a pair of Fives
Seat 3: floriiiiider (small blind) folded before Flop
Seat 4: vjxbkf (big blind) folded before Flop
Seat 5: shenghu showed [Jc Td] and lost with high card King
Seat 6: uripeleg folded before Flop (didn't bet)


PokerStars Game #102597404069:  Hold'em No Limit ($3/$6 USD) - 2013/08/11 5:34:10 ET
Table 'Dnoces II 40-100 bb' 6-max Seat #3 is the button
Seat 1: ZarubaNT ($600 in chips) 
Seat 2: ChowYuenFatt ($601.38 in chips) 
Seat 3: floriiiiider ($1201.86 in chips) 
Seat 4: vjxbkf ($1182.95 in chips) 
Seat 5: shenghu ($328.04 in chips) 
Seat 6: uripeleg ($734.55 in chips) 
vjxbkf: posts small blind $3
shenghu: posts big blind $6
*** HOLE CARDS ***
uripeleg: folds 
ZarubaNT: folds 
ChowYuenFatt: folds 
floriiiiider: folds 
vjxbkf: folds 
Uncalled bet ($3) returned to shenghu
shenghu collected $6 from pot
*** SUMMARY ***
Total pot $6 | Rake $0 
Seat 1: ZarubaNT folded before Flop (didn't bet)
Seat 2: ChowYuenFatt folded before Flop (didn't bet)
Seat 3: floriiiiider (button) folded before Flop (didn't bet)
Seat 4: vjxbkf (small blind) folded before Flop
Seat 5: shenghu (big blind) collected ($6)
Seat 6: uripeleg folded before Flop (didn't bet)


PokerStars Game #102597412161:  Hold'em No Limit ($3/$6 USD) - 2013/08/11 5:34:30 ET
Table 'Dnoces II 40-100 bb' 6-max Seat #4 is the button
Seat 1: ZarubaNT ($600 in chips) 
Seat 2: ChowYuenFatt ($601.38 in chips) 
Seat 3: floriiiiider ($1201.86 in chips) 
Seat 4: vjxbkf ($1179.95 in chips) 
Seat 5: shenghu ($331.04 in chips) 
Seat 6: uripeleg ($734.55 in chips) 
shenghu: posts small blind $3
uripeleg: posts big blind $6
*** HOLE CARDS ***
ZarubaNT: raises $12 to $18
ChowYuenFatt: calls $18
floriiiiider: folds 
vjxbkf: folds 
shenghu: folds 
uripeleg: raises $57 to $75
ZarubaNT: folds 
ChowYuenFatt: folds 
Uncalled bet ($57) returned to uripeleg
uripeleg collected $57 from pot
*** SUMMARY ***
Total pot $57 | Rake $0 
Seat 1: ZarubaNT folded before Flop
Seat 2: ChowYuenFatt folded before Flop
Seat 3: floriiiiider folded before Flop (didn't bet)
Seat 4: vjxbkf (button) folded before Flop (didn't bet)
Seat 5: shenghu (small blind) folded before Flop
Seat 6: uripeleg (big blind) collected ($57)


PokerStars Game #102597791217:  Hold'em No Limit ($3/$6 USD) - 2013/08/11 5:50:07 ET
Table 'Dnoces II 40-100 bb' 6-max Seat #5 is the button
Seat 1: ZarubaNT ($609 in chips) 
Seat 2: ChowYuenFatt ($600 in chips) 
Seat 3: floriiiiider ($1150.96 in chips) 
Seat 4: vjxbkf ($1209.43 in chips) 
Seat 5: shenghu ($1054.16 in chips) 
Seat 6: uripeleg ($779.75 in chips) 
uripeleg: posts small blind $3
ZarubaNT: posts big blind $6
*** HOLE CARDS ***
ChowYuenFatt: folds 
floriiiiider: folds 
vjxbkf: raises $12 to $18
shenghu: folds 
shenghu leaves the table
uripeleg: folds 
ZarubaNT: calls $12
*** FLOP *** [7d Qd 2d]
ZarubaNT: checks 
vjxbkf: checks 
*** TURN *** [7d Qd 2d] [Td]
ZarubaNT: checks 
vjxbkf: checks 
*** RIVER *** [7d Qd 2d Td] [Jc]
ZarubaNT: checks 
vjxbkf: checks 
*** SHOW DOWN ***
ZarubaNT: shows [As Tc] (a pair of Tens)
vjxbkf: mucks hand 
ZarubaNT collected $37.24 from pot
*** SUMMARY ***
Total pot $39 | Rake $1.76 
Board [7d Qd 2d Td Jc]
Seat 1: ZarubaNT (big blind) showed [As Tc] and won ($37.24) with a pair of Tens
Seat 2: ChowYuenFatt folded before Flop (didn't bet)
Seat 3: floriiiiider folded before Flop (didn't bet)
Seat 4: vjxbkf mucked
Seat 5: shenghu (button) folded before Flop (didn't bet)
Seat 6: uripeleg (small blind) folded before Flop


PokerStars Game #102597817342:  Hold'em No Limit ($3/$6 USD) - 2013/08/11 5:51:13 ET
Table 'Dnoces II 40-100 bb' 6-max Seat #6 is the button
Seat 1: ZarubaNT ($628.24 in chips) 
Seat 2: ChowYuenFatt ($600 in chips) 
Seat 3: floriiiiider ($1150.96 in chips) 
Seat 4: vjxbkf ($1191.43 in chips) 
Seat 6: uripeleg ($776.75 in chips) 
ZarubaNT: posts small blind $3
ChowYuenFatt: posts big blind $6
*** HOLE CARDS ***
floriiiiider: folds 
vjxbkf: raises $12 to $18
uripeleg: folds 
ZarubaNT: folds 
ChowYuenFatt: folds 
Uncalled bet ($12) returned to vjxbkf
vjxbkf collected $15 from pot
vjxbkf: doesn't show hand 
*** SUMMARY ***
Total pot $15 | Rake $0 
Seat 1: ZarubaNT (small blind) folded before Flop
Seat 2: ChowYuenFatt (big blind) folded before Flop
Seat 3: floriiiiider folded before Flop (didn't bet)
Seat 4: vjxbkf collected ($15)
Seat 6: uripeleg (button) folded before Flop (didn't bet)


PokerStars Game #102597827210:  Hold'em No Limit ($3/$6 USD) - 2013/08/11 5:51:37 ET
Table 'Dnoces II 40-100 bb' 6-max Seat #1 is the button
Seat 1: ZarubaNT ($625.24 in chips) 
Seat 2: ChowYuenFatt ($594 in chips) 
Seat 4: vjxbkf ($1200.43 in chips) 
Seat 6: uripeleg ($776.75 in chips) 
ChowYuenFatt: posts small blind $3
floriiiiider: is sitting out 
vjxbkf: posts big blind $6
*** HOLE CARDS ***
DuckinF0nk joins the table at seat #5 
uripeleg: folds 
ZarubaNT: raises $6 to $12
ChowYuenFatt: folds 
vjxbkf: folds 
Uncalled bet ($6) returned to ZarubaNT
ZarubaNT collected $15 from pot
ZarubaNT: doesn't show hand 
*** SUMMARY ***
Total pot $15 | Rake $0 
Seat 1: ZarubaNT (button) collected ($15)
Seat 2: ChowYuenFatt (small blind) folded before Flop
Seat 4: vjxbkf (big blind) folded before Flop
Seat 6: uripeleg folded before Flop (didn't bet)


PokerStars Game #102597833237:  Hold'em No Limit ($3/$6 USD) - 2013/08/11 5:51:53 ET
Table 'Dnoces II 40-100 bb' 6-max Seat #2 is the button
Seat 1: ZarubaNT ($634.24 in chips) 
Seat 2: ChowYuenFatt ($591 in chips) 
Seat 4: vjxbkf ($1194.43 in chips) 
Seat 5: DuckinF0nk ($600 in chips) 
Seat 6: uripeleg ($776.75 in chips) 
vjxbkf: posts small blind $3
DuckinF0nk: posts big blind $6
*** HOLE CARDS ***
floriiiiider leaves the table
Hristo008 joins the table at seat #3 
uripeleg: raises $6 to $12
ZarubaNT: folds 
ChowYuenFatt: folds 
vjxbkf: folds 
DuckinF0nk: folds 
Uncalled bet ($6) returned to uripeleg
uripeleg collected $15 from pot
*** SUMMARY ***
Total pot $15 | Rake $0 
Seat 1: ZarubaNT folded before Flop (didn't bet)
Seat 2: ChowYuenFatt (button) folded before Flop (didn't bet)
Seat 4: vjxbkf (small blind) folded before Flop
Seat 5: DuckinF0nk (big blind) folded before Flop
Seat 6: uripeleg collected ($15)


PokerStars Game #102597841775:  Hold'em No Limit ($3/$6 USD) - 2013/08/11 5:52:14 ET
Table 'Dnoces II 40-100 bb' 6-max Seat #4 is the button
Seat 1: ZarubaNT ($634.24 in chips) 
Seat 2: ChowYuenFatt ($591 in chips) 
Seat 4: vjxbkf ($1191.43 in chips) 
Seat 5: DuckinF0nk ($600 in chips) 
Seat 6: uripeleg ($785.75 in chips) 
DuckinF0nk: posts small blind $3
uripeleg: posts big blind $6
*** HOLE CARDS ***
ZarubaNT: folds 
ChowYuenFatt: folds 
vjxbkf: raises $6 to $12
DuckinF0nk: folds 
uripeleg: raises $36 to $48
vjxbkf: folds 
Uncalled bet ($36) returned to uripeleg
uripeleg collected $27 from pot
*** SUMMARY ***
Total pot $27 | Rake $0 
Seat 1: ZarubaNT folded before Flop (didn't bet)
Seat 2: ChowYuenFatt folded before Flop (didn't bet)
Seat 4: vjxbkf (button) folded before Flop
Seat 5: DuckinF0nk (small blind) folded before Flop
Seat 6: uripeleg (big blind) collected ($27)


PokerStars Game #102597856342:  Hold'em No Limit ($3/$6 USD) - 2013/08/11 5:52:50 ET
Table 'Dnoces II 40-100 bb' 6-max Seat #5 is the button
Seat 2: ChowYuenFatt ($591 in chips) 
Seat 4: vjxbkf ($1179.43 in chips) 
Seat 5: DuckinF0nk ($600 in chips) 
Seat 6: uripeleg ($800.75 in chips) 
uripeleg: posts small blind $3
ZarubaNT: is sitting out 
ChowYuenFatt: posts big blind $6
*** HOLE CARDS ***
vjxbkf: raises $12 to $18
DuckinF0nk: raises $30 to $48
uripeleg: folds 
ChowYuenFatt: folds 
vjxbkf: folds 
Uncalled bet ($30) returned to DuckinF0nk
DuckinF0nk collected $45 from pot
DuckinF0nk: doesn't show hand 
*** SUMMARY ***
Total pot $45 | Rake $0 
Seat 2: ChowYuenFatt (big blind) folded before Flop
Seat 4: vjxbkf folded before Flop
Seat 5: DuckinF0nk (button) collected ($45)
Seat 6: uripeleg (small blind) folded before Flop


PokerStars Game #102597884773:  Hold'em No Limit ($3/$6 USD) - 2013/08/11 5:54:00 ET
Table 'Dnoces II 40-100 bb' 6-max Seat #6 is the button
Seat 2: ChowYuenFatt ($585 in chips) 
Seat 4: vjxbkf ($1161.43 in chips) 
Seat 5: DuckinF0nk ($627 in chips) 
Seat 6: uripeleg ($797.75 in chips) 
ZarubaNT will be allowed to play after the button
ChowYuenFatt: posts small blind $3
vjxbkf: posts big blind $6
*** HOLE CARDS ***
DuckinF0nk: folds 
uripeleg: raises $6 to $12
ChowYuenFatt: calls $9
vjxbkf: folds 
*** FLOP *** [9c 4s Kd]
ChowYuenFatt: checks 
uripeleg: bets $14.32
ChowYuenFatt: folds 
Uncalled bet ($14.32) returned to uripeleg
uripeleg collected $28.65 from pot
*** SUMMARY ***
Total pot $30 | Rake $1.35 
Board [9c 4s Kd]
Seat 2: ChowYuenFatt (small blind) folded on the Flop
Seat 4: vjxbkf (big blind) folded before Flop
Seat 5: DuckinF0nk folded before Flop (didn't bet)
Seat 6: uripeleg (button) collected ($28.65)


PokerStars Game #102597908223:  Hold'em No Limit ($3/$6 USD) - 2013/08/11 5:54:59 ET
Table 'Dnoces II 40-100 bb' 6-max Seat #2 is the button
Seat 2: ChowYuenFatt ($573 in chips) 
Seat 4: vjxbkf ($1155.43 in chips) 
Seat 5: DuckinF0nk ($627 in chips) 
Seat 6: uripeleg ($814.40 in chips) 
vjxbkf: posts small blind $3
DuckinF0nk: posts big blind $6
ZarubaNT: sits out 
*** HOLE CARDS ***
uripeleg: folds 
ChowYuenFatt: raises $11 to $17
vjxbkf: folds 
DuckinF0nk: folds 
Uncalled bet ($11) returned to ChowYuenFatt
ChowYuenFatt collected $15 from pot
ChowYuenFatt: doesn't show hand 
*** SUMMARY ***
Total pot $15 | Rake $0 
Seat 2: ChowYuenFatt (button) collected ($15)
Seat 4: vjxbkf (small blind) folded before Flop
Seat 5: DuckinF0nk (big blind) folded before Flop
Seat 6: uripeleg folded before Flop (didn't bet)


PokerStars Game #102597671542:  Hold'em No Limit ($3/$6 USD) - 2013/08/11 5:45:13 ET
Table 'Dnoces II 40-100 bb' 6-max Seat #1 is the button
Seat 1: ZarubaNT ($600 in chips) 
Seat 2: ChowYuenFatt ($594 in chips) 
Seat 3: floriiiiider ($1195.96 in chips) 
Seat 4: vjxbkf ($1218.43 in chips) 
Seat 5: shenghu ($455.28 in chips) 
Seat 6: uripeleg ($832.75 in chips) 
ChowYuenFatt: posts small blind $3
floriiiiider: posts big blind $6
*** HOLE CARDS ***
vjxbkf: folds 
shenghu: calls $6
uripeleg: folds 
ZarubaNT: folds 
ChowYuenFatt: calls $3
floriiiiider: checks 
*** FLOP *** [5h Qd 2h]
ChowYuenFatt: checks 
floriiiiider: checks 
shenghu: bets $12
ChowYuenFatt: folds 
floriiiiider: calls $12
*** TURN *** [5h Qd 2h] [2c]
floriiiiider: checks 
shenghu: bets $24
floriiiiider: calls $24
*** RIVER *** [5h Qd 2h 2c] [4s]
floriiiiider: checks 
shenghu: checks 
*** SHOW DOWN ***
floriiiiider: shows [Ts 5d] (two pair, Fives and Deuces)
shenghu: shows [9c Qs] (two pair, Queens and Deuces)
shenghu collected $87.20 from pot
*** SUMMARY ***
Total pot $90 | Rake $2.80 
Board [5h Qd 2h 2c 4s]
Seat 1: ZarubaNT (button) folded before Flop (didn't bet)
Seat 2: ChowYuenFatt (small blind) folded on the Flop
Seat 3: floriiiiider (big blind) showed [Ts 5d] and lost with two pair, Fives and Deuces
Seat 4: vjxbkf folded before Flop (didn't bet)
Seat 5: shenghu showed [9c Qs] and won ($87.20) with two pair, Queens and Deuces
Seat 6: uripeleg folded before Flop (didn't bet)


PokerStars Game #102597712137:  Hold'em No Limit ($3/$6 USD) - 2013/08/11 5:46:52 ET
Table 'Dnoces II 40-100 bb' 6-max Seat #2 is the button
Seat 1: ZarubaNT ($600 in chips) 
Seat 2: ChowYuenFatt ($588 in chips) 
Seat 3: floriiiiider ($1153.96 in chips) 
Seat 4: vjxbkf ($1218.43 in chips) 
Seat 5: shenghu ($500.48 in chips) 
Seat 6: uripeleg ($832.75 in chips) 
floriiiiider: posts small blind $3
vjxbkf: posts big blind $6
*** HOLE CARDS ***
shenghu: calls $6
uripeleg: raises $16.50 to $22.50
ZarubaNT: folds 
ChowYuenFatt: raises $36.50 to $59
floriiiiider: folds 
vjxbkf: folds 
shenghu: calls $53
uripeleg: calls $36.50
*** FLOP *** [5d 8s 3s]
shenghu: bets $108
uripeleg: folds 
ChowYuenFatt: raises $421 to $529 and is all-in
shenghu: calls $333.48 and is all-in
Uncalled bet ($87.52) returned to ChowYuenFatt
*** TURN *** [5d 8s 3s] [6h]
*** RIVER *** [5d 8s 3s 6h] [2c]
*** SHOW DOWN ***
shenghu: shows [Jc Js] (a pair of Jacks)
ChowYuenFatt: shows [As Qh] (high card Ace)
shenghu collected $1066.16 from pot
*** SUMMARY ***
Total pot $1068.96 | Rake $2.80 
Board [5d 8s 3s 6h 2c]
Seat 1: ZarubaNT folded before Flop (didn't bet)
Seat 2: ChowYuenFatt (button) showed [As Qh] and lost with high card Ace
Seat 3: floriiiiider (small blind) folded before Flop
Seat 4: vjxbkf (big blind) folded before Flop
Seat 5: shenghu showed [Jc Js] and won ($1066.16) with a pair of Jacks
Seat 6: uripeleg folded on the Flop


PokerStars Game #102597757682:  Hold'em No Limit ($3/$6 USD) - 2013/08/11 5:48:44 ET
Table 'Dnoces II 40-100 bb' 6-max Seat #3 is the button
Seat 1: ZarubaNT ($600 in chips) 
Seat 2: ChowYuenFatt ($600 in chips) 
Seat 3: floriiiiider ($1150.96 in chips) 
Seat 4: vjxbkf ($1212.43 in chips) 
Seat 5: shenghu ($1066.16 in chips) 
Seat 6: uripeleg ($773.75 in chips) 
vjxbkf: posts small blind $3
shenghu: posts big blind $6
*** HOLE CARDS ***
uripeleg: folds 
ZarubaNT: raises $12 to $18
ChowYuenFatt: folds 
floriiiiider: folds 
vjxbkf: folds 
shenghu: folds 
Uncalled bet ($12) returned to ZarubaNT
ZarubaNT collected $15 from pot
ZarubaNT: doesn't show hand 
*** SUMMARY ***
Total pot $15 | Rake $0 
Seat 1: ZarubaNT collected ($15)
Seat 2: ChowYuenFatt folded before Flop (didn't bet)
Seat 3: floriiiiider (button) folded before Flop (didn't bet)
Seat 4: vjxbkf (small blind) folded before Flop
Seat 5: shenghu (big blind) folded before Flop
Seat 6: uripeleg folded before Flop (didn't bet)


PokerStars Game #102597774029:  Hold'em No Limit ($3/$6 USD) - 2013/08/11 5:49:24 ET
Table 'Dnoces II 40-100 bb' 6-max Seat #4 is the button
Seat 1: ZarubaNT ($609 in chips) 
Seat 2: ChowYuenFatt ($600 in chips) 
Seat 3: floriiiiider ($1150.96 in chips) 
Seat 4: vjxbkf ($1209.43 in chips) 
Seat 5: shenghu ($1060.16 in chips) 
Seat 6: uripeleg ($773.75 in chips) 
shenghu: posts small blind $3
uripeleg: posts big blind $6
*** HOLE CARDS ***
ZarubaNT: folds 
ChowYuenFatt: folds 
floriiiiider: folds 
vjxbkf: folds 
shenghu: calls $3
uripeleg: raises $12 to $18
shenghu: folds 
Uncalled bet ($12) returned to uripeleg
uripeleg collected $12 from pot
*** SUMMARY ***
Total pot $12 | Rake $0 
Seat 1: ZarubaNT folded before Flop (didn't bet)
Seat 2: ChowYuenFatt folded before Flop (didn't bet)
Seat 3: floriiiiider folded before Flop (didn't bet)
Seat 4: vjxbkf (button) folded before Flop (didn't bet)
Seat 5: shenghu (small blind) folded before Flop
Seat 6: uripeleg (big blind) collected ($12)


PokerStars Game #102598264393:  Hold'em No Limit ($3/$6 USD) - 2013/08/11 6:10:28 ET
Table 'Dnoces II 40-100 bb' 6-max Seat #3 is the button
Seat 1: ZarubaNT ($600 in chips) 
Seat 2: ChowYuenFatt ($337.38 in chips) 
Seat 3: Hristo008 ($510.20 in chips) 
Seat 4: vjxbkf ($1404.52 in chips) 
Seat 5: DuckinF0nk ($759.20 in chips) 
Seat 6: uripeleg ($791.90 in chips) 
vjxbkf: posts small blind $3
DuckinF0nk: posts big blind $6
*** HOLE CARDS ***
uripeleg: raises $7.50 to $13.50
ZarubaNT: calls $13.50
ChowYuenFatt: folds 
Hristo008: calls $13.50
vjxbkf: calls $10.50
DuckinF0nk: folds 
*** FLOP *** [Ah Ad 9c]
vjxbkf: checks 
uripeleg: checks 
ZarubaNT: checks 
Hristo008: checks 
*** TURN *** [Ah Ad 9c] [5s]
vjxbkf: checks 
uripeleg: bets $36
ZarubaNT: folds 
Hristo008: folds 
vjxbkf: folds 
Uncalled bet ($36) returned to uripeleg
uripeleg collected $57.30 from pot
*** SUMMARY ***
Total pot $60 | Rake $2.70 
Board [Ah Ad 9c 5s]
Seat 1: ZarubaNT folded on the Turn
Seat 2: ChowYuenFatt folded before Flop (didn't bet)
Seat 3: Hristo008 (button) folded on the Turn
Seat 4: vjxbkf (small blind) folded on the Turn
Seat 5: DuckinF0nk (big blind) folded before Flop
Seat 6: uripeleg collected ($57.30)


PokerStars Game #102598306041:  Hold'em No Limit ($3/$6 USD) - 2013/08/11 6:12:05 ET
Table 'Dnoces II 40-100 bb' 6-max Seat #4 is the button
Seat 1: ZarubaNT ($600 in chips) 
Seat 2: ChowYuenFatt ($337.38 in chips) 
Seat 3: Hristo008 ($496.70 in chips) 
Seat 4: vjxbkf ($1391.02 in chips) 
Seat 5: DuckinF0nk ($753.20 in chips) 
Seat 6: uripeleg ($835.70 in chips) 
DuckinF0nk: posts small blind $3
uripeleg: posts big blind $6
*** HOLE CARDS ***
ZarubaNT: folds 
ChowYuenFatt: folds 
Hristo008: folds 
vjxbkf: raises $6 to $12
DuckinF0nk: folds 
uripeleg: calls $6
*** FLOP *** [Qd 9d 3h]
uripeleg: checks 
vjxbkf: bets $15
uripeleg: folds 
Uncalled bet ($15) returned to vjxbkf
vjxbkf collected $25.78 from pot
vjxbkf: doesn't show hand 
*** SUMMARY ***
Total pot $27 | Rake $1.22 
Board [Qd 9d 3h]
Seat 1: ZarubaNT folded before Flop (didn't bet)
Seat 2: ChowYuenFatt folded before Flop (didn't bet)
Seat 3: Hristo008 folded before Flop (didn't bet)
Seat 4: vjxbkf (button) collected ($25.78)
Seat 5: DuckinF0nk (small blind) folded before Flop
Seat 6: uripeleg (big blind) folded on the Flop


PokerStars Game #102598325811:  Hold'em No Limit ($3/$6 USD) - 2013/08/11 6:12:52 ET
Table 'Dnoces II 40-100 bb' 6-max Seat #5 is the button
Seat 1: ZarubaNT ($600 in chips) 
Seat 2: ChowYuenFatt ($337.38 in chips) 
Seat 3: Hristo008 ($496.70 in chips) 
Seat 4: vjxbkf ($1404.80 in chips) 
Seat 5: DuckinF0nk ($750.20 in chips) 
Seat 6: uripeleg ($823.70 in chips) 
uripeleg: posts small blind $3
ZarubaNT: posts big blind $6
*** HOLE CARDS ***
ChowYuenFatt: folds 
Hristo008: folds 
vjxbkf: folds 
DuckinF0nk: folds 
uripeleg: folds 
Uncalled bet ($3) returned to ZarubaNT
ZarubaNT collected $6 from pot
ZarubaNT: doesn't show hand 
*** SUMMARY ***
Total pot $6 | Rake $0 
Seat 1: ZarubaNT (big blind) collected ($6)
Seat 2: ChowYuenFatt folded before Flop (didn't bet)
Seat 3: Hristo008 folded before Flop (didn't bet)
Seat 4: vjxbkf folded before Flop (didn't bet)
Seat 5: DuckinF0nk (button) folded before Flop (didn't bet)
Seat 6: uripeleg (small blind) folded before Flop


PokerStars Game #102598338910:  Hold'em No Limit ($3/$6 USD) - 2013/08/11 6:13:23 ET
Table 'Dnoces II 40-100 bb' 6-max Seat #6 is the button
Seat 1: ZarubaNT ($603 in chips) 
Seat 2: ChowYuenFatt ($337.38 in chips) 
Seat 3: Hristo008 ($496.70 in chips) 
Seat 4: vjxbkf ($1404.80 in chips) 
Seat 5: DuckinF0nk ($750.20 in chips) 
Seat 6: uripeleg ($820.70 in chips) 
ZarubaNT: posts small blind $3
ChowYuenFatt: posts big blind $6
*** HOLE CARDS ***
Hristo008: folds 
vjxbkf: folds 
DuckinF0nk: folds 
uripeleg: raises $7.50 to $13.50
ZarubaNT: folds 
ChowYuenFatt: folds 
Uncalled bet ($7.50) returned to uripeleg
uripeleg collected $15 from pot
*** SUMMARY ***
Total pot $15 | Rake $0 
Seat 1: ZarubaNT (small blind) folded before Flop
Seat 2: ChowYuenFatt (big blind) folded before Flop
Seat 3: Hristo008 folded before Flop (didn't bet)
Seat 4: vjxbkf folded before Flop (didn't bet)
Seat 5: DuckinF0nk folded before Flop (didn't bet)
Seat 6: uripeleg (button) collected ($15)


PokerStars Game #102598353994:  Hold'em No Limit ($3/$6 USD) - 2013/08/11 6:13:59 ET
Table 'Dnoces II 40-100 bb' 6-max Seat #1 is the button
Seat 1: ZarubaNT ($600 in chips) 
Seat 2: ChowYuenFatt ($331.38 in chips) 
Seat 3: Hristo008 ($496.70 in chips) 
Seat 4: vjxbkf ($1404.80 in chips) 
Seat 5: DuckinF0nk ($750.20 in chips) 
Seat 6: uripeleg ($829.70 in chips) 
ChowYuenFatt: posts small blind $3
Hristo008: posts big blind $6
*** HOLE CARDS ***
vjxbkf: folds 
DuckinF0nk: folds 
uripeleg: folds 
ZarubaNT: raises $6 to $12
ChowYuenFatt: folds 
Hristo008: raises $30 to $42
ZarubaNT: calls $30
*** FLOP *** [6c 6s Qc]
Hristo008: bets $60
ZarubaNT: calls $60
*** TURN *** [6c 6s Qc] [9d]
Hristo008: bets $120
ZarubaNT: calls $120
*** RIVER *** [6c 6s Qc 9d] [5h]
Hristo008: checks 
ZarubaNT: bets $378 and is all-in
Hristo008: folds 
Uncalled bet ($378) returned to ZarubaNT
ZarubaNT collected $444.20 from pot
ZarubaNT: doesn't show hand 
*** SUMMARY ***
Total pot $447 | Rake $2.80 
Board [6c 6s Qc 9d 5h]
Seat 1: ZarubaNT (button) collected ($444.20)
Seat 2: ChowYuenFatt (small blind) folded before Flop
Seat 3: Hristo008 (big blind) folded on the River
Seat 4: vjxbkf folded before Flop (didn't bet)
Seat 5: DuckinF0nk folded before Flop (didn't bet)
Seat 6: uripeleg folded before Flop (didn't bet)


PokerStars Game #102598142266:  Hold'em No Limit ($3/$6 USD) - 2013/08/11 6:05:41 ET
Table 'Dnoces II 40-100 bb' 6-max Seat #4 is the button
Seat 1: ZarubaNT ($600 in chips) 
Seat 2: ChowYuenFatt ($541.38 in chips) 
Seat 3: Hristo008 ($534.20 in chips) 
Seat 4: vjxbkf ($1138.67 in chips) 
Seat 5: DuckinF0nk ($762.20 in chips) 
Seat 6: uripeleg ($821.90 in chips) 
DuckinF0nk: posts small blind $3
uripeleg: posts big blind $6
*** HOLE CARDS ***
ZarubaNT: folds 
ChowYuenFatt: folds 
Hristo008: folds 
vjxbkf: raises $6 to $12
DuckinF0nk: calls $9
uripeleg: folds 
*** FLOP *** [Td 6c 3c]
DuckinF0nk: checks 
vjxbkf: bets $18
DuckinF0nk: folds 
Uncalled bet ($18) returned to vjxbkf
vjxbkf collected $28.65 from pot
vjxbkf: doesn't show hand 
*** SUMMARY ***
Total pot $30 | Rake $1.35 
Board [Td 6c 3c]
Seat 1: ZarubaNT folded before Flop (didn't bet)
Seat 2: ChowYuenFatt folded before Flop (didn't bet)
Seat 3: Hristo008 folded before Flop (didn't bet)
Seat 4: vjxbkf (button) collected ($28.65)
Seat 5: DuckinF0nk (small blind) folded on the Flop
Seat 6: uripeleg (big blind) folded before Flop


PokerStars Game #102598168399:  Hold'em No Limit ($3/$6 USD) - 2013/08/11 6:06:42 ET
Table 'Dnoces II 40-100 bb' 6-max Seat #5 is the button
Seat 1: ZarubaNT ($600 in chips) 
Seat 2: ChowYuenFatt ($541.38 in chips) 
Seat 3: Hristo008 ($534.20 in chips) 
Seat 4: vjxbkf ($1155.32 in chips) 
Seat 5: DuckinF0nk ($750.20 in chips) 
Seat 6: uripeleg ($815.90 in chips) 
uripeleg: posts small blind $3
ZarubaNT: posts big blind $6
*** HOLE CARDS ***
ChowYuenFatt: folds 
Hristo008: folds 
vjxbkf: raises $12 to $18
DuckinF0nk: folds 
uripeleg: folds 
ZarubaNT: folds 
Uncalled bet ($12) returned to vjxbkf
vjxbkf collected $15 from pot
vjxbkf: doesn't show hand 
*** SUMMARY ***
Total pot $15 | Rake $0 
Seat 1: ZarubaNT (big blind) folded before Flop
Seat 2: ChowYuenFatt folded before Flop (didn't bet)
Seat 3: Hristo008 folded before Flop (didn't bet)
Seat 4: vjxbkf collected ($15)
Seat 5: DuckinF0nk (button) folded before Flop (didn't bet)
Seat 6: uripeleg (small blind) folded before Flop


PokerStars Game #102598183709:  Hold'em No Limit ($3/$6 USD) - 2013/08/11 6:07:18 ET
Table 'Dnoces II 40-100 bb' 6-max Seat #6 is the button
Seat 1: ZarubaNT ($600 in chips) 
Seat 2: ChowYuenFatt ($541.38 in chips) 
Seat 3: Hristo008 ($534.20 in chips) 
Seat 4: vjxbkf ($1164.32 in chips) 
Seat 5: DuckinF0nk ($750.20 in chips) 
Seat 6: uripeleg ($812.90 in chips) 
ZarubaNT: posts small blind $3
ChowYuenFatt: posts big blind $6
*** HOLE CARDS ***
Hristo008: folds 
vjxbkf: folds 
DuckinF0nk: raises $12 to $18
uripeleg: folds 
ZarubaNT: folds 
ChowYuenFatt: folds 
Uncalled bet ($12) returned to DuckinF0nk
DuckinF0nk collected $15 from pot
DuckinF0nk: doesn't show hand 
*** SUMMARY ***
Total pot $15 | Rake $0 
Seat 1: ZarubaNT (small blind) folded before Flop
Seat 2: ChowYuenFatt (big blind) folded before Flop
Seat 3: Hristo008 folded before Flop (didn't bet)
Seat 4: vjxbkf folded before Flop (didn't bet)
Seat 5: DuckinF0nk collected ($15)
Seat 6: uripeleg (button) folded before Flop (didn't bet)


PokerStars Game #102598199154:  Hold'em No Limit ($3/$6 USD) - 2013/08/11 6:07:54 ET
Table 'Dnoces II 40-100 bb' 6-max Seat #1 is the button
Seat 1: ZarubaNT ($600 in chips) 
Seat 2: ChowYuenFatt ($535.38 in chips) 
Seat 3: Hristo008 ($534.20 in chips) 
Seat 4: vjxbkf ($1164.32 in chips) 
Seat 5: DuckinF0nk ($759.20 in chips) 
Seat 6: uripeleg ($812.90 in chips) 
ChowYuenFatt: posts small blind $3
Hristo008: posts big blind $6
*** HOLE CARDS ***
vjxbkf: raises $15 to $21
DuckinF0nk: folds 
uripeleg: calls $21
ZarubaNT: folds 
ChowYuenFatt: calls $18
Hristo008: calls $15
*** FLOP *** [Qh 4s 6s]
ChowYuenFatt: checks 
Hristo008: checks 
vjxbkf: bets $57
uripeleg: folds 
ChowYuenFatt: calls $57
Hristo008: folds 
*** TURN *** [Qh 4s 6s] [7h]
ChowYuenFatt: checks 
vjxbkf: bets $129
ChowYuenFatt: calls $129
*** RIVER *** [Qh 4s 6s 7h] [Ad]
ChowYuenFatt: checks 
vjxbkf: checks 
*** SHOW DOWN ***
ChowYuenFatt: shows [8c 7d] (a pair of Sevens)
vjxbkf: shows [Kh Kd] (a pair of Kings)
vjxbkf collected $453.20 from pot
*** SUMMARY ***
Total pot $456 | Rake $2.80 
Board [Qh 4s 6s 7h Ad]
Seat 1: ZarubaNT (button) folded before Flop (didn't bet)
Seat 2: ChowYuenFatt (small blind) showed [8c 7d] and lost with a pair of Sevens
Seat 3: Hristo008 (big blind) folded on the Flop
Seat 4: vjxbkf showed [Kh Kd] and won ($453.20) with a pair of Kings
Seat 5: DuckinF0nk folded before Flop (didn't bet)
Seat 6: uripeleg folded on the Flop


PokerStars Game #102598251845:  Hold'em No Limit ($3/$6 USD) - 2013/08/11 6:09:58 ET
Table 'Dnoces II 40-100 bb' 6-max Seat #2 is the button
Seat 1: ZarubaNT ($600 in chips) 
Seat 2: ChowYuenFatt ($328.38 in chips) 
Seat 3: Hristo008 ($513.20 in chips) 
Seat 4: vjxbkf ($1410.52 in chips) 
Seat 5: DuckinF0nk ($759.20 in chips) 
Seat 6: uripeleg ($791.90 in chips) 
Hristo008: posts small blind $3
vjxbkf: posts big blind $6
*** HOLE CARDS ***
DuckinF0nk: folds 
uripeleg: folds 
ZarubaNT: folds 
ChowYuenFatt: raises $10 to $16
Hristo008: folds 
vjxbkf: folds 
Uncalled bet ($10) returned to ChowYuenFatt
ChowYuenFatt collected $15 from pot
ChowYuenFatt: doesn't show hand 
*** SUMMARY ***
Total pot $15 | Rake $0 
Seat 1: ZarubaNT folded before Flop (didn't bet)
Seat 2: ChowYuenFatt (button) collected ($15)
Seat 3: Hristo008 (small blind) folded before Flop
Seat 4: vjxbkf (big blind) folded before Flop
Seat 5: DuckinF0nk folded before Flop (didn't bet)
Seat 6: uripeleg folded before Flop (didn't bet)


PokerStars Game #102597919243:  Hold'em No Limit ($3/$6 USD) - 2013/08/11 5:55:28 ET
Table 'Dnoces II 40-100 bb' 6-max Seat #4 is the button
Seat 2: ChowYuenFatt ($582 in chips) 
Seat 4: vjxbkf ($1152.43 in chips) 
Seat 5: DuckinF0nk ($621 in chips) 
Seat 6: uripeleg ($814.40 in chips) 
DuckinF0nk: posts small blind $3
uripeleg: posts big blind $6
ZarubaNT: sits out 
*** HOLE CARDS ***
ChowYuenFatt: folds 
vjxbkf: raises $6 to $12
DuckinF0nk: folds 
uripeleg: raises $36 to $48
vjxbkf: folds 
Uncalled bet ($36) returned to uripeleg
uripeleg collected $27 from pot
*** SUMMARY ***
Total pot $27 | Rake $0 
Seat 2: ChowYuenFatt folded before Flop (didn't bet)
Seat 4: vjxbkf (button) folded before Flop
Seat 5: DuckinF0nk (small blind) folded before Flop
Seat 6: uripeleg (big blind) collected ($27)


PokerStars Game #102597935752:  Hold'em No Limit ($3/$6 USD) - 2013/08/11 5:56:21 ET
Table 'Dnoces II 40-100 bb' 6-max Seat #5 is the button
Seat 1: ZarubaNT ($634.24 in chips) 
Seat 2: ChowYuenFatt ($582 in chips) 
Seat 4: vjxbkf ($1140.43 in chips) 
Seat 5: DuckinF0nk ($618 in chips) 
Seat 6: uripeleg ($829.40 in chips) 
uripeleg: posts small blind $3
ZarubaNT: posts big blind $6
Hristo008: sits out 
*** HOLE CARDS ***
ChowYuenFatt: folds 
vjxbkf: raises $12 to $18
DuckinF0nk: folds 
uripeleg: folds 
ZarubaNT: calls $12
*** FLOP *** [7c 9s Js]
ZarubaNT: checks 
vjxbkf: bets $21
ZarubaNT: folds 
Uncalled bet ($21) returned to vjxbkf
vjxbkf collected $37.24 from pot
vjxbkf: doesn't show hand 
*** SUMMARY ***
Total pot $39 | Rake $1.76 
Board [7c 9s Js]
Seat 1: ZarubaNT (big blind) folded on the Flop
Seat 2: ChowYuenFatt folded before Flop (didn't bet)
Seat 4: vjxbkf collected ($37.24)
Seat 5: DuckinF0nk (button) folded before Flop (didn't bet)
Seat 6: uripeleg (small blind) folded before Flop


PokerStars Game #102597946507:  Hold'em No Limit ($3/$6 USD) - 2013/08/11 5:56:55 ET
Table 'Dnoces II 40-100 bb' 6-max Seat #6 is the button
Seat 1: ZarubaNT ($616.24 in chips) 
Seat 2: ChowYuenFatt ($582 in chips) 
Seat 4: vjxbkf ($1159.67 in chips) 
Seat 5: DuckinF0nk ($618 in chips) 
Seat 6: uripeleg ($826.40 in chips) 
ZarubaNT: posts small blind $3
ChowYuenFatt: posts big blind $6
Hristo008: sits out 
*** HOLE CARDS ***
vjxbkf: folds 
DuckinF0nk: folds 
uripeleg: raises $7.50 to $13.50
ZarubaNT: folds 
ChowYuenFatt: folds 
Uncalled bet ($7.50) returned to uripeleg
uripeleg collected $15 from pot
*** SUMMARY ***
Total pot $15 | Rake $0 
Seat 1: ZarubaNT (small blind) folded before Flop
Seat 2: ChowYuenFatt (big blind) folded before Flop
Seat 4: vjxbkf folded before Flop (didn't bet)
Seat 5: DuckinF0nk folded before Flop (didn't bet)
Seat 6: uripeleg (button) collected ($15)


PokerStars Game #102597954899:  Hold'em No Limit ($3/$6 USD) - 2013/08/11 5:57:21 ET
Table 'Dnoces II 40-100 bb' 6-max Seat #1 is the button
Seat 1: ZarubaNT ($613.24 in chips) 
Seat 2: ChowYuenFatt ($576 in chips) 
Seat 3: Hristo008 ($600 in chips) 
Seat 4: vjxbkf ($1159.67 in chips) 
Seat 5: DuckinF0nk ($618 in chips) 
Seat 6: uripeleg ($835.40 in chips) 
ChowYuenFatt: posts small blind $3
Hristo008: posts big blind $6
*** HOLE CARDS ***
vjxbkf: folds 
DuckinF0nk: folds 
uripeleg: raises $7.50 to $13.50
ZarubaNT: raises $31.50 to $45
ChowYuenFatt: folds 
Hristo008: folds 
uripeleg: folds 
Uncalled bet ($31.50) returned to ZarubaNT
ZarubaNT collected $36 from pot
ZarubaNT: doesn't show hand 
*** SUMMARY ***
Total pot $36 | Rake $0 
Seat 1: ZarubaNT (button) collected ($36)
Seat 2: ChowYuenFatt (small blind) folded before Flop
Seat 3: Hristo008 (big blind) folded before Flop
Seat 4: vjxbkf folded before Flop (didn't bet)
Seat 5: DuckinF0nk folded before Flop (didn't bet)
Seat 6: uripeleg folded before Flop


PokerStars Game #102597973691:  Hold'em No Limit ($3/$6 USD) - 2013/08/11 5:58:20 ET
Table 'Dnoces II 40-100 bb' 6-max Seat #2 is the button
Seat 1: ZarubaNT ($635.74 in chips) 
Seat 2: ChowYuenFatt ($573 in chips) 
Seat 3: Hristo008 ($594 in chips) 
Seat 4: vjxbkf ($1159.67 in chips) 
Seat 5: DuckinF0nk ($618 in chips) 
Seat 6: uripeleg ($821.90 in chips) 
Hristo008: posts small blind $3
vjxbkf: posts big blind $6
*** HOLE CARDS ***
DuckinF0nk: folds 
uripeleg: raises $7.50 to $13.50
ZarubaNT: folds 
ChowYuenFatt: folds 
Hristo008: folds 
vjxbkf: folds 
Uncalled bet ($7.50) returned to uripeleg
uripeleg collected $15 from pot
*** SUMMARY ***
Total pot $15 | Rake $0 
Seat 1: ZarubaNT folded before Flop (didn't bet)
Seat 2: ChowYuenFatt (button) folded before Flop (didn't bet)
Seat 3: Hristo008 (small blind) folded before Flop
Seat 4: vjxbkf (big blind) folded before Flop
Seat 5: DuckinF0nk folded before Flop (didn't bet)
Seat 6: uripeleg collected ($15)


PokerStars Game #102597981138:  Hold'em No Limit ($3/$6 USD) - 2013/08/11 5:58:43 ET
Table 'Dnoces II 40-100 bb' 6-max Seat #3 is the button
Seat 1: ZarubaNT ($635.74 in chips) 
Seat 2: ChowYuenFatt ($573 in chips) 
Seat 3: Hristo008 ($591 in chips) 
Seat 4: vjxbkf ($1153.67 in chips) 
Seat 5: DuckinF0nk ($618 in chips) 
Seat 6: uripeleg ($830.90 in chips) 
vjxbkf: posts small blind $3
DuckinF0nk: posts big blind $6
*** HOLE CARDS ***
uripeleg: folds 
ZarubaNT: folds 
ChowYuenFatt: folds 
Hristo008: raises $6 to $12
vjxbkf: folds 
DuckinF0nk: folds 
Uncalled bet ($6) returned to Hristo008
Hristo008 collected $15 from pot
Hristo008: doesn't show hand 
*** SUMMARY ***
Total pot $15 | Rake $0 
Seat 1: ZarubaNT folded before Flop (didn't bet)
Seat 2: ChowYuenFatt folded before Flop (didn't bet)
Seat 3: Hristo008 (button) collected ($15)
Seat 4: vjxbkf (small blind) folded before Flop
Seat 5: DuckinF0nk (big blind) folded before Flop
Seat 6: uripeleg folded before Flop (didn't bet)


PokerStars Game #102597987223:  Hold'em No Limit ($3/$6 USD) - 2013/08/11 5:59:02 ET
Table 'Dnoces II 40-100 bb' 6-max Seat #4 is the button
Seat 1: ZarubaNT ($635.74 in chips) 
Seat 2: ChowYuenFatt ($573 in chips) 
Seat 3: Hristo008 ($600 in chips) 
Seat 4: vjxbkf ($1150.67 in chips) 
Seat 5: DuckinF0nk ($612 in chips) 
Seat 6: uripeleg ($830.90 in chips) 
DuckinF0nk: posts small blind $3
uripeleg: posts big blind $6
*** HOLE CARDS ***
ZarubaNT: folds 
ChowYuenFatt: folds 
Hristo008: folds 
vjxbkf: raises $6 to $12
DuckinF0nk: raises $30 to $42
uripeleg: folds 
vjxbkf: folds 
Uncalled bet ($30) returned to DuckinF0nk
DuckinF0nk collected $30 from pot
DuckinF0nk: doesn't show hand 
*** SUMMARY ***
Total pot $30 | Rake $0 
Seat 1: ZarubaNT folded before Flop (didn't bet)
Seat 2: ChowYuenFatt folded before Flop (didn't bet)
Seat 3: Hristo008 folded before Flop (didn't bet)
Seat 4: vjxbkf (button) folded before Flop
Seat 5: DuckinF0nk (small blind) collected ($30)
Seat 6: uripeleg (big blind) folded before Flop


PokerStars Game #102598013647:  Hold'em No Limit ($3/$6 USD) - 2013/08/11 6:00:22 ET
Table 'Dnoces II 40-100 bb' 6-max Seat #5 is the button
Seat 1: ZarubaNT ($635.74 in chips) 
Seat 2: ChowYuenFatt ($573 in chips) 
Seat 3: Hristo008 ($600 in chips) 
Seat 4: vjxbkf ($1138.67 in chips) 
Seat 5: DuckinF0nk ($630 in chips) 
Seat 6: uripeleg ($824.90 in chips) 
uripeleg: posts small blind $3
ZarubaNT: posts big blind $6
*** HOLE CARDS ***
ChowYuenFatt: folds 
Hristo008: raises $12 to $18
vjxbkf: folds 
DuckinF0nk: raises $42 to $60
uripeleg: folds 
ZarubaNT: folds 
Hristo008: calls $42
*** FLOP *** [Th 8s Qd]
Hristo008: checks 
DuckinF0nk: bets $72
Hristo008: calls $72
*** TURN *** [Th 8s Qd] [Kd]
Hristo008: checks 
DuckinF0nk: bets $180
Hristo008: folds 
Uncalled bet ($180) returned to DuckinF0nk
DuckinF0nk collected $270.20 from pot
DuckinF0nk: doesn't show hand 
*** SUMMARY ***
Total pot $273 | Rake $2.80 
Board [Th 8s Qd Kd]
Seat 1: ZarubaNT (big blind) folded before Flop
Seat 2: ChowYuenFatt folded before Flop (didn't bet)
Seat 3: Hristo008 folded on the Turn
Seat 4: vjxbkf folded before Flop (didn't bet)
Seat 5: DuckinF0nk (button) collected ($270.20)
Seat 6: uripeleg (small blind) folded before Flop


PokerStars Game #102598053391:  Hold'em No Limit ($3/$6 USD) - 2013/08/11 6:02:10 ET
Table 'Dnoces II 40-100 bb' 6-max Seat #6 is the button
Seat 1: ZarubaNT ($629.74 in chips) 
Seat 2: ChowYuenFatt ($573 in chips) 
Seat 3: Hristo008 ($468 in chips) 
Seat 4: vjxbkf ($1138.67 in chips) 
Seat 5: DuckinF0nk ($768.20 in chips) 
Seat 6: uripeleg ($821.90 in chips) 
ZarubaNT: posts small blind $3
ChowYuenFatt: posts big blind $6
*** HOLE CARDS ***
Hristo008: folds 
vjxbkf: folds 
DuckinF0nk: folds 
uripeleg: folds 
ZarubaNT: raises $12 to $18
ChowYuenFatt: calls $12
*** FLOP *** [Kd Jd 2h]
ZarubaNT: checks 
ChowYuenFatt: bets $25
ZarubaNT: folds 
Uncalled bet ($25) returned to ChowYuenFatt
ChowYuenFatt collected $34.38 from pot
ChowYuenFatt: doesn't show hand 
*** SUMMARY ***
Total pot $36 | Rake $1.62 
Board [Kd Jd 2h]
Seat 1: ZarubaNT (small blind) folded on the Flop
Seat 2: ChowYuenFatt (big blind) collected ($34.38)
Seat 3: Hristo008 folded before Flop (didn't bet)
Seat 4: vjxbkf folded before Flop (didn't bet)
Seat 5: DuckinF0nk folded before Flop (didn't bet)
Seat 6: uripeleg (button) folded before Flop (didn't bet)


PokerStars Game #102598069220:  Hold'em No Limit ($3/$6 USD) - 2013/08/11 6:02:49 ET
Table 'Dnoces II 40-100 bb' 6-max Seat #1 is the button
Seat 1: ZarubaNT ($611.74 in chips) 
Seat 2: ChowYuenFatt ($589.38 in chips) 
Seat 3: Hristo008 ($468 in chips) 
Seat 4: vjxbkf ($1138.67 in chips) 
Seat 5: DuckinF0nk ($768.20 in chips) 
Seat 6: uripeleg ($821.90 in chips) 
ChowYuenFatt: posts small blind $3
Hristo008: posts big blind $6
*** HOLE CARDS ***
vjxbkf: raises $15 to $21
DuckinF0nk: folds 
uripeleg: folds 
ZarubaNT: folds 
ChowYuenFatt: folds 
Hristo008: folds 
Uncalled bet ($15) returned to vjxbkf
vjxbkf collected $15 from pot
vjxbkf: doesn't show hand 
*** SUMMARY ***
Total pot $15 | Rake $0 
Seat 1: ZarubaNT (button) folded before Flop (didn't bet)
Seat 2: ChowYuenFatt (small blind) folded before Flop
Seat 3: Hristo008 (big blind) folded before Flop
Seat 4: vjxbkf collected ($15)
Seat 5: DuckinF0nk folded before Flop (didn't bet)
Seat 6: uripeleg folded before Flop (didn't bet)


PokerStars Game #102598084300:  Hold'em No Limit ($3/$6 USD) - 2013/08/11 6:03:25 ET
Table 'Dnoces II 40-100 bb' 6-max Seat #2 is the button
Seat 1: ZarubaNT ($611.74 in chips) 
Seat 2: ChowYuenFatt ($586.38 in chips) 
Seat 3: Hristo008 ($462 in chips) 
Seat 4: vjxbkf ($1147.67 in chips) 
Seat 5: DuckinF0nk ($768.20 in chips) 
Seat 6: uripeleg ($821.90 in chips) 
Hristo008: posts small blind $3
vjxbkf: posts big blind $6
*** HOLE CARDS ***
DuckinF0nk: folds 
uripeleg: folds 
ZarubaNT: raises $9 to $15
ChowYuenFatt: calls $15
Hristo008: calls $12
vjxbkf: folds 
*** FLOP *** [9s 2s 8c]
Hristo008: checks 
ZarubaNT: checks 
ChowYuenFatt: bets $39
Hristo008: calls $39
ZarubaNT: folds 
*** TURN *** [9s 2s 8c] [Ks]
Hristo008: checks 
ChowYuenFatt: checks 
*** RIVER *** [9s 2s 8c Ks] [2c]
Hristo008: checks 
ChowYuenFatt: checks 
*** SHOW DOWN ***
Hristo008: shows [Jh Jc] (two pair, Jacks and Deuces)
ChowYuenFatt: mucks hand 
Hristo008 collected $126.20 from pot
*** SUMMARY ***
Total pot $129 | Rake $2.80 
Board [9s 2s 8c Ks 2c]
Seat 1: ZarubaNT folded on the Flop
Seat 2: ChowYuenFatt (button) mucked
Seat 3: Hristo008 (small blind) showed [Jh Jc] and won ($126.20) with two pair, Jacks and Deuces
Seat 4: vjxbkf (big blind) folded before Flop
Seat 5: DuckinF0nk folded before Flop (didn't bet)
Seat 6: uripeleg folded before Flop (didn't bet)


PokerStars Game #102598118191:  Hold'em No Limit ($3/$6 USD) - 2013/08/11 6:04:45 ET
Table 'Dnoces II 40-100 bb' 6-max Seat #3 is the button
Seat 1: ZarubaNT ($600 in chips) 
Seat 2: ChowYuenFatt ($532.38 in chips) 
Seat 3: Hristo008 ($534.20 in chips) 
Seat 4: vjxbkf ($1141.67 in chips) 
Seat 5: DuckinF0nk ($768.20 in chips) 
Seat 6: uripeleg ($821.90 in chips) 
vjxbkf: posts small blind $3
DuckinF0nk: posts big blind $6
*** HOLE CARDS ***
uripeleg: folds 
ZarubaNT has timed out
ZarubaNT: folds 
ChowYuenFatt: raises $9 to $15
Hristo008: folds 
vjxbkf: folds 
DuckinF0nk: folds 
Uncalled bet ($9) returned to ChowYuenFatt
ChowYuenFatt collected $15 from pot
ChowYuenFatt: doesn't show hand 
*** SUMMARY ***
Total pot $15 | Rake $0 
Seat 1: ZarubaNT folded before Flop (didn't bet)
Seat 2: ChowYuenFatt collected ($15)
Seat 3: Hristo008 (button) folded before Flop (didn't bet)
Seat 4: vjxbkf (small blind) folded before Flop
Seat 5: DuckinF0nk (big blind) folded before Flop
Seat 6: uripeleg folded before Flop (didn't bet)


PokerStars Game #102598643575:  Hold'em No Limit ($3/$6 USD) - 2013/08/11 6:25:13 ET
Table 'Dnoces II 40-100 bb' 6-max Seat #3 is the button
Seat 1: ZarubaNT ($1083.40 in chips) 
Seat 2: ChowYuenFatt ($272.38 in chips) 
Seat 3: Hristo008 ($591 in chips) 
Seat 4: vjxbkf ($1711.90 in chips) 
Seat 5: DuckinF0nk ($741.20 in chips) 
Seat 6: uripeleg ($601.70 in chips) 
vjxbkf: posts small blind $3
DuckinF0nk: posts big blind $6
*** HOLE CARDS ***
uripeleg: folds 
ZarubaNT: raises $12 to $18
ChowYuenFatt: calls $18
Hristo008: folds 
vjxbkf: folds 
DuckinF0nk: raises $51 to $69
ZarubaNT: raises $63 to $132
ChowYuenFatt: folds 
DuckinF0nk: raises $609.20 to $741.20 and is all-in
ZarubaNT: calls $609.20
*** FIRST FLOP *** [8c 2d 5d]
*** FIRST TURN *** [8c 2d 5d] [6h]
*** FIRST RIVER *** [8c 2d 5d 6h] [Th]
*** SECOND FLOP *** [2c 7s 8s]
*** SECOND TURN *** [2c 7s 8s] [Jd]
*** SECOND RIVER *** [2c 7s 8s Jd] [9h]
*** FIRST SHOW DOWN ***
DuckinF0nk: shows [As Ks] (high card Ace)
ZarubaNT: shows [Ac Kh] (high card Ace)
DuckinF0nk collected $375.15 from pot
ZarubaNT collected $375.15 from pot
*** SECOND SHOW DOWN ***
DuckinF0nk: shows [As Ks] (high card Ace)
ZarubaNT: shows [Ac Kh] (high card Ace)
DuckinF0nk collected $375.15 from pot
ZarubaNT collected $375.15 from pot
*** SUMMARY ***
Total pot $1503.40 | Rake $2.80 
Hand was run twice
FIRST Board [8c 2d 5d 6h Th]
SECOND Board [2c 7s 8s Jd 9h]
Seat 1: ZarubaNT showed [Ac Kh] and won ($375.15) with high card Ace, and won ($375.15) with high card Ace
Seat 2: ChowYuenFatt folded before Flop
Seat 3: Hristo008 (button) folded before Flop (didn't bet)
Seat 4: vjxbkf (small blind) folded before Flop
Seat 5: DuckinF0nk (big blind) showed [As Ks] and won ($375.15) with high card Ace, and won ($375.15) with high card Ace
Seat 6: uripeleg folded before Flop (didn't bet)


PokerStars Game #102598674947:  Hold'em No Limit ($3/$6 USD) - 2013/08/11 6:26:26 ET
Table 'Dnoces II 40-100 bb' 6-max Seat #4 is the button
Seat 1: ZarubaNT ($1092.50 in chips) 
Seat 2: ChowYuenFatt ($254.38 in chips) 
Seat 3: Hristo008 ($591 in chips) 
Seat 4: vjxbkf ($1708.90 in chips) 
Seat 5: DuckinF0nk ($750.30 in chips) 
Seat 6: uripeleg ($601.70 in chips) 
DuckinF0nk: posts small blind $3
uripeleg: posts big blind $6
*** HOLE CARDS ***
ZarubaNT: folds 
ChowYuenFatt: folds 
Hristo008: folds 
vjxbkf: folds 
DuckinF0nk: folds 
Uncalled bet ($3) returned to uripeleg
uripeleg collected $6 from pot
*** SUMMARY ***
Total pot $6 | Rake $0 
Seat 1: ZarubaNT folded before Flop (didn't bet)
Seat 2: ChowYuenFatt folded before Flop (didn't bet)
Seat 3: Hristo008 folded before Flop (didn't bet)
Seat 4: vjxbkf (button) folded before Flop (didn't bet)
Seat 5: DuckinF0nk (small blind) folded before Flop
Seat 6: uripeleg (big blind) collected ($6)


PokerStars Game #102598681576:  Hold'em No Limit ($3/$6 USD) - 2013/08/11 6:26:42 ET
Table 'Dnoces II 40-100 bb' 6-max Seat #5 is the button
Seat 1: ZarubaNT ($1092.50 in chips) 
Seat 2: ChowYuenFatt ($254.38 in chips) 
Seat 3: Hristo008 ($591 in chips) 
Seat 4: vjxbkf ($1708.90 in chips) 
Seat 5: DuckinF0nk ($747.30 in chips) 
Seat 6: uripeleg ($604.70 in chips) 
uripeleg: posts small blind $3
ZarubaNT: posts big blind $6
*** HOLE CARDS ***
ChowYuenFatt: folds 
Hristo008: folds 
vjxbkf: raises $12 to $18
DuckinF0nk: folds 
uripeleg: folds 
ZarubaNT: folds 
Uncalled bet ($12) returned to vjxbkf
vjxbkf collected $15 from pot
vjxbkf: doesn't show hand 
*** SUMMARY ***
Total pot $15 | Rake $0 
Seat 1: ZarubaNT (big blind) folded before Flop
Seat 2: ChowYuenFatt folded before Flop (didn't bet)
Seat 3: Hristo008 folded before Flop (didn't bet)
Seat 4: vjxbkf collected ($15)
Seat 5: DuckinF0nk (button) folded before Flop (didn't bet)
Seat 6: uripeleg (small blind) folded before Flop


PokerStars Game #102598690662:  Hold'em No Limit ($3/$6 USD) - 2013/08/11 6:27:03 ET
Table 'Dnoces II 40-100 bb' 6-max Seat #6 is the button
Seat 1: ZarubaNT ($1086.50 in chips) 
Seat 2: ChowYuenFatt ($254.38 in chips) 
Seat 3: Hristo008 ($591 in chips) 
Seat 4: vjxbkf ($1717.90 in chips) 
Seat 5: DuckinF0nk ($747.30 in chips) 
Seat 6: uripeleg ($601.70 in chips) 
ZarubaNT: posts small blind $3
ChowYuenFatt: posts big blind $6
*** HOLE CARDS ***
Hristo008: folds 
vjxbkf: folds 
DuckinF0nk: raises $9 to $15
uripeleg: folds 
ZarubaNT: folds 
ChowYuenFatt: folds 
Uncalled bet ($9) returned to DuckinF0nk
DuckinF0nk collected $15 from pot
DuckinF0nk: doesn't show hand 
*** SUMMARY ***
Total pot $15 | Rake $0 
Seat 1: ZarubaNT (small blind) folded before Flop
Seat 2: ChowYuenFatt (big blind) folded before Flop
Seat 3: Hristo008 folded before Flop (didn't bet)
Seat 4: vjxbkf folded before Flop (didn't bet)
Seat 5: DuckinF0nk collected ($15)
Seat 6: uripeleg (button) folded before Flop (didn't bet)


PokerStars Game #102598705517:  Hold'em No Limit ($3/$6 USD) - 2013/08/11 6:27:38 ET
Table 'Dnoces II 40-100 bb' 6-max Seat #1 is the button
Seat 1: ZarubaNT ($1083.50 in chips) 
Seat 2: ChowYuenFatt ($248.38 in chips) 
Seat 3: Hristo008 ($591 in chips) 
Seat 4: vjxbkf ($1717.90 in chips) 
Seat 5: DuckinF0nk ($756.30 in chips) 
Seat 6: uripeleg ($601.70 in chips) 
ChowYuenFatt: posts small blind $3
Hristo008: posts big blind $6
*** HOLE CARDS ***
vjxbkf: folds 
DuckinF0nk: folds 
uripeleg: raises $6 to $12
ZarubaNT: folds 
ChowYuenFatt: folds 
Hristo008: calls $6
*** FLOP *** [Qh 7s 3s]
Hristo008: checks 
uripeleg: bets $20.62
Hristo008: folds 
Uncalled bet ($20.62) returned to uripeleg
uripeleg collected $25.78 from pot
*** SUMMARY ***
Total pot $27 | Rake $1.22 
Board [Qh 7s 3s]
Seat 1: ZarubaNT (button) folded before Flop (didn't bet)
Seat 2: ChowYuenFatt (small blind) folded before Flop
Seat 3: Hristo008 (big blind) folded on the Flop
Seat 4: vjxbkf folded before Flop (didn't bet)
Seat 5: DuckinF0nk folded before Flop (didn't bet)
Seat 6: uripeleg collected ($25.78)


PokerStars Game #102598724902:  Hold'em No Limit ($3/$6 USD) - 2013/08/11 6:28:22 ET
Table 'Dnoces II 40-100 bb' 6-max Seat #2 is the button
Seat 1: ZarubaNT ($1083.50 in chips) 
Seat 2: ChowYuenFatt ($245.38 in chips) 
Seat 3: Hristo008 ($579 in chips) 
Seat 4: vjxbkf ($1717.90 in chips) 
Seat 5: DuckinF0nk ($756.30 in chips) 
Seat 6: uripeleg ($615.48 in chips) 
Hristo008: posts small blind $3
vjxbkf: posts big blind $6
*** HOLE CARDS ***
DuckinF0nk: folds 
uripeleg: raises $7.50 to $13.50
ZarubaNT: folds 
ChowYuenFatt: folds 
Hristo008: folds 
vjxbkf: folds 
Uncalled bet ($7.50) returned to uripeleg
uripeleg collected $15 from pot
*** SUMMARY ***
Total pot $15 | Rake $0 
Seat 1: ZarubaNT folded before Flop (didn't bet)
Seat 2: ChowYuenFatt (button) folded before Flop (didn't bet)
Seat 3: Hristo008 (small blind) folded before Flop
Seat 4: vjxbkf (big blind) folded before Flop
Seat 5: DuckinF0nk folded before Flop (didn't bet)
Seat 6: uripeleg collected ($15)


PokerStars Game #102598733846:  Hold'em No Limit ($3/$6 USD) - 2013/08/11 6:28:43 ET
Table 'Dnoces II 40-100 bb' 6-max Seat #3 is the button
Seat 1: ZarubaNT ($1083.50 in chips) 
Seat 2: ChowYuenFatt ($245.38 in chips) 
Seat 3: Hristo008 ($576 in chips) 
Seat 4: vjxbkf ($1711.90 in chips) 
Seat 6: uripeleg ($624.48 in chips) 
vjxbkf: posts small blind $3
uripeleg: posts big blind $6
*** HOLE CARDS ***
ZarubaNT: folds 
ChowYuenFatt: folds 
Hristo008: folds 
vjxbkf: folds 
Uncalled bet ($3) returned to uripeleg
uripeleg collected $6 from pot
*** SUMMARY ***
Total pot $6 | Rake $0 
Seat 1: ZarubaNT folded before Flop (didn't bet)
Seat 2: ChowYuenFatt folded before Flop (didn't bet)
Seat 3: Hristo008 (button) folded before Flop (didn't bet)
Seat 4: vjxbkf (small blind) folded before Flop
Seat 6: uripeleg (big blind) collected ($6)


PokerStars Game #102598740437:  Hold'em No Limit ($3/$6 USD) - 2013/08/11 6:28:58 ET
Table 'Dnoces II 40-100 bb' 6-max Seat #4 is the button
Seat 1: ZarubaNT ($1083.50 in chips) 
Seat 2: ChowYuenFatt ($245.38 in chips) 
Seat 3: Hristo008 ($576 in chips) 
Seat 4: vjxbkf ($1708.90 in chips) 
Seat 6: uripeleg ($627.48 in chips) 
uripeleg: posts small blind $3
ZarubaNT: posts big blind $6
*** HOLE CARDS ***
ChowYuenFatt: folds 
Hristo008: folds 
vjxbkf: folds 
uripeleg: folds 
Uncalled bet ($3) returned to ZarubaNT
ZarubaNT collected $6 from pot
ZarubaNT: doesn't show hand 
*** SUMMARY ***
Total pot $6 | Rake $0 
Seat 1: ZarubaNT (big blind) collected ($6)
Seat 2: ChowYuenFatt folded before Flop (didn't bet)
Seat 3: Hristo008 folded before Flop (didn't bet)
Seat 4: vjxbkf (button) folded before Flop (didn't bet)
Seat 6: uripeleg (small blind) folded before Flop


PokerStars Game #102598747974:  Hold'em No Limit ($3/$6 USD) - 2013/08/11 6:29:16 ET
Table 'Dnoces II 40-100 bb' 6-max Seat #6 is the button
Seat 1: ZarubaNT ($1086.50 in chips) 
Seat 2: ChowYuenFatt ($245.38 in chips) 
Seat 3: Hristo008 ($576 in chips) 
Seat 4: vjxbkf ($1708.90 in chips) 
Seat 6: uripeleg ($624.48 in chips) 
ZarubaNT: posts small blind $3
ChowYuenFatt: posts big blind $6
*** HOLE CARDS ***
Hristo008: folds 
vjxbkf: folds 
uripeleg: raises $6 to $12
ZarubaNT: folds 
ChowYuenFatt: folds 
Uncalled bet ($6) returned to uripeleg
uripeleg collected $15 from pot
*** SUMMARY ***
Total pot $15 | Rake $0 
Seat 1: ZarubaNT (small blind) folded before Flop
Seat 2: ChowYuenFatt (big blind) folded before Flop
Seat 3: Hristo008 folded before Flop (didn't bet)
Seat 4: vjxbkf folded before Flop (didn't bet)
Seat 6: uripeleg (button) collected ($15)


PokerStars Game #102598757284:  Hold'em No Limit ($3/$6 USD) - 2013/08/11 6:29:38 ET
Table 'Dnoces II 40-100 bb' 6-max Seat #1 is the button
Seat 1: ZarubaNT ($1083.50 in chips) 
Seat 2: ChowYuenFatt ($239.38 in chips) 
Seat 3: Hristo008 ($576 in chips) 
Seat 4: vjxbkf ($1708.90 in chips) 
Seat 6: uripeleg ($633.48 in chips) 
ChowYuenFatt: posts small blind $3
Hristo008: posts big blind $6
*** HOLE CARDS ***
vjxbkf: folds 
uripeleg: folds 
ZarubaNT: folds 
ChowYuenFatt: folds 
Uncalled bet ($3) returned to Hristo008
Hristo008 collected $6 from pot
Hristo008: doesn't show hand 
*** SUMMARY ***
Total pot $6 | Rake $0 
Seat 1: ZarubaNT (button) folded before Flop (didn't bet)
Seat 2: ChowYuenFatt (small blind) folded before Flop
Seat 3: Hristo008 (big blind) collected ($6)
Seat 4: vjxbkf folded before Flop (didn't bet)
Seat 6: uripeleg folded before Flop (didn't bet)


PokerStars Game #102598386268:  Hold'em No Limit ($3/$6 USD) - 2013/08/11 6:15:14 ET
Table 'Dnoces II 40-100 bb' 6-max Seat #2 is the button
Seat 1: ZarubaNT ($822.20 in chips) 
Seat 2: ChowYuenFatt ($328.38 in chips) 
Seat 3: Hristo008 ($274.70 in chips) 
Seat 4: vjxbkf ($1404.80 in chips) 
Seat 5: DuckinF0nk ($750.20 in chips) 
Seat 6: uripeleg ($829.70 in chips) 
Hristo008: posts small blind $3
vjxbkf: posts big blind $6
*** HOLE CARDS ***
DuckinF0nk: folds 
uripeleg: folds 
ZarubaNT: raises $9 to $15
ChowYuenFatt: calls $15
Hristo008: calls $12
vjxbkf: folds 
*** FLOP *** [9d 2c Ah]
Hristo008: checks 
ZarubaNT: checks 
ChowYuenFatt: bets $32
Hristo008: calls $32
ZarubaNT: folds 
*** TURN *** [9d 2c Ah] [Qh]
Hristo008: checks 
ChowYuenFatt: checks 
*** RIVER *** [9d 2c Ah Qh] [3c]
Hristo008: checks 
ChowYuenFatt: checks 
*** SHOW DOWN ***
Hristo008: shows [9c Jh] (a pair of Nines)
ChowYuenFatt: mucks hand 
Hristo008 collected $112.20 from pot
*** SUMMARY ***
Total pot $115 | Rake $2.80 
Board [9d 2c Ah Qh 3c]
Seat 1: ZarubaNT folded on the Flop
Seat 2: ChowYuenFatt (button) mucked
Seat 3: Hristo008 (small blind) showed [9c Jh] and won ($112.20) with a pair of Nines
Seat 4: vjxbkf (big blind) folded before Flop
Seat 5: DuckinF0nk folded before Flop (didn't bet)
Seat 6: uripeleg folded before Flop (didn't bet)


PokerStars Game #102598416525:  Hold'em No Limit ($3/$6 USD) - 2013/08/11 6:16:24 ET
Table 'Dnoces II 40-100 bb' 6-max Seat #3 is the button
Seat 1: ZarubaNT ($807.20 in chips) 
Seat 2: ChowYuenFatt ($281.38 in chips) 
Seat 3: Hristo008 ($339.90 in chips) 
Seat 4: vjxbkf ($1398.80 in chips) 
Seat 5: DuckinF0nk ($750.20 in chips) 
Seat 6: uripeleg ($829.70 in chips) 
vjxbkf: posts small blind $3
DuckinF0nk: posts big blind $6
*** HOLE CARDS ***
uripeleg: raises $7.50 to $13.50
ZarubaNT: folds 
ChowYuenFatt: folds 
Hristo008: raises $28.50 to $42
vjxbkf: folds 
DuckinF0nk: folds 
uripeleg: raises $120 to $162
Hristo008: folds 
Uncalled bet ($120) returned to uripeleg
uripeleg collected $93 from pot
*** SUMMARY ***
Total pot $93 | Rake $0 
Seat 1: ZarubaNT folded before Flop (didn't bet)
Seat 2: ChowYuenFatt folded before Flop (didn't bet)
Seat 3: Hristo008 (button) folded before Flop
Seat 4: vjxbkf (small blind) folded before Flop
Seat 5: DuckinF0nk (big blind) folded before Flop
Seat 6: uripeleg collected ($93)


PokerStars Game #102598437172:  Hold'em No Limit ($3/$6 USD) - 2013/08/11 6:17:12 ET
Table 'Dnoces II 40-100 bb' 6-max Seat #4 is the button
Seat 1: ZarubaNT ($807.20 in chips) 
Seat 2: ChowYuenFatt ($281.38 in chips) 
Seat 3: Hristo008 ($297.90 in chips) 
Seat 4: vjxbkf ($1395.80 in chips) 
Seat 5: DuckinF0nk ($744.20 in chips) 
Seat 6: uripeleg ($880.70 in chips) 
DuckinF0nk: posts small blind $3
uripeleg: posts big blind $6
*** HOLE CARDS ***
ZarubaNT: folds 
ChowYuenFatt: folds 
Hristo008: folds 
vjxbkf: raises $6 to $12
DuckinF0nk: folds 
uripeleg: folds 
Uncalled bet ($6) returned to vjxbkf
vjxbkf collected $15 from pot
vjxbkf: doesn't show hand 
*** SUMMARY ***
Total pot $15 | Rake $0 
Seat 1: ZarubaNT folded before Flop (didn't bet)
Seat 2: ChowYuenFatt folded before Flop (didn't bet)
Seat 3: Hristo008 folded before Flop (didn't bet)
Seat 4: vjxbkf (button) collected ($15)
Seat 5: DuckinF0nk (small blind) folded before Flop
Seat 6: uripeleg (big blind) folded before Flop


PokerStars Game #102598448898:  Hold'em No Limit ($3/$6 USD) - 2013/08/11 6:17:39 ET
Table 'Dnoces II 40-100 bb' 6-max Seat #5 is the button
Seat 1: ZarubaNT ($807.20 in chips) 
Seat 2: ChowYuenFatt ($281.38 in chips) 
Seat 3: Hristo008 ($297.90 in chips) 
Seat 4: vjxbkf ($1404.80 in chips) 
Seat 5: DuckinF0nk ($741.20 in chips) 
Seat 6: uripeleg ($874.70 in chips) 
uripeleg: posts small blind $3
ZarubaNT: posts big blind $6
*** HOLE CARDS ***
ChowYuenFatt: folds 
Hristo008: folds 
vjxbkf: folds 
DuckinF0nk: folds 
uripeleg: folds 
Uncalled bet ($3) returned to ZarubaNT
ZarubaNT collected $6 from pot
ZarubaNT: doesn't show hand 
*** SUMMARY ***
Total pot $6 | Rake $0 
Seat 1: ZarubaNT (big blind) collected ($6)
Seat 2: ChowYuenFatt folded before Flop (didn't bet)
Seat 3: Hristo008 folded before Flop (didn't bet)
Seat 4: vjxbkf folded before Flop (didn't bet)
Seat 5: DuckinF0nk (button) folded before Flop (didn't bet)
Seat 6: uripeleg (small blind) folded before Flop


PokerStars Game #102598461633:  Hold'em No Limit ($3/$6 USD) - 2013/08/11 6:18:08 ET
Table 'Dnoces II 40-100 bb' 6-max Seat #6 is the button
Seat 1: ZarubaNT ($810.20 in chips) 
Seat 2: ChowYuenFatt ($281.38 in chips) 
Seat 3: Hristo008 ($297.90 in chips) 
Seat 4: vjxbkf ($1404.80 in chips) 
Seat 5: DuckinF0nk ($741.20 in chips) 
Seat 6: uripeleg ($871.70 in chips) 
ZarubaNT: posts small blind $3
ChowYuenFatt: posts big blind $6
*** HOLE CARDS ***
Hristo008: raises $6 to $12
vjxbkf: folds 
DuckinF0nk: folds 
uripeleg: folds 
ZarubaNT: folds 
ChowYuenFatt: folds 
Uncalled bet ($6) returned to Hristo008
Hristo008 collected $15 from pot
Hristo008: doesn't show hand 
*** SUMMARY ***
Total pot $15 | Rake $0 
Seat 1: ZarubaNT (small blind) folded before Flop
Seat 2: ChowYuenFatt (big blind) folded before Flop
Seat 3: Hristo008 collected ($15)
Seat 4: vjxbkf folded before Flop (didn't bet)
Seat 5: DuckinF0nk folded before Flop (didn't bet)
Seat 6: uripeleg (button) folded before Flop (didn't bet)


PokerStars Game #102598469345:  Hold'em No Limit ($3/$6 USD) - 2013/08/11 6:18:26 ET
Table 'Dnoces II 40-100 bb' 6-max Seat #1 is the button
Seat 1: ZarubaNT ($807.20 in chips) 
Seat 2: ChowYuenFatt ($275.38 in chips) 
Seat 3: Hristo008 ($306.90 in chips) 
Seat 4: vjxbkf ($1404.80 in chips) 
Seat 5: DuckinF0nk ($741.20 in chips) 
Seat 6: uripeleg ($871.70 in chips) 
ChowYuenFatt: posts small blind $3
Hristo008: posts big blind $6
*** HOLE CARDS ***
vjxbkf: raises $15 to $21
DuckinF0nk: folds 
uripeleg: folds 
ZarubaNT: folds 
ChowYuenFatt: folds 
Hristo008: calls $15
*** FLOP *** [7d Qc Th]
Hristo008: checks 
vjxbkf: bets $27
Hristo008: raises $27 to $54
vjxbkf: calls $27
*** TURN *** [7d Qc Th] [3h]
Hristo008: bets $84
vjxbkf: calls $84
*** RIVER *** [7d Qc Th 3h] [9h]
Hristo008: bets $6
vjxbkf: raises $1239.80 to $1245.80 and is all-in
Hristo008: calls $141.90 and is all-in
Uncalled bet ($1097.90) returned to vjxbkf
*** SHOW DOWN ***
vjxbkf: shows [Ks Js] (a straight, Nine to King)
Hristo008: shows [7c 7h] (three of a kind, Sevens)
vjxbkf collected $614 from pot
*** SUMMARY ***
Total pot $616.80 | Rake $2.80 
Board [7d Qc Th 3h 9h]
Seat 1: ZarubaNT (button) folded before Flop (didn't bet)
Seat 2: ChowYuenFatt (small blind) folded before Flop
Seat 3: Hristo008 (big blind) showed [7c 7h] and lost with three of a kind, Sevens
Seat 4: vjxbkf showed [Ks Js] and won ($614) with a straight, Nine to King
Seat 5: DuckinF0nk folded before Flop (didn't bet)
Seat 6: uripeleg folded before Flop (didn't bet)


PokerStars Game #102599028874:  Hold'em No Limit ($3/$6 USD) - 2013/08/11 6:40:04 ET
Table 'Dnoces II 40-100 bb' 6-max Seat #6 is the button
Seat 2: GERAKLmeat ($253.52 in chips) 
Seat 3: khk24 ($600 in chips) 
Seat 4: vjxbkf ($1976.98 in chips) 
Seat 5: DuckinF0nk ($768.30 in chips) 
Seat 6: uripeleg ($671.52 in chips) 
$-Twackle-$ will be allowed to play after the button
GERAKLmeat: posts small blind $3
khk24: posts big blind $6
*** HOLE CARDS ***
vjxbkf: folds 
DuckinF0nk: folds 
uripeleg: raises $6 to $12
$-Twackle-$ leaves the table
GERAKLmeat: folds 
khk24: folds 
Uncalled bet ($6) returned to uripeleg
uripeleg collected $15 from pot
*** SUMMARY ***
Total pot $15 | Rake $0 
Seat 2: GERAKLmeat (small blind) folded before Flop
Seat 3: khk24 (big blind) folded before Flop
Seat 4: vjxbkf folded before Flop (didn't bet)
Seat 5: DuckinF0nk folded before Flop (didn't bet)
Seat 6: uripeleg (button) collected ($15)


PokerStars Game #102599035958:  Hold'em No Limit ($3/$6 USD) - 2013/08/11 6:40:21 ET
Table 'Dnoces II 40-100 bb' 6-max Seat #2 is the button
Seat 2: GERAKLmeat ($250.52 in chips) 
Seat 3: khk24 ($600 in chips) 
Seat 4: vjxbkf ($1976.98 in chips) 
Seat 5: DuckinF0nk ($768.30 in chips) 
Seat 6: uripeleg ($680.52 in chips) 
khk24: posts small blind $3
vjxbkf: posts big blind $6
*** HOLE CARDS ***
DuckinF0nk: folds 
uripeleg: folds 
GERAKLmeat: raises $6 to $12
khk24: raises $24 to $36
vjxbkf: folds 
GERAKLmeat: folds 
Uncalled bet ($24) returned to khk24
khk24 collected $30 from pot
khk24: doesn't show hand 
*** SUMMARY ***
Total pot $30 | Rake $0 
Seat 2: GERAKLmeat (button) folded before Flop
Seat 3: khk24 (small blind) collected ($30)
Seat 4: vjxbkf (big blind) folded before Flop
Seat 5: DuckinF0nk folded before Flop (didn't bet)
Seat 6: uripeleg folded before Flop (didn't bet)


PokerStars Game #102599047137:  Hold'em No Limit ($3/$6 USD) - 2013/08/11 6:40:46 ET
Table 'Dnoces II 40-100 bb' 6-max Seat #3 is the button
Seat 2: GERAKLmeat ($240 in chips) 
Seat 3: khk24 ($618 in chips) 
Seat 4: vjxbkf ($1970.98 in chips) 
Seat 6: uripeleg ($680.52 in chips) 
vjxbkf: posts small blind $3
DuckinF0nk: is sitting out 
uripeleg: posts big blind $6
*** HOLE CARDS ***
DuckinF0nk leaves the table
GERAKLmeat: folds 
khk24: raises $6 to $12
Hristo008 joins the table at seat #5 
Mekcsiken joins the table at seat #1 
vjxbkf: folds 
uripeleg: folds 
Uncalled bet ($6) returned to khk24
khk24 collected $15 from pot
khk24: doesn't show hand 
*** SUMMARY ***
Total pot $15 | Rake $0 
Seat 2: GERAKLmeat folded before Flop (didn't bet)
Seat 3: khk24 (button) collected ($15)
Seat 4: vjxbkf (small blind) folded before Flop
Seat 6: uripeleg (big blind) folded before Flop


PokerStars Game #102599063027:  Hold'em No Limit ($3/$6 USD) - 2013/08/11 6:41:23 ET
Table 'Dnoces II 40-100 bb' 6-max Seat #4 is the button
Seat 1: Mekcsiken ($600 in chips) 
Seat 2: GERAKLmeat ($240 in chips) 
Seat 3: khk24 ($627 in chips) 
Seat 4: vjxbkf ($1967.98 in chips) 
Seat 6: uripeleg ($674.52 in chips) 
Hristo008 will be allowed to play after the button
uripeleg: posts small blind $3
Mekcsiken: posts big blind $6
*** HOLE CARDS ***
GERAKLmeat: folds 
khk24: folds 
vjxbkf: raises $6 to $12
uripeleg: raises $33 to $45
Mekcsiken: folds 
vjxbkf: folds 
Uncalled bet ($33) returned to uripeleg
uripeleg collected $30 from pot
*** SUMMARY ***
Total pot $30 | Rake $0 
Seat 1: Mekcsiken (big blind) folded before Flop
Seat 2: GERAKLmeat folded before Flop (didn't bet)
Seat 3: khk24 folded before Flop (didn't bet)
Seat 4: vjxbkf (button) folded before Flop
Seat 6: uripeleg (small blind) collected ($30)


PokerStars Game #102599082519:  Hold'em No Limit ($3/$6 USD) - 2013/08/11 6:42:05 ET
Table 'Dnoces II 40-100 bb' 6-max Seat #6 is the button
Seat 1: Mekcsiken ($600 in chips) 
Seat 2: GERAKLmeat ($240 in chips) 
Seat 3: khk24 ($627 in chips) 
Seat 4: vjxbkf ($1955.98 in chips) 
Seat 6: uripeleg ($692.52 in chips) 
Mekcsiken: posts small blind $3
GERAKLmeat: posts big blind $6
Hristo008: sits out 
*** HOLE CARDS ***
khk24: folds 
vjxbkf: folds 
uripeleg: raises $7.50 to $13.50
Mekcsiken: folds 
GERAKLmeat: raises $16.50 to $30
uripeleg: raises $662.52 to $692.52 and is all-in
GERAKLmeat: folds 
Uncalled bet ($662.52) returned to uripeleg
uripeleg collected $63 from pot
*** SUMMARY ***
Total pot $63 | Rake $0 
Seat 1: Mekcsiken (small blind) folded before Flop
Seat 2: GERAKLmeat (big blind) folded before Flop
Seat 3: khk24 folded before Flop (didn't bet)
Seat 4: vjxbkf folded before Flop (didn't bet)
Seat 6: uripeleg (button) collected ($63)


PokerStars Game #102599099942:  Hold'em No Limit ($3/$6 USD) - 2013/08/11 6:42:44 ET
Table 'Dnoces II 40-100 bb' 6-max Seat #1 is the button
Seat 1: Mekcsiken ($600 in chips) 
Seat 2: GERAKLmeat ($240 in chips) 
Seat 3: khk24 ($627 in chips) 
Seat 4: vjxbkf ($1955.98 in chips) 
Seat 6: uripeleg ($725.52 in chips) 
GERAKLmeat: posts small blind $3
khk24: posts big blind $6
Hristo008: sits out 
*** HOLE CARDS ***
vjxbkf: folds 
uripeleg: folds 
Mekcsiken: folds 
GERAKLmeat: raises $6 to $12
khk24: calls $6
*** FLOP *** [Ts 4s Jh]
GERAKLmeat: bets $11.68
khk24: calls $11.68
*** TURN *** [Ts 4s Jh] [7d]
GERAKLmeat: bets $36
khk24: folds 
Uncalled bet ($36) returned to GERAKLmeat
GERAKLmeat collected $45.23 from pot
GERAKLmeat: doesn't show hand 
*** SUMMARY ***
Total pot $47.36 | Rake $2.13 
Board [Ts 4s Jh 7d]
Seat 1: Mekcsiken (button) folded before Flop (didn't bet)
Seat 2: GERAKLmeat (small blind) collected ($45.23)
Seat 3: khk24 (big blind) folded on the Turn
Seat 4: vjxbkf folded before Flop (didn't bet)
Seat 6: uripeleg folded before Flop (didn't bet)


PokerStars Game #102599130372:  Hold'em No Limit ($3/$6 USD) - 2013/08/11 6:43:51 ET
Table 'Dnoces II 40-100 bb' 6-max Seat #2 is the button
Seat 1: Mekcsiken ($600 in chips) 
Seat 2: GERAKLmeat ($261.55 in chips) 
Seat 3: khk24 ($603.32 in chips) 
Seat 4: vjxbkf ($1955.98 in chips) 
Seat 6: uripeleg ($725.52 in chips) 
khk24: posts small blind $3
vjxbkf: posts big blind $6
Hristo008: sits out 
*** HOLE CARDS ***
uripeleg: folds 
Mekcsiken: folds 
GERAKLmeat: raises $6 to $12
khk24: folds 
vjxbkf: folds 
Uncalled bet ($6) returned to GERAKLmeat
GERAKLmeat collected $15 from pot
GERAKLmeat: doesn't show hand 
*** SUMMARY ***
Total pot $15 | Rake $0 
Seat 1: Mekcsiken folded before Flop (didn't bet)
Seat 2: GERAKLmeat (button) collected ($15)
Seat 3: khk24 (small blind) folded before Flop
Seat 4: vjxbkf (big blind) folded before Flop
Seat 6: uripeleg folded before Flop (didn't bet)


PokerStars Game #102599138124:  Hold'em No Limit ($3/$6 USD) - 2013/08/11 6:44:08 ET
Table 'Dnoces II 40-100 bb' 6-max Seat #3 is the button
Seat 1: Mekcsiken ($600 in chips) 
Seat 2: GERAKLmeat ($270.55 in chips) 
Seat 3: khk24 ($600.32 in chips) 
Seat 4: vjxbkf ($1949.98 in chips) 
Seat 5: Hristo008 ($550.78 in chips) 
Seat 6: uripeleg ($725.52 in chips) 
vjxbkf: posts small blind $3
Hristo008: posts big blind $6
*** HOLE CARDS ***
uripeleg: folds 
Mekcsiken: folds 
GERAKLmeat: folds 
khk24: folds 
vjxbkf: folds 
Uncalled bet ($3) returned to Hristo008
Hristo008 collected $6 from pot
*** SUMMARY ***
Total pot $6 | Rake $0 
Seat 1: Mekcsiken folded before Flop (didn't bet)
Seat 2: GERAKLmeat folded before Flop (didn't bet)
Seat 3: khk24 (button) folded before Flop (didn't bet)
Seat 4: vjxbkf (small blind) folded before Flop
Seat 5: Hristo008 (big blind) collected ($6)
Seat 6: uripeleg folded before Flop (didn't bet)


PokerStars Game #102599150753:  Hold'em No Limit ($3/$6 USD) - 2013/08/11 6:44:36 ET
Table 'Dnoces II 40-100 bb' 6-max Seat #4 is the button
Seat 1: Mekcsiken ($600 in chips) 
Seat 2: GERAKLmeat ($270.55 in chips) 
Seat 3: khk24 ($600.32 in chips) 
Seat 4: vjxbkf ($1946.98 in chips) 
Seat 5: Hristo008 ($553.78 in chips) 
Seat 6: uripeleg ($725.52 in chips) 
Hristo008: posts small blind $3
uripeleg: posts big blind $6
*** HOLE CARDS ***
Mekcsiken: folds 
GERAKLmeat: raises $6 to $12
khk24: folds 
vjxbkf: calls $12
Hristo008: folds 
uripeleg: folds 
*** FLOP *** [8c 9d Ts]
GERAKLmeat: bets $16.07
vjxbkf: calls $16.07
*** TURN *** [8c 9d Ts] [7c]
GERAKLmeat: bets $50
vjxbkf: calls $50
*** RIVER *** [8c 9d Ts 7c] [Qd]
GERAKLmeat: bets $192.48 and is all-in
vjxbkf: calls $192.48
*** SHOW DOWN ***
GERAKLmeat: shows [Kc Jc] (a straight, Nine to King)
vjxbkf: shows [Ac Jh] (a straight, Eight to Queen)
GERAKLmeat collected $547.30 from pot
*** SUMMARY ***
Total pot $550.10 | Rake $2.80 
Board [8c 9d Ts 7c Qd]
Seat 1: Mekcsiken folded before Flop (didn't bet)
Seat 2: GERAKLmeat showed [Kc Jc] and won ($547.30) with a straight, Nine to King
Seat 3: khk24 folded before Flop (didn't bet)
Seat 4: vjxbkf (button) showed [Ac Jh] and lost with a straight, Eight to Queen
Seat 5: Hristo008 (small blind) folded before Flop
Seat 6: uripeleg (big blind) folded before Flop


PokerStars Game #102598909782:  Hold'em No Limit ($3/$6 USD) - 2013/08/11 6:35:30 ET
Table 'Dnoces II 40-100 bb' 6-max Seat #6 is the button
Seat 1: ZarubaNT ($1068.50 in chips) 
Seat 2: GERAKLmeat ($240 in chips) 
Seat 4: vjxbkf ($1988.98 in chips) 
Seat 6: uripeleg ($627.48 in chips) 
ZarubaNT: posts small blind $3
GERAKLmeat: posts big blind $6
DuckinF0nk: sits out 
*** HOLE CARDS ***
vjxbkf: folds 
uripeleg: raises $6 to $12
ZarubaNT: folds 
GERAKLmeat: calls $6
*** FLOP *** [Ks Qs 5c]
GERAKLmeat: bets $13.14
uripeleg: calls $13.14
*** TURN *** [Ks Qs 5c] [Td]
GERAKLmeat: bets $26.40
uripeleg: calls $26.40
*** RIVER *** [Ks Qs 5c Td] [8s]
GERAKLmeat: checks 
uripeleg: checks 
*** SHOW DOWN ***
GERAKLmeat: shows [Jh Qc] (a pair of Queens)
uripeleg: shows [Qh 8h] (two pair, Queens and Eights)
uripeleg collected $104.58 from pot
*** SUMMARY ***
Total pot $106.08 | Rake $1.50 
Board [Ks Qs 5c Td 8s]
Seat 1: ZarubaNT (small blind) folded before Flop
Seat 2: GERAKLmeat (big blind) showed [Jh Qc] and lost with a pair of Queens
Seat 4: vjxbkf folded before Flop (didn't bet)
Seat 6: uripeleg (button) showed [Qh 8h] and won ($104.58) with two pair, Queens and Eights


PokerStars Game #102598939018:  Hold'em No Limit ($3/$6 USD) - 2013/08/11 6:36:38 ET
Table 'Dnoces II 40-100 bb' 6-max Seat #1 is the button
Seat 1: ZarubaNT ($1065.50 in chips) 
Seat 2: GERAKLmeat ($240 in chips) 
Seat 4: vjxbkf ($1988.98 in chips) 
Seat 6: uripeleg ($680.52 in chips) 
GERAKLmeat: posts small blind $3
vjxbkf: posts big blind $6
DuckinF0nk: sits out 
*** HOLE CARDS ***
uripeleg: folds 
ZarubaNT: raises $6 to $12
GERAKLmeat: raises $12 to $24
vjxbkf: folds 
ZarubaNT: calls $12
*** FLOP *** [Kc 7c 3h]
GERAKLmeat is disconnected 
GERAKLmeat is connected 
GERAKLmeat: bets $26.77
Hristo008 leaves the table
ZarubaNT: calls $26.77
*** TURN *** [Kc 7c 3h] [4s]
GERAKLmeat: checks 
ZarubaNT: bets $54
GERAKLmeat: folds 
Uncalled bet ($54) returned to ZarubaNT
ZarubaNT collected $106.04 from pot
ZarubaNT: doesn't show hand 
*** SUMMARY ***
Total pot $107.54 | Rake $1.50 
Board [Kc 7c 3h 4s]
Seat 1: ZarubaNT (button) collected ($106.04)
Seat 2: GERAKLmeat (small blind) folded on the Turn
Seat 4: vjxbkf (big blind) folded before Flop
Seat 6: uripeleg folded before Flop (didn't bet)


PokerStars Game #102598973793:  Hold'em No Limit ($3/$6 USD) - 2013/08/11 6:37:57 ET
Table 'Dnoces II 40-100 bb' 6-max Seat #2 is the button
Seat 1: ZarubaNT ($1120.77 in chips) 
Seat 2: GERAKLmeat ($240 in chips) 
Seat 4: vjxbkf ($1982.98 in chips) 
Seat 5: DuckinF0nk ($756.30 in chips) 
Seat 6: uripeleg ($680.52 in chips) 
vjxbkf: posts small blind $3
DuckinF0nk: posts big blind $6
*** HOLE CARDS ***
uripeleg: folds 
ZarubaNT: folds 
GERAKLmeat: raises $6 to $12
vjxbkf: folds 
DuckinF0nk: raises $27 to $39
GERAKLmeat: folds 
Uncalled bet ($27) returned to DuckinF0nk
DuckinF0nk collected $27 from pot
DuckinF0nk: doesn't show hand 
*** SUMMARY ***
Total pot $27 | Rake $0 
Seat 1: ZarubaNT folded before Flop (didn't bet)
Seat 2: GERAKLmeat (button) folded before Flop
Seat 4: vjxbkf (small blind) folded before Flop
Seat 5: DuckinF0nk (big blind) collected ($27)
Seat 6: uripeleg folded before Flop (didn't bet)


PokerStars Game #102598991355:  Hold'em No Limit ($3/$6 USD) - 2013/08/11 6:38:38 ET
Table 'Dnoces II 40-100 bb' 6-max Seat #4 is the button
Seat 1: ZarubaNT ($1120.77 in chips) 
Seat 2: GERAKLmeat ($240 in chips) 
Seat 4: vjxbkf ($1979.98 in chips) 
Seat 5: DuckinF0nk ($771.30 in chips) 
Seat 6: uripeleg ($680.52 in chips) 
DuckinF0nk: posts small blind $3
uripeleg: posts big blind $6
*** HOLE CARDS ***
ZarubaNT: folds 
GERAKLmeat: raises $6 to $12
vjxbkf: calls $12
DuckinF0nk: folds 
uripeleg: folds 
*** FLOP *** [3c Kd Jd]
GERAKLmeat: bets $16.07
vjxbkf: folds 
Uncalled bet ($16.07) returned to GERAKLmeat
GERAKLmeat collected $31.52 from pot
GERAKLmeat: doesn't show hand 
*** SUMMARY ***
Total pot $33 | Rake $1.48 
Board [3c Kd Jd]
Seat 1: ZarubaNT folded before Flop (didn't bet)
Seat 2: GERAKLmeat collected ($31.52)
Seat 4: vjxbkf (button) folded on the Flop
Seat 5: DuckinF0nk (small blind) folded before Flop
Seat 6: uripeleg (big blind) folded before Flop


PokerStars Game #102599014677:  Hold'em No Limit ($3/$6 USD) - 2013/08/11 6:39:32 ET
Table 'Dnoces II 40-100 bb' 6-max Seat #5 is the button
Seat 2: GERAKLmeat ($259.52 in chips) 
Seat 4: vjxbkf ($1967.98 in chips) 
Seat 5: DuckinF0nk ($768.30 in chips) 
Seat 6: uripeleg ($674.52 in chips) 
uripeleg: posts small blind $3
ZarubaNT: is sitting out 
GERAKLmeat: posts big blind $6
*** HOLE CARDS ***
vjxbkf: raises $12 to $18
khk24 joins the table at seat #3 
DuckinF0nk: folds 
ZarubaNT leaves the table
$-Twackle-$ joins the table at seat #1 
uripeleg: folds 
GERAKLmeat: folds 
Uncalled bet ($12) returned to vjxbkf
vjxbkf collected $15 from pot
vjxbkf: doesn't show hand 
*** SUMMARY ***
Total pot $15 | Rake $0 
Seat 2: GERAKLmeat (big blind) folded before Flop
Seat 4: vjxbkf collected ($15)
Seat 5: DuckinF0nk (button) folded before Flop (didn't bet)
Seat 6: uripeleg (small blind) folded before Flop


PokerStars Game #102598767371:  Hold'em No Limit ($3/$6 USD) - 2013/08/11 6:30:00 ET
Table 'Dnoces II 40-100 bb' 6-max Seat #2 is the button
Seat 1: ZarubaNT ($1083.50 in chips) 
Seat 2: ChowYuenFatt ($236.38 in chips) 
Seat 3: Hristo008 ($579 in chips) 
Seat 4: vjxbkf ($1708.90 in chips) 
Seat 6: uripeleg ($633.48 in chips) 
Hristo008: posts small blind $3
vjxbkf: posts big blind $6
*** HOLE CARDS ***
uripeleg: folds 
ZarubaNT: folds 
ChowYuenFatt: raises $9 to $15
Hristo008: calls $12
vjxbkf: calls $9
*** FLOP *** [4c 3c 2d]
Hristo008: checks 
vjxbkf: bets $27
ChowYuenFatt: calls $27
Hristo008: calls $27
*** TURN *** [4c 3c 2d] [Js]
Hristo008: checks 
vjxbkf: bets $54
ChowYuenFatt: folds 
Hristo008: folds 
Uncalled bet ($54) returned to vjxbkf
vjxbkf collected $123.20 from pot
vjxbkf: doesn't show hand 
*** SUMMARY ***
Total pot $126 | Rake $2.80 
Board [4c 3c 2d Js]
Seat 1: ZarubaNT folded before Flop (didn't bet)
Seat 2: ChowYuenFatt (button) folded on the Turn
Seat 3: Hristo008 (small blind) folded on the Turn
Seat 4: vjxbkf (big blind) collected ($123.20)
Seat 6: uripeleg folded before Flop (didn't bet)


PokerStars Game #102598811312:  Hold'em No Limit ($3/$6 USD) - 2013/08/11 6:31:42 ET
Table 'Dnoces II 40-100 bb' 6-max Seat #3 is the button
Seat 1: ZarubaNT ($1083.50 in chips) 
Seat 2: ChowYuenFatt ($194.38 in chips) 
Seat 3: Hristo008 ($537 in chips) 
Seat 4: vjxbkf ($1790.10 in chips) 
Seat 6: uripeleg ($633.48 in chips) 
vjxbkf: posts small blind $3
uripeleg: posts big blind $6
*** HOLE CARDS ***
ZarubaNT: folds 
ChowYuenFatt: raises $9 to $15
Hristo008: folds 
vjxbkf: folds 
uripeleg: folds 
Uncalled bet ($9) returned to ChowYuenFatt
ChowYuenFatt collected $15 from pot
ChowYuenFatt: doesn't show hand 
*** SUMMARY ***
Total pot $15 | Rake $0 
Seat 1: ZarubaNT folded before Flop (didn't bet)
Seat 2: ChowYuenFatt collected ($15)
Seat 3: Hristo008 (button) folded before Flop (didn't bet)
Seat 4: vjxbkf (small blind) folded before Flop
Seat 6: uripeleg (big blind) folded before Flop


PokerStars Game #102598819047:  Hold'em No Limit ($3/$6 USD) - 2013/08/11 6:32:00 ET
Table 'Dnoces II 40-100 bb' 6-max Seat #4 is the button
Seat 1: ZarubaNT ($1083.50 in chips) 
Seat 2: ChowYuenFatt ($203.38 in chips) 
Seat 3: Hristo008 ($537 in chips) 
Seat 4: vjxbkf ($1787.10 in chips) 
Seat 6: uripeleg ($627.48 in chips) 
uripeleg: posts small blind $3
ZarubaNT: posts big blind $6
*** HOLE CARDS ***
ChowYuenFatt: folds 
Hristo008: folds 
vjxbkf: folds 
uripeleg: raises $12 to $18
ZarubaNT: folds 
Uncalled bet ($12) returned to uripeleg
uripeleg collected $12 from pot
*** SUMMARY ***
Total pot $12 | Rake $0 
Seat 1: ZarubaNT (big blind) folded before Flop
Seat 2: ChowYuenFatt folded before Flop (didn't bet)
Seat 3: Hristo008 folded before Flop (didn't bet)
Seat 4: vjxbkf (button) folded before Flop (didn't bet)
Seat 6: uripeleg (small blind) collected ($12)


PokerStars Game #102598830636:  Hold'em No Limit ($3/$6 USD) - 2013/08/11 6:32:27 ET
Table 'Dnoces II 40-100 bb' 6-max Seat #6 is the button
Seat 1: ZarubaNT ($1077.50 in chips) 
Seat 2: ChowYuenFatt ($203.38 in chips) 
Seat 3: Hristo008 ($537 in chips) 
Seat 4: vjxbkf ($1787.10 in chips) 
Seat 6: uripeleg ($633.48 in chips) 
ZarubaNT: posts small blind $3
ChowYuenFatt: posts big blind $6
*** HOLE CARDS ***
Hristo008: raises $6 to $12
vjxbkf: folds 
uripeleg: folds 
ZarubaNT: folds 
ChowYuenFatt: calls $6
*** FLOP *** [6d 9c 9s]
ChowYuenFatt: checks 
Hristo008: checks 
*** TURN *** [6d 9c 9s] [Ts]
ChowYuenFatt: checks 
Hristo008: bets $18
ChowYuenFatt: folds 
Uncalled bet ($18) returned to Hristo008
Hristo008 collected $25.78 from pot
*** SUMMARY ***
Total pot $27 | Rake $1.22 
Board [6d 9c 9s Ts]
Seat 1: ZarubaNT (small blind) folded before Flop
Seat 2: ChowYuenFatt (big blind) folded on the Turn
Seat 3: Hristo008 collected ($25.78)
Seat 4: vjxbkf folded before Flop (didn't bet)
Seat 6: uripeleg (button) folded before Flop (didn't bet)


PokerStars Game #102598852854:  Hold'em No Limit ($3/$6 USD) - 2013/08/11 6:33:18 ET
Table 'Dnoces II 40-100 bb' 6-max Seat #1 is the button
Seat 1: ZarubaNT ($1074.50 in chips) 
Seat 2: ChowYuenFatt ($191.38 in chips) 
Seat 4: vjxbkf ($1787.10 in chips) 
Seat 6: uripeleg ($633.48 in chips) 
ChowYuenFatt: posts small blind $3
Hristo008: is sitting out 
vjxbkf: posts big blind $6
*** HOLE CARDS ***
uripeleg: raises $6 to $12
ZarubaNT: folds 
ChowYuenFatt: calls $9
vjxbkf: raises $33 to $45
uripeleg: folds 
ChowYuenFatt: calls $33
*** FLOP *** [Th 9d 7c]
ChowYuenFatt: checks 
vjxbkf: checks 
*** TURN *** [Th 9d 7c] [Ac]
ChowYuenFatt: bets $146.38 and is all-in
vjxbkf: calls $146.38
*** RIVER *** [Th 9d 7c Ac] [3h]
*** SHOW DOWN ***
ChowYuenFatt: shows [7d 8d] (a pair of Sevens)
vjxbkf: shows [As Jd] (a pair of Aces)
vjxbkf collected $393.26 from pot
*** SUMMARY ***
Total pot $394.76 | Rake $1.50 
Board [Th 9d 7c Ac 3h]
Seat 1: ZarubaNT (button) folded before Flop (didn't bet)
Seat 2: ChowYuenFatt (small blind) showed [7d 8d] and lost with a pair of Sevens
Seat 4: vjxbkf (big blind) showed [As Jd] and won ($393.26) with a pair of Aces
Seat 6: uripeleg folded before Flop


PokerStars Game #102598893514:  Hold'em No Limit ($3/$6 USD) - 2013/08/11 6:34:53 ET
Table 'Dnoces II 40-100 bb' 6-max Seat #4 is the button
Seat 1: ZarubaNT ($1074.50 in chips) 
Seat 4: vjxbkf ($1988.98 in chips) 
Seat 6: uripeleg ($621.48 in chips) 
DuckinF0nk will be allowed to play after the button
uripeleg: posts small blind $3
ZarubaNT: posts big blind $6
*** HOLE CARDS ***
ChowYuenFatt leaves the table
vjxbkf: folds 
GERAKLmeat joins the table at seat #2 
uripeleg: raises $12 to $18
ZarubaNT: folds 
Uncalled bet ($12) returned to uripeleg
uripeleg collected $12 from pot
*** SUMMARY ***
Total pot $12 | Rake $0 
Seat 1: ZarubaNT (big blind) folded before Flop
Seat 4: vjxbkf (button) folded before Flop (didn't bet)
Seat 6: uripeleg (small blind) collected ($12)


PokerStars Game #102599317349:  Hold'em No Limit ($3/$6 USD) - 2013/08/11 6:50:43 ET
Table 'Dnoces II 40-100 bb' 6-max Seat #2 is the button
Seat 1: Mekcsiken ($615.15 in chips) 
Seat 2: GERAKLmeat ($538.30 in chips) 
Seat 3: khk24 ($613.50 in chips) 
Seat 6: uripeleg ($770.72 in chips) 
khk24: posts small blind $3
vjxbkf: is sitting out 
uripeleg: posts big blind $6
*** HOLE CARDS ***
Mekcsiken: folds 
GERAKLmeat: raises $6 to $12
khk24: folds 
uripeleg: calls $6
*** FLOP *** [Ac 2c Jc]
vjxbkf leaves the table
uripeleg: checks 
GERAKLmeat: bets $13.14
uripeleg: calls $13.14
*** TURN *** [Ac 2c Jc] [6s]
uripeleg: checks 
badrealwOw joins the table at seat #4 
GERAKLmeat: bets $26.40
uripeleg: folds 
Uncalled bet ($26.40) returned to GERAKLmeat
GERAKLmeat collected $51.78 from pot
GERAKLmeat: doesn't show hand 
*** SUMMARY ***
Total pot $53.28 | Rake $1.50 
Board [Ac 2c Jc 6s]
Seat 1: Mekcsiken folded before Flop (didn't bet)
Seat 2: GERAKLmeat (button) collected ($51.78)
Seat 3: khk24 (small blind) folded before Flop
Seat 6: uripeleg (big blind) folded on the Turn


PokerStars Game #102599336691:  Hold'em No Limit ($3/$6 USD) - 2013/08/11 6:51:26 ET
Table 'Dnoces II 40-100 bb' 6-max Seat #3 is the button
Seat 1: Mekcsiken ($615.15 in chips) 
Seat 2: GERAKLmeat ($564.94 in chips) 
Seat 3: khk24 ($610.50 in chips) 
Seat 6: uripeleg ($745.58 in chips) 
badrealwOw will be allowed to play after the button
uripeleg: posts small blind $3
Mekcsiken: posts big blind $6
*** HOLE CARDS ***
GERAKLmeat: folds 
khk24: raises $6 to $12
uripeleg: folds 
Mekcsiken: calls $6
*** FLOP *** [2h 7d 6h]
Mekcsiken: checks 
khk24: checks 
*** TURN *** [2h 7d 6h] [Kc]
Mekcsiken: bets $17
khk24: folds 
Uncalled bet ($17) returned to Mekcsiken
Mekcsiken collected $25.78 from pot
*** SUMMARY ***
Total pot $27 | Rake $1.22 
Board [2h 7d 6h Kc]
Seat 1: Mekcsiken (big blind) collected ($25.78)
Seat 2: GERAKLmeat folded before Flop (didn't bet)
Seat 3: khk24 (button) folded on the Turn
Seat 6: uripeleg (small blind) folded before Flop


PokerStars Game #102599356028:  Hold'em No Limit ($3/$6 USD) - 2013/08/11 6:52:09 ET
Table 'Dnoces II 40-100 bb' 6-max Seat #6 is the button
Seat 1: Mekcsiken ($628.93 in chips) 
Seat 2: GERAKLmeat ($564.94 in chips) 
Seat 3: khk24 ($600 in chips) 
Seat 6: uripeleg ($742.58 in chips) 
Mekcsiken: posts small blind $3
GERAKLmeat: posts big blind $6
badrealwOw: sits out 
*** HOLE CARDS ***
khk24: folds 
uripeleg: folds 
Mekcsiken: folds 
Uncalled bet ($3) returned to GERAKLmeat
GERAKLmeat collected $6 from pot
GERAKLmeat: doesn't show hand 
*** SUMMARY ***
Total pot $6 | Rake $0 
Seat 1: Mekcsiken (small blind) folded before Flop
Seat 2: GERAKLmeat (big blind) collected ($6)
Seat 3: khk24 folded before Flop (didn't bet)
Seat 6: uripeleg (button) folded before Flop (didn't bet)


PokerStars Game #102599363562:  Hold'em No Limit ($3/$6 USD) - 2013/08/11 6:52:25 ET
Table 'Dnoces II 40-100 bb' 6-max Seat #1 is the button
Seat 1: Mekcsiken ($625.93 in chips) 
Seat 2: GERAKLmeat ($567.94 in chips) 
Seat 3: khk24 ($600 in chips) 
Seat 6: uripeleg ($742.58 in chips) 
GERAKLmeat: posts small blind $3
khk24: posts big blind $6
badrealwOw: sits out 
*** HOLE CARDS ***
uripeleg: raises $7.50 to $13.50
Mekcsiken: folds 
GERAKLmeat: folds 
khk24: folds 
Uncalled bet ($7.50) returned to uripeleg
uripeleg collected $15 from pot
*** SUMMARY ***
Total pot $15 | Rake $0 
Seat 1: Mekcsiken (button) folded before Flop (didn't bet)
Seat 2: GERAKLmeat (small blind) folded before Flop
Seat 3: khk24 (big blind) folded before Flop
Seat 6: uripeleg collected ($15)


PokerStars Game #102599376499:  Hold'em No Limit ($3/$6 USD) - 2013/08/11 6:52:54 ET
Table 'Dnoces II 40-100 bb' 6-max Seat #2 is the button
Seat 1: Mekcsiken ($625.93 in chips) 
Seat 2: GERAKLmeat ($564.94 in chips) 
Seat 3: khk24 ($600 in chips) 
Seat 4: badrealwOw ($600 in chips) 
Seat 6: uripeleg ($751.58 in chips) 
khk24: posts small blind $3
badrealwOw: posts big blind $6
*** HOLE CARDS ***
uripeleg: folds 
Mekcsiken: folds 
GERAKLmeat: raises $6 to $12
khk24: folds 
badrealwOw: folds 
Uncalled bet ($6) returned to GERAKLmeat
GERAKLmeat collected $15 from pot
GERAKLmeat: doesn't show hand 
*** SUMMARY ***
Total pot $15 | Rake $0 
Seat 1: Mekcsiken folded before Flop (didn't bet)
Seat 2: GERAKLmeat (button) collected ($15)
Seat 3: khk24 (small blind) folded before Flop
Seat 4: badrealwOw (big blind) folded before Flop
Seat 6: uripeleg folded before Flop (didn't bet)


PokerStars Game #102599387115:  Hold'em No Limit ($3/$6 USD) - 2013/08/11 6:53:17 ET
Table 'Dnoces II 40-100 bb' 6-max Seat #3 is the button
Seat 1: Mekcsiken ($625.93 in chips) 
Seat 2: GERAKLmeat ($573.94 in chips) 
Seat 3: khk24 ($600 in chips) 
Seat 4: badrealwOw ($600 in chips) 
Seat 6: uripeleg ($751.58 in chips) 
badrealwOw: posts small blind $3
uripeleg: posts big blind $6
*** HOLE CARDS ***
Mekcsiken: folds 
GERAKLmeat: folds 
khk24: raises $6 to $12
badrealwOw: folds 
uripeleg: folds 
Uncalled bet ($6) returned to khk24
khk24 collected $15 from pot
khk24: doesn't show hand 
*** SUMMARY ***
Total pot $15 | Rake $0 
Seat 1: Mekcsiken folded before Flop (didn't bet)
Seat 2: GERAKLmeat folded before Flop (didn't bet)
Seat 3: khk24 (button) collected ($15)
Seat 4: badrealwOw (small blind) folded before Flop
Seat 6: uripeleg (big blind) folded before Flop


PokerStars Game #102599396010:  Hold'em No Limit ($3/$6 USD) - 2013/08/11 6:53:37 ET
Table 'Dnoces II 40-100 bb' 6-max Seat #4 is the button
Seat 1: Mekcsiken ($625.93 in chips) 
Seat 2: GERAKLmeat ($573.94 in chips) 
Seat 3: khk24 ($609 in chips) 
Seat 4: badrealwOw ($600 in chips) 
Seat 6: uripeleg ($745.58 in chips) 
uripeleg: posts small blind $3
Mekcsiken: posts big blind $6
*** HOLE CARDS ***
GERAKLmeat: folds 
khk24: folds 
badrealwOw: raises $6 to $12
uripeleg: raises $36 to $48
Mekcsiken: folds 
badrealwOw: raises $60 to $108
uripeleg: raises $637.58 to $745.58 and is all-in
badrealwOw: folds 
Uncalled bet ($637.58) returned to uripeleg
uripeleg collected $222 from pot
*** SUMMARY ***
Total pot $222 | Rake $0 
Seat 1: Mekcsiken (big blind) folded before Flop
Seat 2: GERAKLmeat folded before Flop (didn't bet)
Seat 3: khk24 folded before Flop (didn't bet)
Seat 4: badrealwOw (button) folded before Flop
Seat 6: uripeleg (small blind) collected ($222)


PokerStars Game #102599420008:  Hold'em No Limit ($3/$6 USD) - 2013/08/11 6:54:30 ET
Table 'Dnoces II 40-100 bb' 6-max Seat #6 is the button
Seat 1: Mekcsiken ($619.93 in chips) 
Seat 2: GERAKLmeat ($573.94 in chips) 
Seat 3: khk24 ($609 in chips) 
Seat 4: badrealwOw ($600 in chips) 
Seat 6: uripeleg ($859.58 in chips) 
Mekcsiken: posts small blind $3
GERAKLmeat: posts big blind $6
*** HOLE CARDS ***
khk24: folds 
badrealwOw: raises $9 to $15
uripeleg: folds 
Mekcsiken: folds 
GERAKLmeat: folds 
Uncalled bet ($9) returned to badrealwOw
badrealwOw collected $15 from pot
badrealwOw: doesn't show hand 
*** SUMMARY ***
Total pot $15 | Rake $0 
Seat 1: Mekcsiken (small blind) folded before Flop
Seat 2: GERAKLmeat (big blind) folded before Flop
Seat 3: khk24 folded before Flop (didn't bet)
Seat 4: badrealwOw collected ($15)
Seat 6: uripeleg (button) folded before Flop (didn't bet)


PokerStars Game #102599430717:  Hold'em No Limit ($3/$6 USD) - 2013/08/11 6:54:53 ET
Table 'Dnoces II 40-100 bb' 6-max Seat #1 is the button
Seat 1: Mekcsiken ($616.93 in chips) 
Seat 2: GERAKLmeat ($567.94 in chips) 
Seat 3: khk24 ($609 in chips) 
Seat 4: badrealwOw ($609 in chips) 
Seat 6: uripeleg ($859.58 in chips) 
GERAKLmeat: posts small blind $3
khk24: posts big blind $6
*** HOLE CARDS ***
badrealwOw: folds 
uripeleg: raises $7.50 to $13.50
Mekcsiken: folds 
GERAKLmeat: folds 
khk24: raises $40.50 to $54
uripeleg: calls $40.50
*** FLOP *** [5c 5d 6d]
khk24: bets $54
uripeleg: folds 
Uncalled bet ($54) returned to khk24
khk24 collected $108.20 from pot
khk24: doesn't show hand 
*** SUMMARY ***
Total pot $111 | Rake $2.80 
Board [5c 5d 6d]
Seat 1: Mekcsiken (button) folded before Flop (didn't bet)
Seat 2: GERAKLmeat (small blind) folded before Flop
Seat 3: khk24 (big blind) collected ($108.20)
Seat 4: badrealwOw folded before Flop (didn't bet)
Seat 6: uripeleg folded on the Flop


PokerStars Game #102599195284:  Hold'em No Limit ($3/$6 USD) - 2013/08/11 6:46:14 ET
Table 'Dnoces II 40-100 bb' 6-max Seat #5 is the button
Seat 1: Mekcsiken ($600 in chips) 
Seat 2: GERAKLmeat ($547.30 in chips) 
Seat 3: khk24 ($600.32 in chips) 
Seat 4: vjxbkf ($1676.43 in chips) 
Seat 5: Hristo008 ($550.78 in chips) 
Seat 6: uripeleg ($719.52 in chips) 
uripeleg: posts small blind $3
Mekcsiken: posts big blind $6
*** HOLE CARDS ***
GERAKLmeat: folds 
khk24: raises $12 to $18
vjxbkf: folds 
Hristo008: folds 
uripeleg: calls $15
Mekcsiken: folds 
*** FLOP *** [7s 6c 7h]
uripeleg: checks 
khk24: bets $30
uripeleg: calls $30
*** TURN *** [7s 6c 7h] [4d]
uripeleg: checks 
khk24: checks 
*** RIVER *** [7s 6c 7h 4d] [2s]
uripeleg: bets $60
khk24: folds 
Uncalled bet ($60) returned to uripeleg
uripeleg collected $99.20 from pot
*** SUMMARY ***
Total pot $102 | Rake $2.80 
Board [7s 6c 7h 4d 2s]
Seat 1: Mekcsiken (big blind) folded before Flop
Seat 2: GERAKLmeat folded before Flop (didn't bet)
Seat 3: khk24 folded on the River
Seat 4: vjxbkf folded before Flop (didn't bet)
Seat 5: Hristo008 (button) folded before Flop (didn't bet)
Seat 6: uripeleg (small blind) collected ($99.20)


PokerStars Game #102599231417:  Hold'em No Limit ($3/$6 USD) - 2013/08/11 6:47:33 ET
Table 'Dnoces II 40-100 bb' 6-max Seat #6 is the button
Seat 1: Mekcsiken ($600 in chips) 
Seat 2: GERAKLmeat ($547.30 in chips) 
Seat 3: khk24 ($600 in chips) 
Seat 4: vjxbkf ($1676.43 in chips) 
Seat 5: Hristo008 ($550.78 in chips) 
Seat 6: uripeleg ($770.72 in chips) 
Mekcsiken: posts small blind $3
GERAKLmeat: posts big blind $6
*** HOLE CARDS ***
khk24: folds 
vjxbkf: raises $12 to $18
Hristo008: folds 
uripeleg: folds 
Mekcsiken: folds 
GERAKLmeat: folds 
Uncalled bet ($12) returned to vjxbkf
vjxbkf collected $15 from pot
vjxbkf: doesn't show hand 
*** SUMMARY ***
Total pot $15 | Rake $0 
Seat 1: Mekcsiken (small blind) folded before Flop
Seat 2: GERAKLmeat (big blind) folded before Flop
Seat 3: khk24 folded before Flop (didn't bet)
Seat 4: vjxbkf collected ($15)
Seat 5: Hristo008 folded before Flop (didn't bet)
Seat 6: uripeleg (button) folded before Flop (didn't bet)


PokerStars Game #102599240790:  Hold'em No Limit ($3/$6 USD) - 2013/08/11 6:47:54 ET
Table 'Dnoces II 40-100 bb' 6-max Seat #1 is the button
Seat 1: Mekcsiken ($600 in chips) 
Seat 2: GERAKLmeat ($541.30 in chips) 
Seat 3: khk24 ($600 in chips) 
Seat 4: vjxbkf ($1685.43 in chips) 
Seat 5: Hristo008 ($550.78 in chips) 
Seat 6: uripeleg ($770.72 in chips) 
GERAKLmeat: posts small blind $3
khk24: posts big blind $6
*** HOLE CARDS ***
vjxbkf: raises $15 to $21
Hristo008: folds 
uripeleg: folds 
Mekcsiken: folds 
GERAKLmeat: folds 
khk24: folds 
Uncalled bet ($15) returned to vjxbkf
vjxbkf collected $15 from pot
vjxbkf: doesn't show hand 
*** SUMMARY ***
Total pot $15 | Rake $0 
Seat 1: Mekcsiken (button) folded before Flop (didn't bet)
Seat 2: GERAKLmeat (small blind) folded before Flop
Seat 3: khk24 (big blind) folded before Flop
Seat 4: vjxbkf collected ($15)
Seat 5: Hristo008 folded before Flop (didn't bet)
Seat 6: uripeleg folded before Flop (didn't bet)


PokerStars Game #102599247682:  Hold'em No Limit ($3/$6 USD) - 2013/08/11 6:48:09 ET
Table 'Dnoces II 40-100 bb' 6-max Seat #2 is the button
Seat 1: Mekcsiken ($600 in chips) 
Seat 2: GERAKLmeat ($538.30 in chips) 
Seat 3: khk24 ($600 in chips) 
Seat 4: vjxbkf ($1694.43 in chips) 
Seat 5: Hristo008 ($550.78 in chips) 
Seat 6: uripeleg ($770.72 in chips) 
khk24: posts small blind $3
vjxbkf: posts big blind $6
*** HOLE CARDS ***
Hristo008: folds 
uripeleg: folds 
Mekcsiken: folds 
GERAKLmeat: raises $6 to $12
khk24: raises $36 to $48
vjxbkf: folds 
GERAKLmeat: folds 
Uncalled bet ($36) returned to khk24
khk24 collected $30 from pot
khk24: doesn't show hand 
*** SUMMARY ***
Total pot $30 | Rake $0 
Seat 1: Mekcsiken folded before Flop (didn't bet)
Seat 2: GERAKLmeat (button) folded before Flop
Seat 3: khk24 (small blind) collected ($30)
Seat 4: vjxbkf (big blind) folded before Flop
Seat 5: Hristo008 folded before Flop (didn't bet)
Seat 6: uripeleg folded before Flop (didn't bet)


PokerStars Game #102599264395:  Hold'em No Limit ($3/$6 USD) - 2013/08/11 6:48:46 ET
Table 'Dnoces II 40-100 bb' 6-max Seat #3 is the button
Seat 1: Mekcsiken ($600 in chips) 
Seat 2: GERAKLmeat ($526.30 in chips) 
Seat 3: khk24 ($618 in chips) 
Seat 4: vjxbkf ($1688.43 in chips) 
Seat 6: uripeleg ($770.72 in chips) 
vjxbkf: posts small blind $3
Hristo008: is sitting out 
uripeleg: posts big blind $6
*** HOLE CARDS ***
Mekcsiken: folds 
GERAKLmeat: folds 
khk24: folds 
vjxbkf: folds 
Uncalled bet ($3) returned to uripeleg
uripeleg collected $6 from pot
*** SUMMARY ***
Total pot $6 | Rake $0 
Seat 1: Mekcsiken folded before Flop (didn't bet)
Seat 2: GERAKLmeat folded before Flop (didn't bet)
Seat 3: khk24 (button) folded before Flop (didn't bet)
Seat 4: vjxbkf (small blind) folded before Flop
Seat 6: uripeleg (big blind) collected ($6)


PokerStars Game #102599269026:  Hold'em No Limit ($3/$6 USD) - 2013/08/11 6:48:56 ET
Table 'Dnoces II 40-100 bb' 6-max Seat #4 is the button
Seat 1: Mekcsiken ($600 in chips) 
Seat 2: GERAKLmeat ($526.30 in chips) 
Seat 3: khk24 ($618 in chips) 
Seat 4: vjxbkf ($1685.43 in chips) 
Seat 6: uripeleg ($773.72 in chips) 
uripeleg: posts small blind $3
Mekcsiken: posts big blind $6
*** HOLE CARDS ***
GERAKLmeat: folds 
khk24: raises $9 to $15
vjxbkf: folds 
uripeleg: folds 
Mekcsiken: folds 
Uncalled bet ($9) returned to khk24
khk24 collected $15 from pot
khk24: doesn't show hand 
*** SUMMARY ***
Total pot $15 | Rake $0 
Seat 1: Mekcsiken (big blind) folded before Flop
Seat 2: GERAKLmeat folded before Flop (didn't bet)
Seat 3: khk24 collected ($15)
Seat 4: vjxbkf (button) folded before Flop (didn't bet)
Seat 6: uripeleg (small blind) folded before Flop


PokerStars Game #102599280866:  Hold'em No Limit ($3/$6 USD) - 2013/08/11 6:49:22 ET
Table 'Dnoces II 40-100 bb' 6-max Seat #6 is the button
Seat 1: Mekcsiken ($600 in chips) 
Seat 2: GERAKLmeat ($526.30 in chips) 
Seat 3: khk24 ($627 in chips) 
Seat 4: vjxbkf ($1685.43 in chips) 
Seat 6: uripeleg ($770.72 in chips) 
Mekcsiken: posts small blind $3
GERAKLmeat: posts big blind $6
*** HOLE CARDS ***
khk24: folds 
vjxbkf: folds 
uripeleg: folds 
Mekcsiken: raises $9 to $15
GERAKLmeat: raises $27 to $42
Mekcsiken: folds 
Uncalled bet ($27) returned to GERAKLmeat
GERAKLmeat collected $30 from pot
GERAKLmeat: doesn't show hand 
*** SUMMARY ***
Total pot $30 | Rake $0 
Seat 1: Mekcsiken (small blind) folded before Flop
Seat 2: GERAKLmeat (big blind) collected ($30)
Seat 3: khk24 folded before Flop (didn't bet)
Seat 4: vjxbkf folded before Flop (didn't bet)
Seat 6: uripeleg (button) folded before Flop (didn't bet)


PokerStars Game #102599296562:  Hold'em No Limit ($3/$6 USD) - 2013/08/11 6:49:57 ET
Table 'Dnoces II 40-100 bb' 6-max Seat #1 is the button
Seat 1: Mekcsiken ($600 in chips) 
Seat 2: GERAKLmeat ($541.30 in chips) 
Seat 3: khk24 ($627 in chips) 
Seat 4: vjxbkf ($1685.43 in chips) 
Seat 6: uripeleg ($770.72 in chips) 
GERAKLmeat: posts small blind $3
khk24: posts big blind $6
*** HOLE CARDS ***
vjxbkf: folds 
uripeleg: folds 
Mekcsiken: raises $7.50 to $13.50
GERAKLmeat: folds 
khk24: calls $7.50
*** FLOP *** [5h 7h 8d]
khk24: checks 
Mekcsiken: checks 
*** TURN *** [5h 7h 8d] [Kd]
khk24: checks 
Mekcsiken: bets $20
khk24: folds 
Uncalled bet ($20) returned to Mekcsiken
Mekcsiken collected $28.65 from pot
*** SUMMARY ***
Total pot $30 | Rake $1.35 
Board [5h 7h 8d Kd]
Seat 1: Mekcsiken (button) collected ($28.65)
Seat 2: GERAKLmeat (small blind) folded before Flop
Seat 3: khk24 (big blind) folded on the Turn
Seat 4: vjxbkf folded before Flop (didn't bet)
Seat 6: uripeleg folded before Flop (didn't bet)


PokerStars Game #102599546288:  Hold'em No Limit ($3/$6 USD) - 2013/08/11 7:00:19 ET
Table 'Dnoces II 40-100 bb' 6-max Seat #3 is the button
Seat 2: GERAKLmeat ($435.94 in chips) 
Seat 3: khk24 ($741.40 in chips) 
Seat 6: uripeleg ($913.78 in chips) 
uripeleg: posts small blind $3
Mekcsiken: is sitting out 
GERAKLmeat: posts big blind $6
*** HOLE CARDS ***
khk24: raises $6 to $12
Mekcsiken leaves the table
uripeleg: folds 
GERAKLmeat: calls $6
*** FLOP *** [5d 2h Jc]
GERAKLmeat: checks 
khk24: bets $18
GERAKLmeat: raises $24 to $42
khk24: calls $24
*** TURN *** [5d 2h Jc] [9s]
GERAKLmeat: checks 
khk24: checks 
*** RIVER *** [5d 2h Jc 9s] [8d]
GERAKLmeat: bets $80
khk24: folds 
Uncalled bet ($80) returned to GERAKLmeat
GERAKLmeat collected $109.50 from pot
GERAKLmeat: doesn't show hand 
*** SUMMARY ***
Total pot $111 | Rake $1.50 
Board [5d 2h Jc 9s 8d]
Seat 2: GERAKLmeat (big blind) collected ($109.50)
Seat 3: khk24 (button) folded on the River
Seat 6: uripeleg (small blind) folded before Flop


PokerStars Game #102599571972:  Hold'em No Limit ($3/$6 USD) - 2013/08/11 7:01:24 ET
Table 'Dnoces II 40-100 bb' 6-max Seat #6 is the button
Seat 2: GERAKLmeat ($491.44 in chips) 
Seat 3: khk24 ($687.40 in chips) 
Seat 6: uripeleg ($910.78 in chips) 
GERAKLmeat: posts small blind $3
khk24: posts big blind $6
*** HOLE CARDS ***
uripeleg: folds 
uripeleg leaves the table
GERAKLmeat: raises $6 to $12
khk24: raises $30 to $42
GERAKLmeat: folds 
Uncalled bet ($30) returned to khk24
khk24 collected $24 from pot
khk24: doesn't show hand 
*** SUMMARY ***
Total pot $24 | Rake $0 
Seat 2: GERAKLmeat (small blind) folded before Flop
Seat 3: khk24 (big blind) collected ($24)
Seat 6: uripeleg (button) folded before Flop (didn't bet)


PokerStars Game #102599449398:  Hold'em No Limit ($3/$6 USD) - 2013/08/11 6:55:44 ET
Table 'Dnoces II 40-100 bb' 6-max Seat #2 is the button
Seat 1: Mekcsiken ($616.93 in chips) 
Seat 2: GERAKLmeat ($564.94 in chips) 
Seat 3: khk24 ($663.20 in chips) 
Seat 4: badrealwOw ($609 in chips) 
Seat 6: uripeleg ($805.58 in chips) 
khk24: posts small blind $3
badrealwOw: posts big blind $6
*** HOLE CARDS ***
uripeleg: folds 
Mekcsiken: folds 
GERAKLmeat: raises $6 to $12
khk24: raises $36 to $48
badrealwOw: folds 
GERAKLmeat: folds 
Uncalled bet ($36) returned to khk24
khk24 collected $30 from pot
khk24: doesn't show hand 
*** SUMMARY ***
Total pot $30 | Rake $0 
Seat 1: Mekcsiken folded before Flop (didn't bet)
Seat 2: GERAKLmeat (button) folded before Flop
Seat 3: khk24 (small blind) collected ($30)
Seat 4: badrealwOw (big blind) folded before Flop
Seat 6: uripeleg folded before Flop (didn't bet)


PokerStars Game #102599465421:  Hold'em No Limit ($3/$6 USD) - 2013/08/11 6:56:30 ET
Table 'Dnoces II 40-100 bb' 6-max Seat #3 is the button
Seat 1: Mekcsiken ($616.93 in chips) 
Seat 2: GERAKLmeat ($552.94 in chips) 
Seat 3: khk24 ($681.20 in chips) 
Seat 4: badrealwOw ($603 in chips) 
Seat 6: uripeleg ($805.58 in chips) 
badrealwOw: posts small blind $3
uripeleg: posts big blind $6
*** HOLE CARDS ***
Mekcsiken: folds 
GERAKLmeat: folds 
khk24: raises $6 to $12
badrealwOw: folds 
uripeleg: raises $34 to $46
khk24: folds 
Uncalled bet ($34) returned to uripeleg
uripeleg collected $27 from pot
*** SUMMARY ***
Total pot $27 | Rake $0 
Seat 1: Mekcsiken folded before Flop (didn't bet)
Seat 2: GERAKLmeat folded before Flop (didn't bet)
Seat 3: khk24 (button) folded before Flop
Seat 4: badrealwOw (small blind) folded before Flop
Seat 6: uripeleg (big blind) collected ($27)


PokerStars Game #102599471632:  Hold'em No Limit ($3/$6 USD) - 2013/08/11 6:56:47 ET
Table 'Dnoces II 40-100 bb' 6-max Seat #4 is the button
Seat 1: Mekcsiken ($616.93 in chips) 
Seat 2: GERAKLmeat ($552.94 in chips) 
Seat 3: khk24 ($669.20 in chips) 
Seat 4: badrealwOw ($600 in chips) 
Seat 6: uripeleg ($820.58 in chips) 
uripeleg: posts small blind $3
Mekcsiken: posts big blind $6
*** HOLE CARDS ***
GERAKLmeat: folds 
khk24: folds 
badrealwOw: folds 
uripeleg: folds 
Uncalled bet ($3) returned to Mekcsiken
Mekcsiken collected $6 from pot
*** SUMMARY ***
Total pot $6 | Rake $0 
Seat 1: Mekcsiken (big blind) collected ($6)
Seat 2: GERAKLmeat folded before Flop (didn't bet)
Seat 3: khk24 folded before Flop (didn't bet)
Seat 4: badrealwOw (button) folded before Flop (didn't bet)
Seat 6: uripeleg (small blind) folded before Flop


PokerStars Game #102599479456:  Hold'em No Limit ($3/$6 USD) - 2013/08/11 6:57:09 ET
Table 'Dnoces II 40-100 bb' 6-max Seat #6 is the button
Seat 1: Mekcsiken ($619.93 in chips) 
Seat 2: GERAKLmeat ($552.94 in chips) 
Seat 3: khk24 ($669.20 in chips) 
Seat 4: badrealwOw ($600 in chips) 
Seat 6: uripeleg ($817.58 in chips) 
Mekcsiken: posts small blind $3
GERAKLmeat: posts big blind $6
*** HOLE CARDS ***
khk24: folds 
badrealwOw: folds 
uripeleg: raises $6 to $12
Mekcsiken: folds 
GERAKLmeat: calls $6
*** FLOP *** [3c 6d 7s]
GERAKLmeat: bets $13.14
uripeleg: raises $25.86 to $39
GERAKLmeat: raises $51 to $90
uripeleg: calls $51
*** TURN *** [3c 6d 7s] [Qs]
GERAKLmeat: checks 
Hristo008 leaves the table
onez69 joins the table at seat #5 
uripeleg: bets $100
onez69 leaves the table
GERAKLmeat: folds 
Uncalled bet ($100) returned to uripeleg
uripeleg collected $204.20 from pot
*** SUMMARY ***
Total pot $207 | Rake $2.80 
Board [3c 6d 7s Qs]
Seat 1: Mekcsiken (small blind) folded before Flop
Seat 2: GERAKLmeat (big blind) folded on the Turn
Seat 3: khk24 folded before Flop (didn't bet)
Seat 4: badrealwOw folded before Flop (didn't bet)
Seat 6: uripeleg (button) collected ($204.20)


PokerStars Game #102599519362:  Hold'em No Limit ($3/$6 USD) - 2013/08/11 6:59:04 ET
Table 'Dnoces II 40-100 bb' 6-max Seat #1 is the button
Seat 1: Mekcsiken ($616.93 in chips) 
Seat 2: GERAKLmeat ($450.94 in chips) 
Seat 3: khk24 ($669.20 in chips) 
Seat 4: badrealwOw ($600 in chips) 
Seat 6: uripeleg ($919.78 in chips) 
GERAKLmeat: posts small blind $3
khk24: posts big blind $6
*** HOLE CARDS ***
badrealwOw: folds 
badrealwOw leaves the table
uripeleg: folds 
Mekcsiken: raises $9 to $15
GERAKLmeat: folds 
khk24: raises $39 to $54
Mekcsiken: calls $39
*** FLOP *** [As 9d Jh]
khk24: bets $54
Mekcsiken: folds 
Uncalled bet ($54) returned to khk24
khk24 collected $108.20 from pot
khk24: doesn't show hand 
*** SUMMARY ***
Total pot $111 | Rake $2.80 
Board [As 9d Jh]
Seat 1: Mekcsiken (button) folded on the Flop
Seat 2: GERAKLmeat (small blind) folded before Flop
Seat 3: khk24 (big blind) collected ($108.20)
Seat 4: badrealwOw folded before Flop (didn't bet)
Seat 6: uripeleg folded before Flop (didn't bet)


PokerStars Game #102599536690:  Hold'em No Limit ($3/$6 USD) - 2013/08/11 6:59:53 ET
Table 'Dnoces II 40-100 bb' 6-max Seat #2 is the button
Seat 1: Mekcsiken ($600 in chips) 
Seat 2: GERAKLmeat ($447.94 in chips) 
Seat 3: khk24 ($723.40 in chips) 
Seat 6: uripeleg ($919.78 in chips) 
khk24: posts small blind $3
uripeleg: posts big blind $6
*** HOLE CARDS ***
Mekcsiken: folds 
GERAKLmeat: raises $6 to $12
khk24: raises $36 to $48
uripeleg: folds 
GERAKLmeat: folds 
Uncalled bet ($36) returned to khk24
khk24 collected $30 from pot
khk24: doesn't show hand 
*** SUMMARY ***
Total pot $30 | Rake $0 
Seat 1: Mekcsiken folded before Flop (didn't bet)
Seat 2: GERAKLmeat (button) folded before Flop
Seat 3: khk24 (small blind) collected ($30)
Seat 6: uripeleg (big blind) folded before Flop
