

PokerStars Game #102608095391:  Hold'em No Limit ($3/$6 USD) - 2013/08/11 11:05:17 ET
Table 'Cydonia IX 40-100 bb' 6-max Seat #3 is the button
Seat 1: x_QUIXTAR_x ($362.48 in chips) 
Seat 2: ilir3 ($630.70 in chips) 
Seat 3: Y-Yx777 ($394 in chips) 
Seat 4: patapong ($627 in chips) 
Seat 5: shevliak ($240 in chips) 
Seat 6: zazano ($600 in chips) 
patapong: posts small blind $3
shevliak: posts big blind $6
*** HOLE CARDS ***
zazano: folds 
x_QUIXTAR_x: folds 
ilir3: raises $6 to $12
Y-Yx777: folds 
patapong: folds 
shevliak: folds 
Uncalled bet ($6) returned to ilir3
ilir3 collected $15 from pot
ilir3: doesn't show hand 
*** SUMMARY ***
Total pot $15 | Rake $0 
Seat 1: x_QUIXTAR_x folded before Flop (didn't bet)
Seat 2: ilir3 collected ($15)
Seat 3: Y-Yx777 (button) folded before Flop (didn't bet)
Seat 4: patapong (small blind) folded before Flop
Seat 5: shevliak (big blind) folded before Flop
Seat 6: zazano folded before Flop (didn't bet)


PokerStars Game #102608122321:  Hold'em No Limit ($3/$6 USD) - 2013/08/11 11:05:52 ET
Table 'Cydonia IX 40-100 bb' 6-max Seat #4 is the button
Seat 1: x_QUIXTAR_x ($362.48 in chips) 
Seat 2: ilir3 ($639.70 in chips) 
Seat 3: Y-Yx777 ($394 in chips) 
Seat 4: patapong ($624 in chips) 
Seat 5: shevliak ($240 in chips) 
Seat 6: zazano ($600 in chips) 
shevliak: posts small blind $3
zazano: posts big blind $6
*** HOLE CARDS ***
x_QUIXTAR_x: folds 
ilir3: raises $9 to $15
Y-Yx777: raises $33 to $48
patapong: folds 
shevliak: folds 
zazano: folds 
ilir3: folds 
Uncalled bet ($33) returned to Y-Yx777
Y-Yx777 collected $39 from pot
*** SUMMARY ***
Total pot $39 | Rake $0 
Seat 1: x_QUIXTAR_x folded before Flop (didn't bet)
Seat 2: ilir3 folded before Flop
Seat 3: Y-Yx777 collected ($39)
Seat 4: patapong (button) folded before Flop (didn't bet)
Seat 5: shevliak (small blind) folded before Flop
Seat 6: zazano (big blind) folded before Flop


PokerStars Game #102608170544:  Hold'em No Limit ($3/$6 USD) - 2013/08/11 11:06:55 ET
Table 'Cydonia IX 40-100 bb' 6-max Seat #5 is the button
Seat 1: x_QUIXTAR_x ($362.48 in chips) 
Seat 2: ilir3 ($624.70 in chips) 
Seat 3: Y-Yx777 ($418 in chips) 
Seat 4: patapong ($624 in chips) 
Seat 5: shevliak ($240 in chips) 
Seat 6: zazano ($600 in chips) 
zazano: posts small blind $3
x_QUIXTAR_x: posts big blind $6
*** HOLE CARDS ***
ilir3: folds 
Y-Yx777: folds 
patapong: folds 
shevliak: raises $6 to $12
zazano: folds 
x_QUIXTAR_x: folds 
Uncalled bet ($6) returned to shevliak
shevliak collected $15 from pot
shevliak: doesn't show hand 
*** SUMMARY ***
Total pot $15 | Rake $0 
Seat 1: x_QUIXTAR_x (big blind) folded before Flop
Seat 2: ilir3 folded before Flop (didn't bet)
Seat 3: Y-Yx777 folded before Flop (didn't bet)
Seat 4: patapong folded before Flop (didn't bet)
Seat 5: shevliak (button) collected ($15)
Seat 6: zazano (small blind) folded before Flop


PokerStars Game #102608195179:  Hold'em No Limit ($3/$6 USD) - 2013/08/11 11:07:27 ET
Table 'Cydonia IX 40-100 bb' 6-max Seat #6 is the button
Seat 1: x_QUIXTAR_x ($356.48 in chips) 
Seat 2: ilir3 ($624.70 in chips) 
Seat 3: Y-Yx777 ($418 in chips) 
Seat 4: patapong ($624 in chips) 
Seat 5: shevliak ($249 in chips) 
Seat 6: zazano ($600 in chips) 
x_QUIXTAR_x: posts small blind $3
ilir3: posts big blind $6
*** HOLE CARDS ***
Y-Yx777: raises $6 to $12
patapong: folds 
shevliak: calls $12
zazano: folds 
x_QUIXTAR_x: folds 
ilir3: folds 
*** FLOP *** [Kc Qd 4h]
Y-Yx777: bets $18
shevliak: calls $18
*** TURN *** [Kc Qd 4h] [3d]
Y-Yx777: bets $36
shevliak: calls $36
*** RIVER *** [Kc Qd 4h 3d] [5s]
Y-Yx777: checks 
shevliak: checks 
*** SHOW DOWN ***
Y-Yx777: shows [Qc Td] (a pair of Queens)
shevliak: mucks hand 
Y-Yx777 collected $138.20 from pot
*** SUMMARY ***
Total pot $141 | Rake $2.80 
Board [Kc Qd 4h 3d 5s]
Seat 1: x_QUIXTAR_x (small blind) folded before Flop
Seat 2: ilir3 (big blind) folded before Flop
Seat 3: Y-Yx777 showed [Qc Td] and won ($138.20) with a pair of Queens
Seat 4: patapong folded before Flop (didn't bet)
Seat 5: shevliak mucked
Seat 6: zazano (button) folded before Flop (didn't bet)


PokerStars Game #102608230822:  Hold'em No Limit ($3/$6 USD) - 2013/08/11 11:08:15 ET
Table 'Cydonia IX 40-100 bb' 6-max Seat #1 is the button
Seat 1: x_QUIXTAR_x ($353.48 in chips) 
Seat 2: ilir3 ($618.70 in chips) 
Seat 3: Y-Yx777 ($490.20 in chips) 
Seat 4: patapong ($624 in chips) 
Seat 5: shevliak ($240 in chips) 
Seat 6: zazano ($600 in chips) 
ilir3: posts small blind $3
Y-Yx777: posts big blind $6
*** HOLE CARDS ***
patapong: folds 
shevliak: folds 
zazano: raises $12 to $18
x_QUIXTAR_x: folds 
ilir3: raises $42 to $60
Y-Yx777: folds 
zazano: calls $42
*** FLOP *** [3d Qd 6c]
ilir3: bets $72
zazano: folds 
Uncalled bet ($72) returned to ilir3
ilir3 collected $123.20 from pot
ilir3: doesn't show hand 
*** SUMMARY ***
Total pot $126 | Rake $2.80 
Board [3d Qd 6c]
Seat 1: x_QUIXTAR_x (button) folded before Flop (didn't bet)
Seat 2: ilir3 (small blind) collected ($123.20)
Seat 3: Y-Yx777 (big blind) folded before Flop
Seat 4: patapong folded before Flop (didn't bet)
Seat 5: shevliak folded before Flop (didn't bet)
Seat 6: zazano folded on the Flop


PokerStars Game #102608286013:  Hold'em No Limit ($3/$6 USD) - 2013/08/11 11:09:28 ET
Table 'Cydonia IX 40-100 bb' 6-max Seat #2 is the button
Seat 1: x_QUIXTAR_x ($353.48 in chips) 
Seat 2: ilir3 ($681.90 in chips) 
Seat 3: Y-Yx777 ($484.20 in chips) 
Seat 4: patapong ($624 in chips) 
Seat 5: shevliak ($240 in chips) 
Seat 6: zazano ($600 in chips) 
Y-Yx777: posts small blind $3
patapong: posts big blind $6
*** HOLE CARDS ***
shevliak: folds 
zazano: raises $12 to $18
x_QUIXTAR_x: raises $17 to $35
ilir3: folds 
Y-Yx777: folds 
patapong: folds 
zazano: raises $43 to $78
x_QUIXTAR_x: folds 
Uncalled bet ($43) returned to zazano
zazano collected $79 from pot
zazano: doesn't show hand 
*** SUMMARY ***
Total pot $79 | Rake $0 
Seat 1: x_QUIXTAR_x folded before Flop
Seat 2: ilir3 (button) folded before Flop (didn't bet)
Seat 3: Y-Yx777 (small blind) folded before Flop
Seat 4: patapong (big blind) folded before Flop
Seat 5: shevliak folded before Flop (didn't bet)
Seat 6: zazano collected ($79)


PokerStars Game #102607888710:  Hold'em No Limit ($3/$6 USD) - 2013/08/11 11:00:46 ET
Table 'Cydonia IX 40-100 bb' 6-max Seat #1 is the button
Seat 1: x_QUIXTAR_x ($300 in chips) 
Seat 3: Y-Yx777 ($480 in chips) 
Seat 4: patapong ($600 in chips) 
Y-Yx777: posts small blind $3
patapong: posts big blind $6
*** HOLE CARDS ***
x_QUIXTAR_x: folds 
zazano joins the table at seat #6 
shevliak joins the table at seat #5 
Y-Yx777: raises $12 to $18
patapong: folds 
Uncalled bet ($12) returned to Y-Yx777
ilir3 joins the table at seat #2 
Y-Yx777 collected $12 from pot
*** SUMMARY ***
Total pot $12 | Rake $0 
Seat 1: x_QUIXTAR_x (button) folded before Flop (didn't bet)
Seat 3: Y-Yx777 (small blind) collected ($12)
Seat 4: patapong (big blind) folded before Flop


PokerStars Game #102607896845:  Hold'em No Limit ($3/$6 USD) - 2013/08/11 11:00:58 ET
Table 'Cydonia IX 40-100 bb' 6-max Seat #3 is the button
Seat 1: x_QUIXTAR_x ($300 in chips) 
Seat 3: Y-Yx777 ($486 in chips) 
Seat 4: patapong ($600 in chips) 
Seat 5: shevliak ($240 in chips) 
patapong: posts small blind $3
shevliak: posts big blind $6
zazano: sits out 
ilir3: sits out 
*** HOLE CARDS ***
x_QUIXTAR_x: raises $7.50 to $13.50
Y-Yx777: calls $13.50
patapong: raises $43.50 to $57
shevliak: folds 
x_QUIXTAR_x: folds 
Y-Yx777: folds 
Uncalled bet ($43.50) returned to patapong
patapong collected $46.50 from pot
*** SUMMARY ***
Total pot $46.50 | Rake $0 
Seat 1: x_QUIXTAR_x folded before Flop
Seat 3: Y-Yx777 (button) folded before Flop
Seat 4: patapong (small blind) collected ($46.50)
Seat 5: shevliak (big blind) folded before Flop


PokerStars Game #102607920618:  Hold'em No Limit ($3/$6 USD) - 2013/08/11 11:01:31 ET
Table 'Cydonia IX 40-100 bb' 6-max Seat #4 is the button
Seat 1: x_QUIXTAR_x ($300 in chips) 
Seat 3: Y-Yx777 ($472.50 in chips) 
Seat 4: patapong ($633 in chips) 
Seat 5: shevliak ($240 in chips) 
Seat 6: zazano ($600 in chips) 
shevliak: posts small blind $3
zazano: posts big blind $6
ilir3: sits out 
*** HOLE CARDS ***
x_QUIXTAR_x: folds 
Y-Yx777: folds 
patapong: folds 
shevliak: folds 
Uncalled bet ($3) returned to zazano
zazano collected $6 from pot
zazano: doesn't show hand 
*** SUMMARY ***
Total pot $6 | Rake $0 
Seat 1: x_QUIXTAR_x folded before Flop (didn't bet)
Seat 3: Y-Yx777 folded before Flop (didn't bet)
Seat 4: patapong (button) folded before Flop (didn't bet)
Seat 5: shevliak (small blind) folded before Flop
Seat 6: zazano (big blind) collected ($6)


PokerStars Game #102607930797:  Hold'em No Limit ($3/$6 USD) - 2013/08/11 11:01:44 ET
Table 'Cydonia IX 40-100 bb' 6-max Seat #5 is the button
Seat 1: x_QUIXTAR_x ($300 in chips) 
Seat 3: Y-Yx777 ($472.50 in chips) 
Seat 4: patapong ($633 in chips) 
Seat 5: shevliak ($240 in chips) 
Seat 6: zazano ($603 in chips) 
zazano: posts small blind $3
x_QUIXTAR_x: posts big blind $6
ilir3: sits out 
*** HOLE CARDS ***
Y-Yx777: folds 
patapong: folds 
shevliak: raises $6 to $12
zazano: folds 
x_QUIXTAR_x: calls $6
*** FLOP *** [7h 9h 2c]
x_QUIXTAR_x: checks 
shevliak: checks 
*** TURN *** [7h 9h 2c] [3d]
x_QUIXTAR_x: bets $18
shevliak: folds 
Uncalled bet ($18) returned to x_QUIXTAR_x
x_QUIXTAR_x collected $25.78 from pot
x_QUIXTAR_x: doesn't show hand 
*** SUMMARY ***
Total pot $27 | Rake $1.22 
Board [7h 9h 2c 3d]
Seat 1: x_QUIXTAR_x (big blind) collected ($25.78)
Seat 3: Y-Yx777 folded before Flop (didn't bet)
Seat 4: patapong folded before Flop (didn't bet)
Seat 5: shevliak (button) folded on the Turn
Seat 6: zazano (small blind) folded before Flop


PokerStars Game #102607981789:  Hold'em No Limit ($3/$6 USD) - 2013/08/11 11:02:51 ET
Table 'Cydonia IX 40-100 bb' 6-max Seat #6 is the button
Seat 1: x_QUIXTAR_x ($313.78 in chips) 
Seat 2: ilir3 ($600 in chips) 
Seat 3: Y-Yx777 ($472.50 in chips) 
Seat 4: patapong ($633 in chips) 
Seat 5: shevliak ($240 in chips) 
Seat 6: zazano ($600 in chips) 
x_QUIXTAR_x: posts small blind $3
ilir3: posts big blind $6
*** HOLE CARDS ***
Y-Yx777: raises $6 to $12
patapong: folds 
shevliak: folds 
zazano: folds 
x_QUIXTAR_x: folds 
ilir3: calls $6
*** FLOP *** [Kd Jd Kc]
ilir3: checks 
Y-Yx777: bets $12
ilir3: calls $12
*** TURN *** [Kd Jd Kc] [Qs]
ilir3: checks 
Y-Yx777: checks 
*** RIVER *** [Kd Jd Kc Qs] [Ac]
ilir3: bets $30
Y-Yx777: folds 
Uncalled bet ($30) returned to ilir3
ilir3 collected $48.70 from pot
ilir3: doesn't show hand 
*** SUMMARY ***
Total pot $51 | Rake $2.30 
Board [Kd Jd Kc Qs Ac]
Seat 1: x_QUIXTAR_x (small blind) folded before Flop
Seat 2: ilir3 (big blind) collected ($48.70)
Seat 3: Y-Yx777 folded on the River
Seat 4: patapong folded before Flop (didn't bet)
Seat 5: shevliak folded before Flop (didn't bet)
Seat 6: zazano (button) folded before Flop (didn't bet)


PokerStars Game #102608012784:  Hold'em No Limit ($3/$6 USD) - 2013/08/11 11:03:31 ET
Table 'Cydonia IX 40-100 bb' 6-max Seat #1 is the button
Seat 1: x_QUIXTAR_x ($310.78 in chips) 
Seat 2: ilir3 ($624.70 in chips) 
Seat 3: Y-Yx777 ($448.50 in chips) 
Seat 4: patapong ($633 in chips) 
Seat 5: shevliak ($240 in chips) 
Seat 6: zazano ($600 in chips) 
ilir3: posts small blind $3
Y-Yx777: posts big blind $6
*** HOLE CARDS ***
patapong: folds 
shevliak: folds 
zazano: folds 
x_QUIXTAR_x: raises $7.50 to $13.50
ilir3: folds 
Y-Yx777: calls $7.50
*** FLOP *** [8c Kh Tc]
Y-Yx777: checks 
x_QUIXTAR_x: bets $18
Y-Yx777: calls $18
*** TURN *** [8c Kh Tc] [Js]
Y-Yx777: checks 
x_QUIXTAR_x: bets $20
Y-Yx777: calls $20
*** RIVER *** [8c Kh Tc Js] [Kc]
Y-Yx777: checks 
x_QUIXTAR_x: bets $50
Y-Yx777: folds 
Uncalled bet ($50) returned to x_QUIXTAR_x
x_QUIXTAR_x collected $103.20 from pot
x_QUIXTAR_x: doesn't show hand 
*** SUMMARY ***
Total pot $106 | Rake $2.80 
Board [8c Kh Tc Js Kc]
Seat 1: x_QUIXTAR_x (button) collected ($103.20)
Seat 2: ilir3 (small blind) folded before Flop
Seat 3: Y-Yx777 (big blind) folded on the River
Seat 4: patapong folded before Flop (didn't bet)
Seat 5: shevliak folded before Flop (didn't bet)
Seat 6: zazano folded before Flop (didn't bet)


PokerStars Game #102608076015:  Hold'em No Limit ($3/$6 USD) - 2013/08/11 11:04:52 ET
Table 'Cydonia IX 40-100 bb' 6-max Seat #2 is the button
Seat 1: x_QUIXTAR_x ($362.48 in chips) 
Seat 2: ilir3 ($621.70 in chips) 
Seat 3: Y-Yx777 ($397 in chips) 
Seat 4: patapong ($633 in chips) 
Seat 5: shevliak ($240 in chips) 
Seat 6: zazano ($600 in chips) 
Y-Yx777: posts small blind $3
patapong: posts big blind $6
*** HOLE CARDS ***
shevliak: folds 
zazano: folds 
x_QUIXTAR_x: folds 
ilir3: raises $6 to $12
Y-Yx777: folds 
patapong: folds 
Uncalled bet ($6) returned to ilir3
ilir3 collected $15 from pot
*** SUMMARY ***
Total pot $15 | Rake $0 
Seat 1: x_QUIXTAR_x folded before Flop (didn't bet)
Seat 2: ilir3 (button) collected ($15)
Seat 3: Y-Yx777 (small blind) folded before Flop
Seat 4: patapong (big blind) folded before Flop
Seat 5: shevliak folded before Flop (didn't bet)
Seat 6: zazano folded before Flop (didn't bet)


PokerStars Game #102609207220:  Hold'em No Limit ($3/$6 USD) - 2013/08/11 11:30:53 ET
Table 'Cydonia IX 40-100 bb' 6-max Seat #3 is the button
Seat 1: x_QUIXTAR_x ($300 in chips) 
Seat 2: ilir3 ($689.86 in chips) 
Seat 3: Y-Yx777 ($629.11 in chips) 
Seat 4: patapong ($600 in chips) 
Seat 6: LuckyBiitch ($635 in chips) 
patapong: posts small blind $3
LuckyBiitch: posts big blind $6
*** HOLE CARDS ***
x_QUIXTAR_x: folds 
ilir3: folds 
Y-Yx777: folds 
patapong: raises $12 to $18
LuckyBiitch: calls $12
*** FLOP *** [4d 3c 6s]
patapong: bets $24.07
LuckyBiitch: folds 
Uncalled bet ($24.07) returned to patapong
patapong collected $34.38 from pot
*** SUMMARY ***
Total pot $36 | Rake $1.62 
Board [4d 3c 6s]
Seat 1: x_QUIXTAR_x folded before Flop (didn't bet)
Seat 2: ilir3 folded before Flop (didn't bet)
Seat 3: Y-Yx777 (button) folded before Flop (didn't bet)
Seat 4: patapong (small blind) collected ($34.38)
Seat 6: LuckyBiitch (big blind) folded on the Flop


PokerStars Game #102609235903:  Hold'em No Limit ($3/$6 USD) - 2013/08/11 11:31:33 ET
Table 'Cydonia IX 40-100 bb' 6-max Seat #4 is the button
Seat 1: x_QUIXTAR_x ($300 in chips) 
Seat 2: ilir3 ($689.86 in chips) 
Seat 3: Y-Yx777 ($629.11 in chips) 
Seat 4: patapong ($616.38 in chips) 
Seat 6: LuckyBiitch ($617 in chips) 
LuckyBiitch: posts small blind $3
x_QUIXTAR_x: posts big blind $6
*** HOLE CARDS ***
ilir3: folds 
Y-Yx777: folds 
patapong: raises $6 to $12
LuckyBiitch: folds 
x_QUIXTAR_x: folds 
Uncalled bet ($6) returned to patapong
patapong collected $15 from pot
*** SUMMARY ***
Total pot $15 | Rake $0 
Seat 1: x_QUIXTAR_x (big blind) folded before Flop
Seat 2: ilir3 folded before Flop (didn't bet)
Seat 3: Y-Yx777 folded before Flop (didn't bet)
Seat 4: patapong (button) collected ($15)
Seat 6: LuckyBiitch (small blind) folded before Flop


PokerStars Game #102609247710:  Hold'em No Limit ($3/$6 USD) - 2013/08/11 11:31:49 ET
Table 'Cydonia IX 40-100 bb' 6-max Seat #6 is the button
Seat 1: x_QUIXTAR_x ($300 in chips) 
Seat 2: ilir3 ($689.86 in chips) 
Seat 3: Y-Yx777 ($629.11 in chips) 
Seat 4: patapong ($625.38 in chips) 
Seat 6: LuckyBiitch ($614 in chips) 
x_QUIXTAR_x: posts small blind $3
ilir3: posts big blind $6
*** HOLE CARDS ***
Y-Yx777: folds 
patapong: raises $9 to $15
LuckyBiitch: folds 
x_QUIXTAR_x: folds 
ilir3: folds 
Uncalled bet ($9) returned to patapong
patapong collected $15 from pot
*** SUMMARY ***
Total pot $15 | Rake $0 
Seat 1: x_QUIXTAR_x (small blind) folded before Flop
Seat 2: ilir3 (big blind) folded before Flop
Seat 3: Y-Yx777 folded before Flop (didn't bet)
Seat 4: patapong collected ($15)
Seat 6: LuckyBiitch (button) folded before Flop (didn't bet)


PokerStars Game #102609271033:  Hold'em No Limit ($3/$6 USD) - 2013/08/11 11:32:22 ET
Table 'Cydonia IX 40-100 bb' 6-max Seat #1 is the button
Seat 1: x_QUIXTAR_x ($300 in chips) 
Seat 2: ilir3 ($683.86 in chips) 
Seat 3: Y-Yx777 ($629.11 in chips) 
Seat 4: patapong ($634.38 in chips) 
Seat 6: LuckyBiitch ($614 in chips) 
ilir3: posts small blind $3
Y-Yx777: posts big blind $6
*** HOLE CARDS ***
patapong: folds 
LuckyBiitch: folds 
x_QUIXTAR_x: folds 
ilir3: calls $3
Y-Yx777: raises $12 to $18
ilir3: folds 
Uncalled bet ($12) returned to Y-Yx777
Y-Yx777 collected $12 from pot
*** SUMMARY ***
Total pot $12 | Rake $0 
Seat 1: x_QUIXTAR_x (button) folded before Flop (didn't bet)
Seat 2: ilir3 (small blind) folded before Flop
Seat 3: Y-Yx777 (big blind) collected ($12)
Seat 4: patapong folded before Flop (didn't bet)
Seat 6: LuckyBiitch folded before Flop (didn't bet)


PokerStars Game #102609289044:  Hold'em No Limit ($3/$6 USD) - 2013/08/11 11:32:47 ET
Table 'Cydonia IX 40-100 bb' 6-max Seat #2 is the button
Seat 1: x_QUIXTAR_x ($300 in chips) 
Seat 2: ilir3 ($677.86 in chips) 
Seat 3: Y-Yx777 ($635.11 in chips) 
Seat 4: patapong ($634.38 in chips) 
Seat 6: LuckyBiitch ($614 in chips) 
Y-Yx777: posts small blind $3
patapong: posts big blind $6
*** HOLE CARDS ***
LuckyBiitch: folds 
x_QUIXTAR_x: folds 
ilir3: raises $6 to $12
Y-Yx777: raises $36 to $48
patapong: folds 
ilir3: folds 
Uncalled bet ($36) returned to Y-Yx777
Y-Yx777 collected $30 from pot
*** SUMMARY ***
Total pot $30 | Rake $0 
Seat 1: x_QUIXTAR_x folded before Flop (didn't bet)
Seat 2: ilir3 (button) folded before Flop
Seat 3: Y-Yx777 (small blind) collected ($30)
Seat 4: patapong (big blind) folded before Flop
Seat 6: LuckyBiitch folded before Flop (didn't bet)


PokerStars Game #102609313337:  Hold'em No Limit ($3/$6 USD) - 2013/08/11 11:33:21 ET
Table 'Cydonia IX 40-100 bb' 6-max Seat #3 is the button
Seat 1: x_QUIXTAR_x ($300 in chips) 
Seat 2: ilir3 ($665.86 in chips) 
Seat 3: Y-Yx777 ($653.11 in chips) 
Seat 4: patapong ($628.38 in chips) 
Seat 6: LuckyBiitch ($614 in chips) 
patapong: posts small blind $3
LuckyBiitch: posts big blind $6
*** HOLE CARDS ***
x_QUIXTAR_x: raises $7.50 to $13.50
ilir3: folds 
Y-Yx777: folds 
patapong: folds 
LuckyBiitch: raises $24.50 to $38
x_QUIXTAR_x: raises $52 to $90
LuckyBiitch: folds 
Uncalled bet ($52) returned to x_QUIXTAR_x
x_QUIXTAR_x collected $79 from pot
x_QUIXTAR_x: doesn't show hand 
*** SUMMARY ***
Total pot $79 | Rake $0 
Seat 1: x_QUIXTAR_x collected ($79)
Seat 2: ilir3 folded before Flop (didn't bet)
Seat 3: Y-Yx777 (button) folded before Flop (didn't bet)
Seat 4: patapong (small blind) folded before Flop
Seat 6: LuckyBiitch (big blind) folded before Flop


PokerStars Game #102609337005:  Hold'em No Limit ($3/$6 USD) - 2013/08/11 11:33:54 ET
Table 'Cydonia IX 40-100 bb' 6-max Seat #4 is the button
Seat 1: x_QUIXTAR_x ($341 in chips) 
Seat 2: ilir3 ($665.86 in chips) 
Seat 3: Y-Yx777 ($653.11 in chips) 
Seat 4: patapong ($625.38 in chips) 
Seat 6: LuckyBiitch ($600 in chips) 
LuckyBiitch: posts small blind $3
x_QUIXTAR_x: posts big blind $6
*** HOLE CARDS ***
ilir3: folds 
Y-Yx777: folds 
patapong: raises $6 to $12
LuckyBiitch: raises $33 to $45
x_QUIXTAR_x: folds 
patapong: folds 
Uncalled bet ($33) returned to LuckyBiitch
LuckyBiitch collected $30 from pot
LuckyBiitch: doesn't show hand 
*** SUMMARY ***
Total pot $30 | Rake $0 
Seat 1: x_QUIXTAR_x (big blind) folded before Flop
Seat 2: ilir3 folded before Flop (didn't bet)
Seat 3: Y-Yx777 folded before Flop (didn't bet)
Seat 4: patapong (button) folded before Flop
Seat 6: LuckyBiitch (small blind) collected ($30)


PokerStars Game #102609360642:  Hold'em No Limit ($3/$6 USD) - 2013/08/11 11:34:27 ET
Table 'Cydonia IX 40-100 bb' 6-max Seat #6 is the button
Seat 1: x_QUIXTAR_x ($335 in chips) 
Seat 2: ilir3 ($665.86 in chips) 
Seat 3: Y-Yx777 ($653.11 in chips) 
Seat 4: patapong ($613.38 in chips) 
Seat 6: LuckyBiitch ($618 in chips) 
x_QUIXTAR_x: posts small blind $3
ilir3: posts big blind $6
*** HOLE CARDS ***
Y-Yx777: folds 
patapong: folds 
LuckyBiitch: raises $6 to $12
x_QUIXTAR_x: folds 
ilir3: calls $6
*** FLOP *** [7s 4h Ah]
ilir3: checks 
LuckyBiitch: bets $16
ilir3: calls $16
*** TURN *** [7s 4h Ah] [3h]
ilir3: checks 
LuckyBiitch: checks 
*** RIVER *** [7s 4h Ah 3h] [Jd]
ilir3: checks 
LuckyBiitch: checks 
*** SHOW DOWN ***
ilir3: shows [5d 5h] (a pair of Fives)
LuckyBiitch: shows [9c 9s] (a pair of Nines)
LuckyBiitch collected $56.34 from pot
*** SUMMARY ***
Total pot $59 | Rake $2.66 
Board [7s 4h Ah 3h Jd]
Seat 1: x_QUIXTAR_x (small blind) folded before Flop
Seat 2: ilir3 (big blind) showed [5d 5h] and lost with a pair of Fives
Seat 3: Y-Yx777 folded before Flop (didn't bet)
Seat 4: patapong folded before Flop (didn't bet)
Seat 6: LuckyBiitch (button) showed [9c 9s] and won ($56.34) with a pair of Nines


PokerStars Game #102608988095:  Hold'em No Limit ($3/$6 USD) - 2013/08/11 11:25:42 ET
Table 'Cydonia IX 40-100 bb' 6-max Seat #4 is the button
Seat 2: ilir3 ($661.16 in chips) 
Seat 3: Y-Yx777 ($597.04 in chips) 
Seat 4: patapong ($600 in chips) 
Seat 5: shevliak ($267 in chips) 
Seat 6: LuckyBiitch ($600 in chips) 
shevliak: posts small blind $3
LuckyBiitch: posts big blind $6
*** HOLE CARDS ***
ilir3: folds 
Y-Yx777: folds 
patapong: raises $6 to $12
shevliak: raises $24 to $36
LuckyBiitch: folds 
patapong: raises $24 to $60
shevliak: raises $207 to $267 and is all-in
patapong: calls $207
*** FIRST FLOP *** [8d 6s 4c]
*** FIRST TURN *** [8d 6s 4c] [Ks]
*** FIRST RIVER *** [8d 6s 4c Ks] [5c]
*** SECOND FLOP *** [6d 7d Qd]
*** SECOND TURN *** [6d 7d Qd] [As]
*** SECOND RIVER *** [6d 7d Qd As] [7s]
*** FIRST SHOW DOWN ***
shevliak: shows [Qc Ah] (high card Ace)
patapong: shows [Tc Th] (a pair of Tens)
patapong collected $268.60 from pot
*** SECOND SHOW DOWN ***
shevliak: shows [Qc Ah] (two pair, Aces and Queens)
patapong: shows [Tc Th] (two pair, Tens and Sevens)
shevliak collected $268.60 from pot
*** SUMMARY ***
Total pot $540 | Rake $2.80 
Hand was run twice
FIRST Board [8d 6s 4c Ks 5c]
SECOND Board [6d 7d Qd As 7s]
Seat 2: ilir3 folded before Flop (didn't bet)
Seat 3: Y-Yx777 folded before Flop (didn't bet)
Seat 4: patapong (button) showed [Tc Th] and won ($268.60) with a pair of Tens, and lost with two pair, Tens and Sevens
Seat 5: shevliak (small blind) showed [Qc Ah] and lost with high card Ace, and won ($268.60) with two pair, Aces and Queens
Seat 6: LuckyBiitch (big blind) folded before Flop


PokerStars Game #102609036358:  Hold'em No Limit ($3/$6 USD) - 2013/08/11 11:26:50 ET
Table 'Cydonia IX 40-100 bb' 6-max Seat #5 is the button
Seat 1: x_QUIXTAR_x ($349.56 in chips) 
Seat 2: ilir3 ($661.16 in chips) 
Seat 3: Y-Yx777 ($597.04 in chips) 
Seat 4: patapong ($601.60 in chips) 
Seat 5: shevliak ($268.60 in chips) 
Seat 6: LuckyBiitch ($600 in chips) 
LuckyBiitch: posts small blind $3
x_QUIXTAR_x: posts big blind $6
*** HOLE CARDS ***
ilir3: folds 
Y-Yx777: folds 
patapong: folds 
shevliak: folds 
LuckyBiitch: raises $12 to $18
x_QUIXTAR_x: raises $17 to $35
LuckyBiitch: raises $40 to $75
x_QUIXTAR_x: folds 
Uncalled bet ($40) returned to LuckyBiitch
LuckyBiitch collected $70 from pot
LuckyBiitch: doesn't show hand 
*** SUMMARY ***
Total pot $70 | Rake $0 
Seat 1: x_QUIXTAR_x (big blind) folded before Flop
Seat 2: ilir3 folded before Flop (didn't bet)
Seat 3: Y-Yx777 folded before Flop (didn't bet)
Seat 4: patapong folded before Flop (didn't bet)
Seat 5: shevliak (button) folded before Flop (didn't bet)
Seat 6: LuckyBiitch (small blind) collected ($70)


PokerStars Game #102609086225:  Hold'em No Limit ($3/$6 USD) - 2013/08/11 11:28:02 ET
Table 'Cydonia IX 40-100 bb' 6-max Seat #6 is the button
Seat 1: x_QUIXTAR_x ($314.56 in chips) 
Seat 2: ilir3 ($661.16 in chips) 
Seat 3: Y-Yx777 ($597.04 in chips) 
Seat 4: patapong ($601.60 in chips) 
Seat 5: shevliak ($268.60 in chips) 
Seat 6: LuckyBiitch ($635 in chips) 
x_QUIXTAR_x: posts small blind $3
ilir3: posts big blind $6
*** HOLE CARDS ***
Y-Yx777: raises $6 to $12
patapong: folds 
shevliak: folds 
LuckyBiitch: folds 
x_QUIXTAR_x: folds 
ilir3: folds 
Uncalled bet ($6) returned to Y-Yx777
Y-Yx777 collected $15 from pot
*** SUMMARY ***
Total pot $15 | Rake $0 
Seat 1: x_QUIXTAR_x (small blind) folded before Flop
Seat 2: ilir3 (big blind) folded before Flop
Seat 3: Y-Yx777 collected ($15)
Seat 4: patapong folded before Flop (didn't bet)
Seat 5: shevliak folded before Flop (didn't bet)
Seat 6: LuckyBiitch (button) folded before Flop (didn't bet)


PokerStars Game #102609097507:  Hold'em No Limit ($3/$6 USD) - 2013/08/11 11:28:18 ET
Table 'Cydonia IX 40-100 bb' 6-max Seat #1 is the button
Seat 1: x_QUIXTAR_x ($311.56 in chips) 
Seat 2: ilir3 ($655.16 in chips) 
Seat 3: Y-Yx777 ($606.04 in chips) 
Seat 4: patapong ($601.60 in chips) 
Seat 5: shevliak ($268.60 in chips) 
Seat 6: LuckyBiitch ($635 in chips) 
ilir3: posts small blind $3
Y-Yx777: posts big blind $6
*** HOLE CARDS ***
patapong: folds 
shevliak: folds 
LuckyBiitch has timed out
LuckyBiitch: folds 
x_QUIXTAR_x: raises $7.50 to $13.50
ilir3: folds 
Y-Yx777: calls $7.50
*** FLOP *** [2h Td 2c]
Y-Yx777: checks 
x_QUIXTAR_x: bets $12
Y-Yx777: calls $12
*** TURN *** [2h Td 2c] [As]
Y-Yx777: checks 
x_QUIXTAR_x: checks 
*** RIVER *** [2h Td 2c As] [9h]
Y-Yx777: bets $24
x_QUIXTAR_x: folds 
Uncalled bet ($24) returned to Y-Yx777
Y-Yx777 collected $51.57 from pot
*** SUMMARY ***
Total pot $54 | Rake $2.43 
Board [2h Td 2c As 9h]
Seat 1: x_QUIXTAR_x (button) folded on the River
Seat 2: ilir3 (small blind) folded before Flop
Seat 3: Y-Yx777 (big blind) collected ($51.57)
Seat 4: patapong folded before Flop (didn't bet)
Seat 5: shevliak folded before Flop (didn't bet)
Seat 6: LuckyBiitch folded before Flop (didn't bet)


PokerStars Game #102609156850:  Hold'em No Limit ($3/$6 USD) - 2013/08/11 11:29:43 ET
Table 'Cydonia IX 40-100 bb' 6-max Seat #2 is the button
Seat 1: x_QUIXTAR_x ($300 in chips) 
Seat 2: ilir3 ($652.16 in chips) 
Seat 3: Y-Yx777 ($632.11 in chips) 
Seat 4: patapong ($601.60 in chips) 
Seat 5: shevliak ($268.60 in chips) 
Seat 6: LuckyBiitch ($635 in chips) 
Y-Yx777: posts small blind $3
patapong: posts big blind $6
*** HOLE CARDS ***
shevliak has timed out
shevliak: folds 
LuckyBiitch: folds 
x_QUIXTAR_x: raises $7.50 to $13.50
ilir3: calls $13.50
Y-Yx777: folds 
patapong: folds 
*** FLOP *** [As 8h 3h]
x_QUIXTAR_x: bets $18
ilir3: calls $18
*** TURN *** [As 8h 3h] [6d]
x_QUIXTAR_x: checks 
ilir3: checks 
*** RIVER *** [As 8h 3h 6d] [3d]
x_QUIXTAR_x: checks 
ilir3: checks 
*** SHOW DOWN ***
x_QUIXTAR_x: shows [Ts Kd] (a pair of Threes)
ilir3: shows [4h 4c] (two pair, Fours and Threes)
ilir3 collected $69.20 from pot
*** SUMMARY ***
Total pot $72 | Rake $2.80 
Board [As 8h 3h 6d 3d]
Seat 1: x_QUIXTAR_x showed [Ts Kd] and lost with a pair of Threes
Seat 2: ilir3 (button) showed [4h 4c] and won ($69.20) with two pair, Fours and Threes
Seat 3: Y-Yx777 (small blind) folded before Flop
Seat 4: patapong (big blind) folded before Flop
Seat 5: shevliak folded before Flop (didn't bet)
Seat 6: LuckyBiitch folded before Flop (didn't bet)


PokerStars Game #102608779279:  Hold'em No Limit ($3/$6 USD) - 2013/08/11 11:20:46 ET
Table 'Cydonia IX 40-100 bb' 6-max Seat #2 is the button
Seat 2: ilir3 ($700.16 in chips) 
Seat 3: Y-Yx777 ($456.72 in chips) 
Seat 4: patapong ($600 in chips) 
Seat 5: shevliak ($243.10 in chips) 
Seat 6: LuckyBiitch ($619.20 in chips) 
Y-Yx777: posts small blind $3
patapong: posts big blind $6
*** HOLE CARDS ***
shevliak: folds 
LuckyBiitch: folds 
ilir3: folds 
Y-Yx777: folds 
Uncalled bet ($3) returned to patapong
patapong collected $6 from pot
*** SUMMARY ***
Total pot $6 | Rake $0 
Seat 2: ilir3 (button) folded before Flop (didn't bet)
Seat 3: Y-Yx777 (small blind) folded before Flop
Seat 4: patapong (big blind) collected ($6)
Seat 5: shevliak folded before Flop (didn't bet)
Seat 6: LuckyBiitch folded before Flop (didn't bet)


PokerStars Game #102608788311:  Hold'em No Limit ($3/$6 USD) - 2013/08/11 11:20:59 ET
Table 'Cydonia IX 40-100 bb' 6-max Seat #3 is the button
Seat 2: ilir3 ($700.16 in chips) 
Seat 3: Y-Yx777 ($453.72 in chips) 
Seat 4: patapong ($603 in chips) 
Seat 5: shevliak ($243.10 in chips) 
Seat 6: LuckyBiitch ($619.20 in chips) 
patapong: posts small blind $3
shevliak: posts big blind $6
*** HOLE CARDS ***
LuckyBiitch: folds 
ilir3: folds 
Y-Yx777: folds 
patapong: folds 
Uncalled bet ($3) returned to shevliak
shevliak collected $6 from pot
shevliak: doesn't show hand 
*** SUMMARY ***
Total pot $6 | Rake $0 
Seat 2: ilir3 folded before Flop (didn't bet)
Seat 3: Y-Yx777 (button) folded before Flop (didn't bet)
Seat 4: patapong (small blind) folded before Flop
Seat 5: shevliak (big blind) collected ($6)
Seat 6: LuckyBiitch folded before Flop (didn't bet)


PokerStars Game #102608807139:  Hold'em No Limit ($3/$6 USD) - 2013/08/11 11:21:26 ET
Table 'Cydonia IX 40-100 bb' 6-max Seat #4 is the button
Seat 2: ilir3 ($700.16 in chips) 
Seat 3: Y-Yx777 ($453.72 in chips) 
Seat 4: patapong ($600 in chips) 
Seat 5: shevliak ($246.10 in chips) 
Seat 6: LuckyBiitch ($619.20 in chips) 
shevliak: posts small blind $3
LuckyBiitch: posts big blind $6
*** HOLE CARDS ***
ilir3: raises $9 to $15
Y-Yx777: calls $15
patapong: folds 
shevliak: folds 
LuckyBiitch: folds 
*** FLOP *** [Qh 8c 2d]
ilir3: bets $24
Y-Yx777: calls $24
*** TURN *** [Qh 8c 2d] [Qs]
ilir3: checks 
Y-Yx777: checks 
*** RIVER *** [Qh 8c 2d Qs] [9d]
ilir3: checks 
Y-Yx777: bets $48
ilir3: folds 
Uncalled bet ($48) returned to Y-Yx777
Y-Yx777 collected $84.20 from pot
*** SUMMARY ***
Total pot $87 | Rake $2.80 
Board [Qh 8c 2d Qs 9d]
Seat 2: ilir3 folded on the River
Seat 3: Y-Yx777 collected ($84.20)
Seat 4: patapong (button) folded before Flop (didn't bet)
Seat 5: shevliak (small blind) folded before Flop
Seat 6: LuckyBiitch (big blind) folded before Flop


PokerStars Game #102608850684:  Hold'em No Limit ($3/$6 USD) - 2013/08/11 11:22:27 ET
Table 'Cydonia IX 40-100 bb' 6-max Seat #5 is the button
Seat 2: ilir3 ($661.16 in chips) 
Seat 3: Y-Yx777 ($498.92 in chips) 
Seat 4: patapong ($600 in chips) 
Seat 5: shevliak ($243.10 in chips) 
Seat 6: LuckyBiitch ($613.20 in chips) 
LuckyBiitch: posts small blind $3
ilir3: posts big blind $6
*** HOLE CARDS ***
Y-Yx777: folds 
patapong: folds 
shevliak: raises $6 to $12
LuckyBiitch: folds 
ilir3: raises $24 to $36
shevliak: folds 
Uncalled bet ($24) returned to ilir3
ilir3 collected $27 from pot
ilir3: doesn't show hand 
*** SUMMARY ***
Total pot $27 | Rake $0 
Seat 2: ilir3 (big blind) collected ($27)
Seat 3: Y-Yx777 folded before Flop (didn't bet)
Seat 4: patapong folded before Flop (didn't bet)
Seat 5: shevliak (button) folded before Flop
Seat 6: LuckyBiitch (small blind) folded before Flop


PokerStars Game #102608870238:  Hold'em No Limit ($3/$6 USD) - 2013/08/11 11:22:55 ET
Table 'Cydonia IX 40-100 bb' 6-max Seat #6 is the button
Seat 2: ilir3 ($676.16 in chips) 
Seat 3: Y-Yx777 ($498.92 in chips) 
Seat 4: patapong ($600 in chips) 
Seat 5: shevliak ($240 in chips) 
Seat 6: LuckyBiitch ($610.20 in chips) 
ilir3: posts small blind $3
Y-Yx777: posts big blind $6
*** HOLE CARDS ***
patapong: folds 
shevliak: folds 
LuckyBiitch: raises $6 to $12
ilir3: folds 
Y-Yx777: calls $6
*** FLOP *** [9s 5s 4s]
Y-Yx777: checks 
LuckyBiitch: checks 
*** TURN *** [9s 5s 4s] [7c]
Y-Yx777: bets $12
LuckyBiitch: calls $12
*** RIVER *** [9s 5s 4s 7c] [Kd]
Y-Yx777: bets $24
LuckyBiitch: raises $51 to $75
Y-Yx777: calls $51
*** SHOW DOWN ***
LuckyBiitch: shows [Jd 8h] (high card King)
Y-Yx777: shows [Th Ks] (a pair of Kings)
Y-Yx777 collected $198.20 from pot
*** SUMMARY ***
Total pot $201 | Rake $2.80 
Board [9s 5s 4s 7c Kd]
Seat 2: ilir3 (small blind) folded before Flop
Seat 3: Y-Yx777 (big blind) showed [Th Ks] and won ($198.20) with a pair of Kings
Seat 4: patapong folded before Flop (didn't bet)
Seat 5: shevliak folded before Flop (didn't bet)
Seat 6: LuckyBiitch (button) showed [Jd 8h] and lost with high card King


PokerStars Game #102608926724:  Hold'em No Limit ($3/$6 USD) - 2013/08/11 11:24:15 ET
Table 'Cydonia IX 40-100 bb' 6-max Seat #2 is the button
Seat 2: ilir3 ($673.16 in chips) 
Seat 3: Y-Yx777 ($598.12 in chips) 
Seat 4: patapong ($600 in chips) 
Seat 5: shevliak ($240 in chips) 
Seat 6: LuckyBiitch ($600 in chips) 
Y-Yx777: posts small blind $3
patapong: posts big blind $6
*** HOLE CARDS ***
shevliak: folds 
LuckyBiitch: folds 
ilir3: folds 
Y-Yx777: raises $6 to $12
patapong: calls $6
*** FLOP *** [3h 4h 3s]
Y-Yx777: bets $12
patapong: folds 
Uncalled bet ($12) returned to Y-Yx777
Y-Yx777 collected $22.92 from pot
*** SUMMARY ***
Total pot $24 | Rake $1.08 
Board [3h 4h 3s]
Seat 2: ilir3 (button) folded before Flop (didn't bet)
Seat 3: Y-Yx777 (small blind) collected ($22.92)
Seat 4: patapong (big blind) folded on the Flop
Seat 5: shevliak folded before Flop (didn't bet)
Seat 6: LuckyBiitch folded before Flop (didn't bet)


PokerStars Game #102608950038:  Hold'em No Limit ($3/$6 USD) - 2013/08/11 11:24:48 ET
Table 'Cydonia IX 40-100 bb' 6-max Seat #3 is the button
Seat 2: ilir3 ($673.16 in chips) 
Seat 3: Y-Yx777 ($609.04 in chips) 
Seat 4: patapong ($600 in chips) 
Seat 5: shevliak ($240 in chips) 
Seat 6: LuckyBiitch ($600 in chips) 
patapong: posts small blind $3
shevliak: posts big blind $6
*** HOLE CARDS ***
LuckyBiitch: folds 
ilir3: raises $6 to $12
Y-Yx777: calls $12
patapong: folds 
shevliak: raises $105 to $117
ilir3: folds 
Y-Yx777: folds 
Uncalled bet ($105) returned to shevliak
shevliak collected $39 from pot
shevliak: doesn't show hand 
*** SUMMARY ***
Total pot $39 | Rake $0 
Seat 2: ilir3 folded before Flop
Seat 3: Y-Yx777 (button) folded before Flop
Seat 4: patapong (small blind) folded before Flop
Seat 5: shevliak (big blind) collected ($39)
Seat 6: LuckyBiitch folded before Flop (didn't bet)


PokerStars Game #102608542862:  Hold'em No Limit ($3/$6 USD) - 2013/08/11 11:15:18 ET
Table 'Cydonia IX 40-100 bb' 6-max Seat #5 is the button
Seat 1: x_QUIXTAR_x ($349.56 in chips) 
Seat 2: ilir3 ($695.92 in chips) 
Seat 3: Y-Yx777 ($475.20 in chips) 
Seat 4: patapong ($600 in chips) 
Seat 5: shevliak ($252.10 in chips) 
Seat 6: LuckyBiitch ($600 in chips) 
LuckyBiitch: posts small blind $3
x_QUIXTAR_x: posts big blind $6
*** HOLE CARDS ***
ilir3 said, "facile"
ilir3: folds 
Y-Yx777: folds 
patapong: raises $9 to $15
shevliak: folds 
LuckyBiitch: folds 
x_QUIXTAR_x: folds 
Uncalled bet ($9) returned to patapong
patapong collected $15 from pot
*** SUMMARY ***
Total pot $15 | Rake $0 
Seat 1: x_QUIXTAR_x (big blind) folded before Flop
Seat 2: ilir3 folded before Flop (didn't bet)
Seat 3: Y-Yx777 folded before Flop (didn't bet)
Seat 4: patapong collected ($15)
Seat 5: shevliak (button) folded before Flop (didn't bet)
Seat 6: LuckyBiitch (small blind) folded before Flop


PokerStars Game #102608562856:  Hold'em No Limit ($3/$6 USD) - 2013/08/11 11:15:46 ET
Table 'Cydonia IX 40-100 bb' 6-max Seat #6 is the button
Seat 1: x_QUIXTAR_x ($343.56 in chips) 
Seat 2: ilir3 ($695.92 in chips) 
Seat 3: Y-Yx777 ($475.20 in chips) 
Seat 4: patapong ($609 in chips) 
Seat 5: shevliak ($252.10 in chips) 
Seat 6: LuckyBiitch ($600 in chips) 
x_QUIXTAR_x: posts small blind $3
ilir3: posts big blind $6
*** HOLE CARDS ***
Y-Yx777: raises $6 to $12
patapong: folds 
shevliak: folds 
LuckyBiitch: folds 
x_QUIXTAR_x: folds 
ilir3: folds 
Uncalled bet ($6) returned to Y-Yx777
Y-Yx777 collected $15 from pot
*** SUMMARY ***
Total pot $15 | Rake $0 
Seat 1: x_QUIXTAR_x (small blind) folded before Flop
Seat 2: ilir3 (big blind) folded before Flop
Seat 3: Y-Yx777 collected ($15)
Seat 4: patapong folded before Flop (didn't bet)
Seat 5: shevliak folded before Flop (didn't bet)
Seat 6: LuckyBiitch (button) folded before Flop (didn't bet)


PokerStars Game #102608586764:  Hold'em No Limit ($3/$6 USD) - 2013/08/11 11:16:18 ET
Table 'Cydonia IX 40-100 bb' 6-max Seat #1 is the button
Seat 1: x_QUIXTAR_x ($340.56 in chips) 
Seat 2: ilir3 ($689.92 in chips) 
Seat 3: Y-Yx777 ($484.20 in chips) 
Seat 4: patapong ($609 in chips) 
Seat 5: shevliak ($252.10 in chips) 
Seat 6: LuckyBiitch ($600 in chips) 
ilir3: posts small blind $3
Y-Yx777: posts big blind $6
*** HOLE CARDS ***
patapong: folds 
shevliak: folds 
LuckyBiitch: folds 
x_QUIXTAR_x: folds 
ilir3: folds 
Uncalled bet ($3) returned to Y-Yx777
Y-Yx777 collected $6 from pot
*** SUMMARY ***
Total pot $6 | Rake $0 
Seat 1: x_QUIXTAR_x (button) folded before Flop (didn't bet)
Seat 2: ilir3 (small blind) folded before Flop
Seat 3: Y-Yx777 (big blind) collected ($6)
Seat 4: patapong folded before Flop (didn't bet)
Seat 5: shevliak folded before Flop (didn't bet)
Seat 6: LuckyBiitch folded before Flop (didn't bet)


PokerStars Game #102608612037:  Hold'em No Limit ($3/$6 USD) - 2013/08/11 11:16:53 ET
Table 'Cydonia IX 40-100 bb' 6-max Seat #2 is the button
Seat 1: x_QUIXTAR_x ($340.56 in chips) 
Seat 2: ilir3 ($686.92 in chips) 
Seat 3: Y-Yx777 ($487.20 in chips) 
Seat 4: patapong ($609 in chips) 
Seat 5: shevliak ($252.10 in chips) 
Seat 6: LuckyBiitch ($600 in chips) 
Y-Yx777: posts small blind $3
patapong: posts big blind $6
*** HOLE CARDS ***
shevliak: folds 
LuckyBiitch: folds 
x_QUIXTAR_x: raises $7.50 to $13.50
ilir3: folds 
Y-Yx777: folds 
patapong: folds 
Uncalled bet ($7.50) returned to x_QUIXTAR_x
x_QUIXTAR_x collected $15 from pot
x_QUIXTAR_x: doesn't show hand 
*** SUMMARY ***
Total pot $15 | Rake $0 
Seat 1: x_QUIXTAR_x collected ($15)
Seat 2: ilir3 (button) folded before Flop (didn't bet)
Seat 3: Y-Yx777 (small blind) folded before Flop
Seat 4: patapong (big blind) folded before Flop
Seat 5: shevliak folded before Flop (didn't bet)
Seat 6: LuckyBiitch folded before Flop (didn't bet)


PokerStars Game #102608663051:  Hold'em No Limit ($3/$6 USD) - 2013/08/11 11:18:04 ET
Table 'Cydonia IX 40-100 bb' 6-max Seat #3 is the button
Seat 2: ilir3 ($686.92 in chips) 
Seat 3: Y-Yx777 ($484.20 in chips) 
Seat 4: patapong ($603 in chips) 
Seat 5: shevliak ($252.10 in chips) 
Seat 6: LuckyBiitch ($600 in chips) 
patapong: posts small blind $3
shevliak: posts big blind $6
*** HOLE CARDS ***
LuckyBiitch: raises $12 to $18
ilir3: folds 
Y-Yx777: calls $18
patapong: folds 
shevliak: folds 
*** FLOP *** [3d 8s 3c]
LuckyBiitch: checks 
Y-Yx777: checks 
*** TURN *** [3d 8s 3c] [6c]
LuckyBiitch: checks 
Y-Yx777: bets $30
LuckyBiitch: calls $30
*** RIVER *** [3d 8s 3c 6c] [Qh]
LuckyBiitch: checks 
Y-Yx777: checks 
*** SHOW DOWN ***
LuckyBiitch: shows [5d 6d] (two pair, Sixes and Threes)
Y-Yx777: mucks hand 
LuckyBiitch collected $102.20 from pot
*** SUMMARY ***
Total pot $105 | Rake $2.80 
Board [3d 8s 3c 6c Qh]
Seat 2: ilir3 folded before Flop (didn't bet)
Seat 3: Y-Yx777 (button) mucked
Seat 4: patapong (small blind) folded before Flop
Seat 5: shevliak (big blind) folded before Flop
Seat 6: LuckyBiitch showed [5d 6d] and won ($102.20) with two pair, Sixes and Threes


PokerStars Game #102608711586:  Hold'em No Limit ($3/$6 USD) - 2013/08/11 11:19:12 ET
Table 'Cydonia IX 40-100 bb' 6-max Seat #4 is the button
Seat 2: ilir3 ($686.92 in chips) 
Seat 3: Y-Yx777 ($436.20 in chips) 
Seat 4: patapong ($600 in chips) 
Seat 5: shevliak ($246.10 in chips) 
Seat 6: LuckyBiitch ($654.20 in chips) 
shevliak: posts small blind $3
LuckyBiitch: posts big blind $6
*** HOLE CARDS ***
ilir3: raises $9 to $15
Y-Yx777: calls $15
patapong: folds 
shevliak: folds 
LuckyBiitch: folds 
*** FLOP *** [Th 4h 5s]
ilir3: checks 
Y-Yx777: checks 
*** TURN *** [Th 4h 5s] [Kd]
ilir3: bets $24
Y-Yx777: folds 
Uncalled bet ($24) returned to ilir3
ilir3 collected $37.24 from pot
ilir3: doesn't show hand 
*** SUMMARY ***
Total pot $39 | Rake $1.76 
Board [Th 4h 5s Kd]
Seat 2: ilir3 collected ($37.24)
Seat 3: Y-Yx777 folded on the Turn
Seat 4: patapong (button) folded before Flop (didn't bet)
Seat 5: shevliak (small blind) folded before Flop
Seat 6: LuckyBiitch (big blind) folded before Flop


PokerStars Game #102608732112:  Hold'em No Limit ($3/$6 USD) - 2013/08/11 11:19:40 ET
Table 'Cydonia IX 40-100 bb' 6-max Seat #5 is the button
Seat 2: ilir3 ($709.16 in chips) 
Seat 3: Y-Yx777 ($421.20 in chips) 
Seat 4: patapong ($600 in chips) 
Seat 5: shevliak ($243.10 in chips) 
Seat 6: LuckyBiitch ($648.20 in chips) 
LuckyBiitch: posts small blind $3
ilir3: posts big blind $6
*** HOLE CARDS ***
Y-Yx777: raises $6 to $12
patapong: folds 
shevliak: folds 
LuckyBiitch: folds 
ilir3: folds 
Uncalled bet ($6) returned to Y-Yx777
Y-Yx777 collected $15 from pot
*** SUMMARY ***
Total pot $15 | Rake $0 
Seat 2: ilir3 (big blind) folded before Flop
Seat 3: Y-Yx777 collected ($15)
Seat 4: patapong folded before Flop (didn't bet)
Seat 5: shevliak (button) folded before Flop (didn't bet)
Seat 6: LuckyBiitch (small blind) folded before Flop


PokerStars Game #102608743702:  Hold'em No Limit ($3/$6 USD) - 2013/08/11 11:19:56 ET
Table 'Cydonia IX 40-100 bb' 6-max Seat #6 is the button
Seat 2: ilir3 ($703.16 in chips) 
Seat 3: Y-Yx777 ($430.20 in chips) 
Seat 4: patapong ($600 in chips) 
Seat 5: shevliak ($243.10 in chips) 
Seat 6: LuckyBiitch ($645.20 in chips) 
ilir3: posts small blind $3
Y-Yx777: posts big blind $6
*** HOLE CARDS ***
patapong: folds 
shevliak: folds 
LuckyBiitch: raises $6 to $12
ilir3: folds 
Y-Yx777: calls $6
*** FLOP *** [Ah 6c 4d]
Y-Yx777: checks 
LuckyBiitch: bets $14
Y-Yx777: calls $14
*** TURN *** [Ah 6c 4d] [Jc]
Y-Yx777: checks 
LuckyBiitch: checks 
*** RIVER *** [Ah 6c 4d Jc] [3d]
Y-Yx777: bets $24
LuckyBiitch: folds 
Uncalled bet ($24) returned to Y-Yx777
Y-Yx777 collected $52.52 from pot
*** SUMMARY ***
Total pot $55 | Rake $2.48 
Board [Ah 6c 4d Jc 3d]
Seat 2: ilir3 (small blind) folded before Flop
Seat 3: Y-Yx777 (big blind) collected ($52.52)
Seat 4: patapong folded before Flop (didn't bet)
Seat 5: shevliak folded before Flop (didn't bet)
Seat 6: LuckyBiitch (button) folded on the River


PokerStars Game #102608330170:  Hold'em No Limit ($3/$6 USD) - 2013/08/11 11:10:28 ET
Table 'Cydonia IX 40-100 bb' 6-max Seat #3 is the button
Seat 1: x_QUIXTAR_x ($318.48 in chips) 
Seat 2: ilir3 ($681.90 in chips) 
Seat 3: Y-Yx777 ($481.20 in chips) 
Seat 4: patapong ($618 in chips) 
Seat 5: shevliak ($240 in chips) 
Seat 6: zazano ($644 in chips) 
patapong: posts small blind $3
shevliak: posts big blind $6
*** HOLE CARDS ***
zazano: folds 
x_QUIXTAR_x: folds 
ilir3: folds 
Y-Yx777: raises $6 to $12
patapong: folds 
shevliak: folds 
Uncalled bet ($6) returned to Y-Yx777
Y-Yx777 collected $15 from pot
*** SUMMARY ***
Total pot $15 | Rake $0 
Seat 1: x_QUIXTAR_x folded before Flop (didn't bet)
Seat 2: ilir3 folded before Flop (didn't bet)
Seat 3: Y-Yx777 (button) collected ($15)
Seat 4: patapong (small blind) folded before Flop
Seat 5: shevliak (big blind) folded before Flop
Seat 6: zazano folded before Flop (didn't bet)


PokerStars Game #102608350387:  Hold'em No Limit ($3/$6 USD) - 2013/08/11 11:10:55 ET
Table 'Cydonia IX 40-100 bb' 6-max Seat #4 is the button
Seat 1: x_QUIXTAR_x ($318.48 in chips) 
Seat 2: ilir3 ($681.90 in chips) 
Seat 3: Y-Yx777 ($490.20 in chips) 
Seat 4: patapong ($615 in chips) 
Seat 5: shevliak ($240 in chips) 
shevliak: posts small blind $3
zazano: is sitting out 
zazano leaves the table
x_QUIXTAR_x: posts big blind $6
*** HOLE CARDS ***
ilir3: folds 
Y-Yx777: folds 
LuckyBiitch joins the table at seat #6 
patapong: folds 
shevliak: folds 
Uncalled bet ($3) returned to x_QUIXTAR_x
x_QUIXTAR_x collected $6 from pot
x_QUIXTAR_x: doesn't show hand 
*** SUMMARY ***
Total pot $6 | Rake $0 
Seat 1: x_QUIXTAR_x (big blind) collected ($6)
Seat 2: ilir3 folded before Flop (didn't bet)
Seat 3: Y-Yx777 folded before Flop (didn't bet)
Seat 4: patapong (button) folded before Flop (didn't bet)
Seat 5: shevliak (small blind) folded before Flop


PokerStars Game #102608366497:  Hold'em No Limit ($3/$6 USD) - 2013/08/11 11:11:17 ET
Table 'Cydonia IX 40-100 bb' 6-max Seat #5 is the button
Seat 1: x_QUIXTAR_x ($321.48 in chips) 
Seat 2: ilir3 ($681.90 in chips) 
Seat 3: Y-Yx777 ($490.20 in chips) 
Seat 4: patapong ($615 in chips) 
Seat 5: shevliak ($240 in chips) 
LuckyBiitch will be allowed to play after the button
x_QUIXTAR_x: posts small blind $3
ilir3: posts big blind $6
*** HOLE CARDS ***
Y-Yx777: folds 
patapong: folds 
shevliak: folds 
x_QUIXTAR_x: raises $6 to $12
ilir3: folds 
Uncalled bet ($6) returned to x_QUIXTAR_x
x_QUIXTAR_x collected $12 from pot
x_QUIXTAR_x: doesn't show hand 
*** SUMMARY ***
Total pot $12 | Rake $0 
Seat 1: x_QUIXTAR_x (small blind) collected ($12)
Seat 2: ilir3 (big blind) folded before Flop
Seat 3: Y-Yx777 folded before Flop (didn't bet)
Seat 4: patapong folded before Flop (didn't bet)
Seat 5: shevliak (button) folded before Flop (didn't bet)


PokerStars Game #102608386525:  Hold'em No Limit ($3/$6 USD) - 2013/08/11 11:11:44 ET
Table 'Cydonia IX 40-100 bb' 6-max Seat #1 is the button
Seat 1: x_QUIXTAR_x ($327.48 in chips) 
Seat 2: ilir3 ($675.90 in chips) 
Seat 3: Y-Yx777 ($490.20 in chips) 
Seat 4: patapong ($615 in chips) 
Seat 5: shevliak ($240 in chips) 
ilir3: posts small blind $3
Y-Yx777: posts big blind $6
LuckyBiitch: sits out 
*** HOLE CARDS ***
patapong: folds 
shevliak: folds 
x_QUIXTAR_x: folds 
ilir3: calls $3
Y-Yx777: checks 
*** FLOP *** [Td Kh Tc]
ilir3: bets $6
Y-Yx777: calls $6
*** TURN *** [Td Kh Tc] [4c]
ilir3: checks 
Y-Yx777: checks 
*** RIVER *** [Td Kh Tc 4c] [Ts]
ilir3: bets $12
Y-Yx777: folds 
Uncalled bet ($12) returned to ilir3
ilir3 collected $22.92 from pot
*** SUMMARY ***
Total pot $24 | Rake $1.08 
Board [Td Kh Tc 4c Ts]
Seat 1: x_QUIXTAR_x (button) folded before Flop (didn't bet)
Seat 2: ilir3 (small blind) collected ($22.92)
Seat 3: Y-Yx777 (big blind) folded on the River
Seat 4: patapong folded before Flop (didn't bet)
Seat 5: shevliak folded before Flop (didn't bet)


PokerStars Game #102608424527:  Hold'em No Limit ($3/$6 USD) - 2013/08/11 11:12:36 ET
Table 'Cydonia IX 40-100 bb' 6-max Seat #2 is the button
Seat 1: x_QUIXTAR_x ($327.48 in chips) 
Seat 2: ilir3 ($686.82 in chips) 
Seat 3: Y-Yx777 ($478.20 in chips) 
Seat 4: patapong ($615 in chips) 
Seat 5: shevliak ($240 in chips) 
Y-Yx777: posts small blind $3
patapong: posts big blind $6
LuckyBiitch: sits out 
*** HOLE CARDS ***
shevliak: raises $7.08 to $13.08
x_QUIXTAR_x: raises $22.92 to $36
ilir3: folds 
Y-Yx777: folds 
patapong: folds 
shevliak: folds 
Uncalled bet ($22.92) returned to x_QUIXTAR_x
x_QUIXTAR_x collected $35.16 from pot
x_QUIXTAR_x: doesn't show hand 
*** SUMMARY ***
Total pot $35.16 | Rake $0 
Seat 1: x_QUIXTAR_x collected ($35.16)
Seat 2: ilir3 (button) folded before Flop (didn't bet)
Seat 3: Y-Yx777 (small blind) folded before Flop
Seat 4: patapong (big blind) folded before Flop
Seat 5: shevliak folded before Flop


PokerStars Game #102608449402:  Hold'em No Limit ($3/$6 USD) - 2013/08/11 11:13:10 ET
Table 'Cydonia IX 40-100 bb' 6-max Seat #3 is the button
Seat 1: x_QUIXTAR_x ($349.56 in chips) 
Seat 2: ilir3 ($686.82 in chips) 
Seat 3: Y-Yx777 ($475.20 in chips) 
Seat 4: patapong ($609 in chips) 
Seat 5: shevliak ($240 in chips) 
patapong: posts small blind $3
shevliak: posts big blind $6
LuckyBiitch: sits out 
*** HOLE CARDS ***
x_QUIXTAR_x: folds 
ilir3: folds 
Y-Yx777: folds 
patapong: folds 
Uncalled bet ($3) returned to shevliak
shevliak collected $6 from pot
shevliak: doesn't show hand 
*** SUMMARY ***
Total pot $6 | Rake $0 
Seat 1: x_QUIXTAR_x folded before Flop (didn't bet)
Seat 2: ilir3 folded before Flop (didn't bet)
Seat 3: Y-Yx777 (button) folded before Flop (didn't bet)
Seat 4: patapong (small blind) folded before Flop
Seat 5: shevliak (big blind) collected ($6)


PokerStars Game #102608467792:  Hold'em No Limit ($3/$6 USD) - 2013/08/11 11:13:36 ET
Table 'Cydonia IX 40-100 bb' 6-max Seat #4 is the button
Seat 1: x_QUIXTAR_x ($349.56 in chips) 
Seat 2: ilir3 ($686.82 in chips) 
Seat 3: Y-Yx777 ($475.20 in chips) 
Seat 4: patapong ($606 in chips) 
Seat 5: shevliak ($243 in chips) 
Seat 6: LuckyBiitch ($600 in chips) 
shevliak: posts small blind $3
LuckyBiitch: posts big blind $6
*** HOLE CARDS ***
x_QUIXTAR_x: folds 
ilir3: raises $9 to $15
Y-Yx777: folds 
patapong: calls $15
shevliak: raises $33 to $48
LuckyBiitch: folds 
ilir3: raises $50 to $98
Y-Yx777 is disconnected 
patapong: folds 
shevliak: raises $145 to $243 and is all-in
ilir3: calls $145
*** FIRST FLOP *** [7d 4d Ad]
*** FIRST TURN *** [7d 4d Ad] [9d]
*** FIRST RIVER *** [7d 4d Ad 9d] [2c]
*** SECOND FLOP *** [4s Qh Th]
*** SECOND TURN *** [4s Qh Th] [9c]
*** SECOND RIVER *** [4s Qh Th 9c] [Jd]
*** FIRST SHOW DOWN ***
shevliak: shows [Ah Ac] (three of a kind, Aces)
ilir3: shows [Js Jc] (a pair of Jacks)
shevliak collected $252.10 from pot
*** SECOND SHOW DOWN ***
shevliak: shows [Ah Ac] (a pair of Aces)
ilir3: shows [Js Jc] (three of a kind, Jacks)
ilir3 collected $252.10 from pot
*** SUMMARY ***
Total pot $507 | Rake $2.80 
Hand was run twice
FIRST Board [7d 4d Ad 9d 2c]
SECOND Board [4s Qh Th 9c Jd]
Seat 1: x_QUIXTAR_x folded before Flop (didn't bet)
Seat 2: ilir3 showed [Js Jc] and lost with a pair of Jacks, and won ($252.10) with three of a kind, Jacks
Seat 3: Y-Yx777 folded before Flop (didn't bet)
Seat 4: patapong (button) folded before Flop
Seat 5: shevliak (small blind) showed [Ah Ac] and won ($252.10) with three of a kind, Aces, and lost with a pair of Aces
Seat 6: LuckyBiitch (big blind) folded before Flop


PokerStars Game #102610031400:  Hold'em No Limit ($3/$6 USD) - 2013/08/11 11:50:10 ET
Table 'Cydonia IX 40-100 bb' 6-max Seat #1 is the button
Seat 1: x_QUIXTAR_x ($332.60 in chips) 
Seat 2: ilir3 ($644.70 in chips) 
Seat 3: Y-Yx777 ($731.51 in chips) 
Seat 4: patapong ($666.72 in chips) 
Seat 5: shevliak ($307.40 in chips) 
Seat 6: LuckyBiitch ($643.20 in chips) 
ilir3: posts small blind $3
Y-Yx777: posts big blind $6
*** HOLE CARDS ***
patapong: raises $9 to $15
shevliak: folds 
LuckyBiitch: folds 
x_QUIXTAR_x: calls $15
ilir3: calls $12
Y-Yx777: calls $9
*** FLOP *** [2s Kc 5c]
ilir3: checks 
Y-Yx777: bets $30
patapong: folds 
x_QUIXTAR_x: folds 
ilir3: folds 
Uncalled bet ($30) returned to Y-Yx777
Y-Yx777 collected $57.30 from pot
*** SUMMARY ***
Total pot $60 | Rake $2.70 
Board [2s Kc 5c]
Seat 1: x_QUIXTAR_x (button) folded on the Flop
Seat 2: ilir3 (small blind) folded on the Flop
Seat 3: Y-Yx777 (big blind) collected ($57.30)
Seat 4: patapong folded on the Flop
Seat 5: shevliak folded before Flop (didn't bet)
Seat 6: LuckyBiitch folded before Flop (didn't bet)


PokerStars Game #102610077841:  Hold'em No Limit ($3/$6 USD) - 2013/08/11 11:51:17 ET
Table 'Cydonia IX 40-100 bb' 6-max Seat #2 is the button
Seat 1: x_QUIXTAR_x ($317.60 in chips) 
Seat 2: ilir3 ($629.70 in chips) 
Seat 3: Y-Yx777 ($773.81 in chips) 
Seat 4: patapong ($651.72 in chips) 
Seat 5: shevliak ($307.40 in chips) 
Seat 6: LuckyBiitch ($643.20 in chips) 
Y-Yx777: posts small blind $3
patapong: posts big blind $6
*** HOLE CARDS ***
shevliak: folds 
LuckyBiitch: folds 
x_QUIXTAR_x: raises $7.50 to $13.50
ilir3: folds 
Y-Yx777: folds 
patapong: folds 
Uncalled bet ($7.50) returned to x_QUIXTAR_x
x_QUIXTAR_x collected $15 from pot
x_QUIXTAR_x: doesn't show hand 
*** SUMMARY ***
Total pot $15 | Rake $0 
Seat 1: x_QUIXTAR_x collected ($15)
Seat 2: ilir3 (button) folded before Flop (didn't bet)
Seat 3: Y-Yx777 (small blind) folded before Flop
Seat 4: patapong (big blind) folded before Flop
Seat 5: shevliak folded before Flop (didn't bet)
Seat 6: LuckyBiitch folded before Flop (didn't bet)


PokerStars Game #102610102524:  Hold'em No Limit ($3/$6 USD) - 2013/08/11 11:51:51 ET
Table 'Cydonia IX 40-100 bb' 6-max Seat #3 is the button
Seat 1: x_QUIXTAR_x ($326.60 in chips) 
Seat 2: ilir3 ($629.70 in chips) 
Seat 3: Y-Yx777 ($770.81 in chips) 
Seat 4: patapong ($645.72 in chips) 
Seat 5: shevliak ($307.40 in chips) 
Seat 6: LuckyBiitch ($643.20 in chips) 
patapong: posts small blind $3
shevliak: posts big blind $6
*** HOLE CARDS ***
LuckyBiitch: raises $12 to $18
x_QUIXTAR_x: folds 
ilir3: folds 
Y-Yx777: folds 
patapong: folds 
shevliak: folds 
Uncalled bet ($12) returned to LuckyBiitch
LuckyBiitch collected $15 from pot
LuckyBiitch: doesn't show hand 
*** SUMMARY ***
Total pot $15 | Rake $0 
Seat 1: x_QUIXTAR_x folded before Flop (didn't bet)
Seat 2: ilir3 folded before Flop (didn't bet)
Seat 3: Y-Yx777 (button) folded before Flop (didn't bet)
Seat 4: patapong (small blind) folded before Flop
Seat 5: shevliak (big blind) folded before Flop
Seat 6: LuckyBiitch collected ($15)


PokerStars Game #102610135373:  Hold'em No Limit ($3/$6 USD) - 2013/08/11 11:52:38 ET
Table 'Cydonia IX 40-100 bb' 6-max Seat #4 is the button
Seat 1: x_QUIXTAR_x ($326.60 in chips) 
Seat 2: ilir3 ($629.70 in chips) 
Seat 3: Y-Yx777 ($770.81 in chips) 
Seat 4: patapong ($642.72 in chips) 
Seat 5: shevliak ($301.40 in chips) 
Seat 6: LuckyBiitch ($652.20 in chips) 
shevliak: posts small blind $3
LuckyBiitch: posts big blind $6
*** HOLE CARDS ***
x_QUIXTAR_x: folds 
ilir3: folds 
Y-Yx777: folds 
patapong: raises $6 to $12
shevliak: folds 
LuckyBiitch: folds 
Uncalled bet ($6) returned to patapong
patapong collected $15 from pot
*** SUMMARY ***
Total pot $15 | Rake $0 
Seat 1: x_QUIXTAR_x folded before Flop (didn't bet)
Seat 2: ilir3 folded before Flop (didn't bet)
Seat 3: Y-Yx777 folded before Flop (didn't bet)
Seat 4: patapong (button) collected ($15)
Seat 5: shevliak (small blind) folded before Flop
Seat 6: LuckyBiitch (big blind) folded before Flop


PokerStars Game #102610162660:  Hold'em No Limit ($3/$6 USD) - 2013/08/11 11:53:17 ET
Table 'Cydonia IX 40-100 bb' 6-max Seat #5 is the button
Seat 1: x_QUIXTAR_x ($326.60 in chips) 
Seat 2: ilir3 ($629.70 in chips) 
Seat 3: Y-Yx777 ($770.81 in chips) 
Seat 4: patapong ($651.72 in chips) 
Seat 5: shevliak ($298.40 in chips) 
Seat 6: LuckyBiitch ($646.20 in chips) 
LuckyBiitch: posts small blind $3
x_QUIXTAR_x: posts big blind $6
*** HOLE CARDS ***
ilir3: folds 
Y-Yx777: raises $6 to $12
patapong: folds 
shevliak: folds 
LuckyBiitch: folds 
x_QUIXTAR_x: calls $6
*** FLOP *** [6c As 5d]
x_QUIXTAR_x: bets $18
Y-Yx777: calls $18
*** TURN *** [6c As 5d] [3s]
x_QUIXTAR_x: bets $20
Y-Yx777: raises $34 to $54
x_QUIXTAR_x: calls $34
*** RIVER *** [6c As 5d 3s] [5c]
x_QUIXTAR_x: checks 
Y-Yx777: checks 
*** SHOW DOWN ***
x_QUIXTAR_x: shows [4c Ac] (two pair, Aces and Fives)
Y-Yx777: mucks hand 
x_QUIXTAR_x collected $168.20 from pot
*** SUMMARY ***
Total pot $171 | Rake $2.80 
Board [6c As 5d 3s 5c]
Seat 1: x_QUIXTAR_x (big blind) showed [4c Ac] and won ($168.20) with two pair, Aces and Fives
Seat 2: ilir3 folded before Flop (didn't bet)
Seat 3: Y-Yx777 mucked
Seat 4: patapong folded before Flop (didn't bet)
Seat 5: shevliak (button) folded before Flop (didn't bet)
Seat 6: LuckyBiitch (small blind) folded before Flop


PokerStars Game #102610207430:  Hold'em No Limit ($3/$6 USD) - 2013/08/11 11:54:21 ET
Table 'Cydonia IX 40-100 bb' 6-max Seat #6 is the button
Seat 1: x_QUIXTAR_x ($410.80 in chips) 
Seat 2: ilir3 ($629.70 in chips) 
Seat 3: Y-Yx777 ($686.81 in chips) 
Seat 4: patapong ($651.72 in chips) 
Seat 5: shevliak ($298.40 in chips) 
Seat 6: LuckyBiitch ($643.20 in chips) 
x_QUIXTAR_x: posts small blind $3
ilir3: posts big blind $6
*** HOLE CARDS ***
Y-Yx777: raises $6 to $12
patapong: folds 
shevliak: folds 
LuckyBiitch: raises $24 to $36
x_QUIXTAR_x: folds 
ilir3: folds 
Y-Yx777: calls $24
*** FLOP *** [5h Ts 5d]
Y-Yx777: checks 
LuckyBiitch: bets $50
Y-Yx777: calls $50
*** TURN *** [5h Ts 5d] [9h]
Y-Yx777: checks 
LuckyBiitch: bets $135
Y-Yx777: folds 
Uncalled bet ($135) returned to LuckyBiitch
LuckyBiitch collected $178.20 from pot
LuckyBiitch: doesn't show hand 
*** SUMMARY ***
Total pot $181 | Rake $2.80 
Board [5h Ts 5d 9h]
Seat 1: x_QUIXTAR_x (small blind) folded before Flop
Seat 2: ilir3 (big blind) folded before Flop
Seat 3: Y-Yx777 folded on the Turn
Seat 4: patapong folded before Flop (didn't bet)
Seat 5: shevliak folded before Flop (didn't bet)
Seat 6: LuckyBiitch (button) collected ($178.20)


PokerStars Game #102609824857:  Hold'em No Limit ($3/$6 USD) - 2013/08/11 11:45:18 ET
Table 'Cydonia IX 40-100 bb' 6-max Seat #4 is the button
Seat 1: x_QUIXTAR_x ($304.50 in chips) 
Seat 3: Y-Yx777 ($734.51 in chips) 
Seat 4: patapong ($666.72 in chips) 
Seat 5: shevliak ($301.80 in chips) 
Seat 6: LuckyBiitch ($600 in chips) 
shevliak: posts small blind $3
LuckyBiitch: posts big blind $6
*** HOLE CARDS ***
x_QUIXTAR_x: folds 
Y-Yx777: raises $6 to $12
patapong: folds 
shevliak: folds 
LuckyBiitch: folds 
Uncalled bet ($6) returned to Y-Yx777
Y-Yx777 collected $15 from pot
*** SUMMARY ***
Total pot $15 | Rake $0 
Seat 1: x_QUIXTAR_x folded before Flop (didn't bet)
Seat 3: Y-Yx777 collected ($15)
Seat 4: patapong (button) folded before Flop (didn't bet)
Seat 5: shevliak (small blind) folded before Flop
Seat 6: LuckyBiitch (big blind) folded before Flop


PokerStars Game #102609847429:  Hold'em No Limit ($3/$6 USD) - 2013/08/11 11:45:50 ET
Table 'Cydonia IX 40-100 bb' 6-max Seat #5 is the button
Seat 1: x_QUIXTAR_x ($304.50 in chips) 
Seat 3: Y-Yx777 ($743.51 in chips) 
Seat 4: patapong ($666.72 in chips) 
Seat 5: shevliak ($298.80 in chips) 
Seat 6: LuckyBiitch ($600 in chips) 
LuckyBiitch: posts small blind $3
x_QUIXTAR_x: posts big blind $6
*** HOLE CARDS ***
Y-Yx777: raises $6 to $12
patapong: folds 
shevliak: folds 
LuckyBiitch: raises $33 to $45
x_QUIXTAR_x: folds 
Y-Yx777: folds 
Uncalled bet ($33) returned to LuckyBiitch
LuckyBiitch collected $30 from pot
LuckyBiitch: doesn't show hand 
*** SUMMARY ***
Total pot $30 | Rake $0 
Seat 1: x_QUIXTAR_x (big blind) folded before Flop
Seat 3: Y-Yx777 folded before Flop
Seat 4: patapong folded before Flop (didn't bet)
Seat 5: shevliak (button) folded before Flop (didn't bet)
Seat 6: LuckyBiitch (small blind) collected ($30)


PokerStars Game #102609863877:  Hold'em No Limit ($3/$6 USD) - 2013/08/11 11:46:13 ET
Table 'Cydonia IX 40-100 bb' 6-max Seat #6 is the button
Seat 1: x_QUIXTAR_x ($300 in chips) 
Seat 3: Y-Yx777 ($731.51 in chips) 
Seat 4: patapong ($666.72 in chips) 
Seat 5: shevliak ($298.80 in chips) 
Seat 6: LuckyBiitch ($618 in chips) 
x_QUIXTAR_x: posts small blind $3
Y-Yx777: posts big blind $6
*** HOLE CARDS ***
patapong: folds 
shevliak: folds 
LuckyBiitch: raises $6 to $12
x_QUIXTAR_x: raises $24 to $36
Y-Yx777: folds 
LuckyBiitch: calls $24
*** FLOP *** [Th Jh 6s]
x_QUIXTAR_x: bets $30
LuckyBiitch: raises $50 to $80
x_QUIXTAR_x: folds 
Uncalled bet ($50) returned to LuckyBiitch
LuckyBiitch collected $135.20 from pot
LuckyBiitch: doesn't show hand 
*** SUMMARY ***
Total pot $138 | Rake $2.80 
Board [Th Jh 6s]
Seat 1: x_QUIXTAR_x (small blind) folded on the Flop
Seat 3: Y-Yx777 (big blind) folded before Flop
Seat 4: patapong folded before Flop (didn't bet)
Seat 5: shevliak folded before Flop (didn't bet)
Seat 6: LuckyBiitch (button) collected ($135.20)


PokerStars Game #102609895214:  Hold'em No Limit ($3/$6 USD) - 2013/08/11 11:46:57 ET
Table 'Cydonia IX 40-100 bb' 6-max Seat #1 is the button
Seat 1: x_QUIXTAR_x ($300 in chips) 
Seat 3: Y-Yx777 ($725.51 in chips) 
Seat 4: patapong ($666.72 in chips) 
Seat 5: shevliak ($298.80 in chips) 
Seat 6: LuckyBiitch ($687.20 in chips) 
ilir3 will be allowed to play after the button
Y-Yx777: posts small blind $3
patapong: posts big blind $6
*** HOLE CARDS ***
shevliak: folds 
LuckyBiitch: folds 
x_QUIXTAR_x: raises $7.50 to $13.50
Y-Yx777: folds 
patapong: folds 
Uncalled bet ($7.50) returned to x_QUIXTAR_x
x_QUIXTAR_x collected $15 from pot
x_QUIXTAR_x: doesn't show hand 
*** SUMMARY ***
Total pot $15 | Rake $0 
Seat 1: x_QUIXTAR_x (button) collected ($15)
Seat 3: Y-Yx777 (small blind) folded before Flop
Seat 4: patapong (big blind) folded before Flop
Seat 5: shevliak folded before Flop (didn't bet)
Seat 6: LuckyBiitch folded before Flop (didn't bet)


PokerStars Game #102609907938:  Hold'em No Limit ($3/$6 USD) - 2013/08/11 11:47:14 ET
Table 'Cydonia IX 40-100 bb' 6-max Seat #3 is the button
Seat 1: x_QUIXTAR_x ($309 in chips) 
Seat 3: Y-Yx777 ($722.51 in chips) 
Seat 4: patapong ($660.72 in chips) 
Seat 5: shevliak ($298.80 in chips) 
Seat 6: LuckyBiitch ($687.20 in chips) 
patapong: posts small blind $3
shevliak: posts big blind $6
ilir3: sits out 
*** HOLE CARDS ***
LuckyBiitch: folds 
x_QUIXTAR_x: folds 
Y-Yx777: raises $6 to $12
patapong: folds 
shevliak: folds 
Uncalled bet ($6) returned to Y-Yx777
Y-Yx777 collected $15 from pot
*** SUMMARY ***
Total pot $15 | Rake $0 
Seat 1: x_QUIXTAR_x folded before Flop (didn't bet)
Seat 3: Y-Yx777 (button) collected ($15)
Seat 4: patapong (small blind) folded before Flop
Seat 5: shevliak (big blind) folded before Flop
Seat 6: LuckyBiitch folded before Flop (didn't bet)


PokerStars Game #102609933486:  Hold'em No Limit ($3/$6 USD) - 2013/08/11 11:47:51 ET
Table 'Cydonia IX 40-100 bb' 6-max Seat #4 is the button
Seat 1: x_QUIXTAR_x ($309 in chips) 
Seat 3: Y-Yx777 ($731.51 in chips) 
Seat 4: patapong ($657.72 in chips) 
Seat 5: shevliak ($292.80 in chips) 
Seat 6: LuckyBiitch ($687.20 in chips) 
shevliak: posts small blind $3
LuckyBiitch: posts big blind $6
ilir3: sits out 
*** HOLE CARDS ***
x_QUIXTAR_x: folds 
Y-Yx777: folds 
patapong: raises $6 to $12
shevliak: folds 
LuckyBiitch: folds 
Uncalled bet ($6) returned to patapong
patapong collected $15 from pot
*** SUMMARY ***
Total pot $15 | Rake $0 
Seat 1: x_QUIXTAR_x folded before Flop (didn't bet)
Seat 3: Y-Yx777 folded before Flop (didn't bet)
Seat 4: patapong (button) collected ($15)
Seat 5: shevliak (small blind) folded before Flop
Seat 6: LuckyBiitch (big blind) folded before Flop


PokerStars Game #102609951526:  Hold'em No Limit ($3/$6 USD) - 2013/08/11 11:48:16 ET
Table 'Cydonia IX 40-100 bb' 6-max Seat #5 is the button
Seat 1: x_QUIXTAR_x ($309 in chips) 
Seat 3: Y-Yx777 ($731.51 in chips) 
Seat 4: patapong ($666.72 in chips) 
Seat 5: shevliak ($289.80 in chips) 
Seat 6: LuckyBiitch ($681.20 in chips) 
LuckyBiitch: posts small blind $3
x_QUIXTAR_x: posts big blind $6
ilir3: sits out 
*** HOLE CARDS ***
Y-Yx777: folds 
patapong: folds 
shevliak: raises $6 to $12
LuckyBiitch: raises $26 to $38
x_QUIXTAR_x: calls $32
shevliak: raises $251.80 to $289.80 and is all-in
LuckyBiitch: folds 
x_QUIXTAR_x: calls $251.80
*** FIRST FLOP *** [Qh Jh 5d]
*** FIRST TURN *** [Qh Jh 5d] [7d]
*** FIRST RIVER *** [Qh Jh 5d 7d] [Td]
*** SECOND FLOP *** [9h 7h 2d]
*** SECOND TURN *** [9h 7h 2d] [Jd]
*** SECOND RIVER *** [9h 7h 2d Jd] [4d]
*** FIRST SHOW DOWN ***
x_QUIXTAR_x: shows [As Ah] (a pair of Aces)
shevliak: shows [Ks Ac] (a straight, Ten to Ace)
shevliak collected $307.40 from pot
*** SECOND SHOW DOWN ***
x_QUIXTAR_x: shows [As Ah] (a pair of Aces)
shevliak: shows [Ks Ac] (high card Ace)
x_QUIXTAR_x collected $307.40 from pot
*** SUMMARY ***
Total pot $617.60 | Rake $2.80 
Hand was run twice
FIRST Board [Qh Jh 5d 7d Td]
SECOND Board [9h 7h 2d Jd 4d]
Seat 1: x_QUIXTAR_x (big blind) showed [As Ah] and lost with a pair of Aces, and won ($307.40) with a pair of Aces
Seat 3: Y-Yx777 folded before Flop (didn't bet)
Seat 4: patapong folded before Flop (didn't bet)
Seat 5: shevliak (button) showed [Ks Ac] and won ($307.40) with a straight, Ten to Ace, and lost with high card Ace
Seat 6: LuckyBiitch (small blind) folded before Flop


PokerStars Game #102609997628:  Hold'em No Limit ($3/$6 USD) - 2013/08/11 11:49:22 ET
Table 'Cydonia IX 40-100 bb' 6-max Seat #6 is the button
Seat 1: x_QUIXTAR_x ($326.60 in chips) 
Seat 2: ilir3 ($650.70 in chips) 
Seat 3: Y-Yx777 ($731.51 in chips) 
Seat 4: patapong ($666.72 in chips) 
Seat 5: shevliak ($307.40 in chips) 
Seat 6: LuckyBiitch ($643.20 in chips) 
x_QUIXTAR_x: posts small blind $3
ilir3: posts big blind $6
*** HOLE CARDS ***
Y-Yx777: folds 
patapong: folds 
shevliak: folds 
LuckyBiitch: folds 
x_QUIXTAR_x: raises $7.50 to $13.50
ilir3: folds 
Uncalled bet ($7.50) returned to x_QUIXTAR_x
x_QUIXTAR_x collected $12 from pot
x_QUIXTAR_x: doesn't show hand 
*** SUMMARY ***
Total pot $12 | Rake $0 
Seat 1: x_QUIXTAR_x (small blind) collected ($12)
Seat 2: ilir3 (big blind) folded before Flop
Seat 3: Y-Yx777 folded before Flop (didn't bet)
Seat 4: patapong folded before Flop (didn't bet)
Seat 5: shevliak folded before Flop (didn't bet)
Seat 6: LuckyBiitch (button) folded before Flop (didn't bet)


PokerStars Game #102609609628:  Hold'em No Limit ($3/$6 USD) - 2013/08/11 11:40:15 ET
Table 'Cydonia IX 40-100 bb' 6-max Seat #2 is the button
Seat 1: x_QUIXTAR_x ($300 in chips) 
Seat 2: ilir3 ($650.70 in chips) 
Seat 3: Y-Yx777 ($707.31 in chips) 
Seat 4: patapong ($634.38 in chips) 
Seat 6: LuckyBiitch ($650.84 in chips) 
Y-Yx777: posts small blind $3
patapong: posts big blind $6
*** HOLE CARDS ***
LuckyBiitch: folds 
x_QUIXTAR_x: folds 
ilir3: folds 
Y-Yx777: raises $6 to $12
patapong: calls $6
*** FLOP *** [5h Ad 3c]
Y-Yx777: bets $12
patapong: raises $18 to $30
Y-Yx777: folds 
Uncalled bet ($18) returned to patapong
patapong collected $45.84 from pot
*** SUMMARY ***
Total pot $48 | Rake $2.16 
Board [5h Ad 3c]
Seat 1: x_QUIXTAR_x folded before Flop (didn't bet)
Seat 2: ilir3 (button) folded before Flop (didn't bet)
Seat 3: Y-Yx777 (small blind) folded on the Flop
Seat 4: patapong (big blind) collected ($45.84)
Seat 6: LuckyBiitch folded before Flop (didn't bet)


PokerStars Game #102609649418:  Hold'em No Limit ($3/$6 USD) - 2013/08/11 11:41:11 ET
Table 'Cydonia IX 40-100 bb' 6-max Seat #3 is the button
Seat 1: x_QUIXTAR_x ($300 in chips) 
Seat 3: Y-Yx777 ($683.31 in chips) 
Seat 4: patapong ($656.22 in chips) 
Seat 5: shevliak ($268.60 in chips) 
Seat 6: LuckyBiitch ($650.84 in chips) 
patapong: posts small blind $3
shevliak: posts big blind $6
*** HOLE CARDS ***
LuckyBiitch: folds 
x_QUIXTAR_x: folds 
Y-Yx777: raises $6 to $12
patapong: folds 
shevliak: raises $30 to $42
Y-Yx777: calls $30
*** FLOP *** [Jc Ks Td]
shevliak: bets $53.88
Y-Yx777: folds 
Uncalled bet ($53.88) returned to shevliak
shevliak collected $84.20 from pot
shevliak: doesn't show hand 
*** SUMMARY ***
Total pot $87 | Rake $2.80 
Board [Jc Ks Td]
Seat 1: x_QUIXTAR_x folded before Flop (didn't bet)
Seat 3: Y-Yx777 (button) folded on the Flop
Seat 4: patapong (small blind) folded before Flop
Seat 5: shevliak (big blind) collected ($84.20)
Seat 6: LuckyBiitch folded before Flop (didn't bet)


PokerStars Game #102609676703:  Hold'em No Limit ($3/$6 USD) - 2013/08/11 11:41:49 ET
Table 'Cydonia IX 40-100 bb' 6-max Seat #4 is the button
Seat 1: x_QUIXTAR_x ($300 in chips) 
Seat 3: Y-Yx777 ($641.31 in chips) 
Seat 4: patapong ($653.22 in chips) 
Seat 5: shevliak ($310.80 in chips) 
Seat 6: LuckyBiitch ($650.84 in chips) 
shevliak: posts small blind $3
LuckyBiitch: posts big blind $6
*** HOLE CARDS ***
x_QUIXTAR_x: folds 
Y-Yx777: raises $6 to $12
patapong: folds 
shevliak: folds 
LuckyBiitch: folds 
Uncalled bet ($6) returned to Y-Yx777
Y-Yx777 collected $15 from pot
*** SUMMARY ***
Total pot $15 | Rake $0 
Seat 1: x_QUIXTAR_x folded before Flop (didn't bet)
Seat 3: Y-Yx777 collected ($15)
Seat 4: patapong (button) folded before Flop (didn't bet)
Seat 5: shevliak (small blind) folded before Flop
Seat 6: LuckyBiitch (big blind) folded before Flop


PokerStars Game #102609695382:  Hold'em No Limit ($3/$6 USD) - 2013/08/11 11:42:16 ET
Table 'Cydonia IX 40-100 bb' 6-max Seat #5 is the button
Seat 1: x_QUIXTAR_x ($300 in chips) 
Seat 3: Y-Yx777 ($650.31 in chips) 
Seat 4: patapong ($653.22 in chips) 
Seat 5: shevliak ($307.80 in chips) 
Seat 6: LuckyBiitch ($644.84 in chips) 
LuckyBiitch: posts small blind $3
x_QUIXTAR_x: posts big blind $6
*** HOLE CARDS ***
Y-Yx777: folds 
patapong: folds 
shevliak: folds 
LuckyBiitch: raises $12 to $18
x_QUIXTAR_x: calls $12
*** FLOP *** [9s 4h 9h]
LuckyBiitch: bets $22
x_QUIXTAR_x: folds 
Uncalled bet ($22) returned to LuckyBiitch
LuckyBiitch collected $34.38 from pot
LuckyBiitch: doesn't show hand 
*** SUMMARY ***
Total pot $36 | Rake $1.62 
Board [9s 4h 9h]
Seat 1: x_QUIXTAR_x (big blind) folded on the Flop
Seat 3: Y-Yx777 folded before Flop (didn't bet)
Seat 4: patapong folded before Flop (didn't bet)
Seat 5: shevliak (button) folded before Flop (didn't bet)
Seat 6: LuckyBiitch (small blind) collected ($34.38)


PokerStars Game #102609713968:  Hold'em No Limit ($3/$6 USD) - 2013/08/11 11:42:42 ET
Table 'Cydonia IX 40-100 bb' 6-max Seat #6 is the button
Seat 1: x_QUIXTAR_x ($300 in chips) 
Seat 3: Y-Yx777 ($650.31 in chips) 
Seat 4: patapong ($653.22 in chips) 
Seat 5: shevliak ($307.80 in chips) 
Seat 6: LuckyBiitch ($661.22 in chips) 
x_QUIXTAR_x: posts small blind $3
Y-Yx777: posts big blind $6
*** HOLE CARDS ***
patapong: folds 
shevliak: folds 
LuckyBiitch: raises $6 to $12
x_QUIXTAR_x: raises $163 to $175
Y-Yx777: folds 
LuckyBiitch: folds 
Uncalled bet ($163) returned to x_QUIXTAR_x
x_QUIXTAR_x collected $30 from pot
x_QUIXTAR_x: doesn't show hand 
*** SUMMARY ***
Total pot $30 | Rake $0 
Seat 1: x_QUIXTAR_x (small blind) collected ($30)
Seat 3: Y-Yx777 (big blind) folded before Flop
Seat 4: patapong folded before Flop (didn't bet)
Seat 5: shevliak folded before Flop (didn't bet)
Seat 6: LuckyBiitch (button) folded before Flop


PokerStars Game #102609753794:  Hold'em No Limit ($3/$6 USD) - 2013/08/11 11:43:38 ET
Table 'Cydonia IX 40-100 bb' 6-max Seat #1 is the button
Seat 1: x_QUIXTAR_x ($318 in chips) 
Seat 3: Y-Yx777 ($644.31 in chips) 
Seat 4: patapong ($653.22 in chips) 
Seat 5: shevliak ($307.80 in chips) 
Seat 6: LuckyBiitch ($649.22 in chips) 
Y-Yx777: posts small blind $3
patapong: posts big blind $6
*** HOLE CARDS ***
shevliak: folds 
LuckyBiitch: raises $12 to $18
x_QUIXTAR_x: folds 
Y-Yx777: calls $15
patapong: folds 
*** FLOP *** [Qs 8h 5h]
Y-Yx777: checks 
LuckyBiitch: bets $24
Y-Yx777: calls $24
*** TURN *** [Qs 8h 5h] [Qh]
Y-Yx777: checks 
LuckyBiitch: bets $45
Y-Yx777: raises $63 to $108
LuckyBiitch: folds 
Uncalled bet ($63) returned to Y-Yx777
Y-Yx777 collected $177.20 from pot
*** SUMMARY ***
Total pot $180 | Rake $2.80 
Board [Qs 8h 5h Qh]
Seat 1: x_QUIXTAR_x (button) folded before Flop (didn't bet)
Seat 3: Y-Yx777 (small blind) collected ($177.20)
Seat 4: patapong (big blind) folded before Flop
Seat 5: shevliak folded before Flop (didn't bet)
Seat 6: LuckyBiitch folded on the Turn


PokerStars Game #102609797232:  Hold'em No Limit ($3/$6 USD) - 2013/08/11 11:44:40 ET
Table 'Cydonia IX 40-100 bb' 6-max Seat #3 is the button
Seat 1: x_QUIXTAR_x ($318 in chips) 
Seat 3: Y-Yx777 ($734.51 in chips) 
Seat 4: patapong ($647.22 in chips) 
Seat 5: shevliak ($307.80 in chips) 
Seat 6: LuckyBiitch ($600 in chips) 
patapong: posts small blind $3
shevliak: posts big blind $6
*** HOLE CARDS ***
LuckyBiitch: folds 
x_QUIXTAR_x: raises $7.50 to $13.50
Y-Yx777: folds 
patapong: raises $30 to $43.50
shevliak: folds 
x_QUIXTAR_x: folds 
Uncalled bet ($30) returned to patapong
patapong collected $33 from pot
*** SUMMARY ***
Total pot $33 | Rake $0 
Seat 1: x_QUIXTAR_x folded before Flop
Seat 3: Y-Yx777 (button) folded before Flop (didn't bet)
Seat 4: patapong (small blind) collected ($33)
Seat 5: shevliak (big blind) folded before Flop
Seat 6: LuckyBiitch folded before Flop (didn't bet)


PokerStars Game #102609403644:  Hold'em No Limit ($3/$6 USD) - 2013/08/11 11:35:27 ET
Table 'Cydonia IX 40-100 bb' 6-max Seat #1 is the button
Seat 1: x_QUIXTAR_x ($332 in chips) 
Seat 2: ilir3 ($637.86 in chips) 
Seat 3: Y-Yx777 ($653.11 in chips) 
Seat 4: patapong ($613.38 in chips) 
Seat 6: LuckyBiitch ($646.34 in chips) 
ilir3: posts small blind $3
Y-Yx777: posts big blind $6
*** HOLE CARDS ***
patapong: folds 
LuckyBiitch: folds 
x_QUIXTAR_x: folds 
ilir3: calls $3
Y-Yx777: checks 
*** FLOP *** [Ad 5c 4s]
ilir3: bets $6
Y-Yx777: calls $6
*** TURN *** [Ad 5c 4s] [Kd]
ilir3: checks 
Y-Yx777: bets $12
ilir3: calls $12
*** RIVER *** [Ad 5c 4s Kd] [8d]
ilir3: checks 
Y-Yx777: checks 
*** SHOW DOWN ***
ilir3: shows [8s 8h] (three of a kind, Eights)
Y-Yx777: mucks hand 
ilir3 collected $45.84 from pot
*** SUMMARY ***
Total pot $48 | Rake $2.16 
Board [Ad 5c 4s Kd 8d]
Seat 1: x_QUIXTAR_x (button) folded before Flop (didn't bet)
Seat 2: ilir3 (small blind) showed [8s 8h] and won ($45.84) with three of a kind, Eights
Seat 3: Y-Yx777 (big blind) mucked
Seat 4: patapong folded before Flop (didn't bet)
Seat 6: LuckyBiitch folded before Flop (didn't bet)


PokerStars Game #102609437528:  Hold'em No Limit ($3/$6 USD) - 2013/08/11 11:36:14 ET
Table 'Cydonia IX 40-100 bb' 6-max Seat #2 is the button
Seat 1: x_QUIXTAR_x ($332 in chips) 
Seat 2: ilir3 ($659.70 in chips) 
Seat 3: Y-Yx777 ($629.11 in chips) 
Seat 4: patapong ($613.38 in chips) 
Seat 6: LuckyBiitch ($646.34 in chips) 
Y-Yx777: posts small blind $3
patapong: posts big blind $6
*** HOLE CARDS ***
LuckyBiitch: folds 
x_QUIXTAR_x: raises $7.50 to $13.50
ilir3: folds 
Y-Yx777: calls $10.50
patapong: raises $40.50 to $54
x_QUIXTAR_x: folds 
Y-Yx777: folds 
Uncalled bet ($40.50) returned to patapong
patapong collected $40.50 from pot
*** SUMMARY ***
Total pot $40.50 | Rake $0 
Seat 1: x_QUIXTAR_x folded before Flop
Seat 2: ilir3 (button) folded before Flop (didn't bet)
Seat 3: Y-Yx777 (small blind) folded before Flop
Seat 4: patapong (big blind) collected ($40.50)
Seat 6: LuckyBiitch folded before Flop (didn't bet)


PokerStars Game #102609458824:  Hold'em No Limit ($3/$6 USD) - 2013/08/11 11:36:44 ET
Table 'Cydonia IX 40-100 bb' 6-max Seat #3 is the button
Seat 1: x_QUIXTAR_x ($318.50 in chips) 
Seat 2: ilir3 ($659.70 in chips) 
Seat 3: Y-Yx777 ($615.61 in chips) 
Seat 4: patapong ($640.38 in chips) 
Seat 6: LuckyBiitch ($646.34 in chips) 
patapong: posts small blind $3
LuckyBiitch: posts big blind $6
*** HOLE CARDS ***
x_QUIXTAR_x: raises $7.50 to $13.50
ilir3: folds 
Y-Yx777: folds 
patapong: folds 
LuckyBiitch: calls $7.50
*** FLOP *** [Jc 8h 5d]
LuckyBiitch: checks 
x_QUIXTAR_x: bets $12
LuckyBiitch: folds 
Uncalled bet ($12) returned to x_QUIXTAR_x
x_QUIXTAR_x collected $28.65 from pot
x_QUIXTAR_x: doesn't show hand 
*** SUMMARY ***
Total pot $30 | Rake $1.35 
Board [Jc 8h 5d]
Seat 1: x_QUIXTAR_x collected ($28.65)
Seat 2: ilir3 folded before Flop (didn't bet)
Seat 3: Y-Yx777 (button) folded before Flop (didn't bet)
Seat 4: patapong (small blind) folded before Flop
Seat 6: LuckyBiitch (big blind) folded on the Flop


PokerStars Game #102609490426:  Hold'em No Limit ($3/$6 USD) - 2013/08/11 11:37:28 ET
Table 'Cydonia IX 40-100 bb' 6-max Seat #4 is the button
Seat 1: x_QUIXTAR_x ($333.65 in chips) 
Seat 2: ilir3 ($659.70 in chips) 
Seat 3: Y-Yx777 ($615.61 in chips) 
Seat 4: patapong ($637.38 in chips) 
Seat 6: LuckyBiitch ($632.84 in chips) 
LuckyBiitch: posts small blind $3
x_QUIXTAR_x: posts big blind $6
*** HOLE CARDS ***
ilir3: folds 
Y-Yx777: folds 
patapong: raises $6 to $12
LuckyBiitch: raises $33 to $45
x_QUIXTAR_x: folds 
patapong: folds 
Uncalled bet ($33) returned to LuckyBiitch
LuckyBiitch collected $30 from pot
LuckyBiitch: doesn't show hand 
*** SUMMARY ***
Total pot $30 | Rake $0 
Seat 1: x_QUIXTAR_x (big blind) folded before Flop
Seat 2: ilir3 folded before Flop (didn't bet)
Seat 3: Y-Yx777 folded before Flop (didn't bet)
Seat 4: patapong (button) folded before Flop
Seat 6: LuckyBiitch (small blind) collected ($30)


PokerStars Game #102609523860:  Hold'em No Limit ($3/$6 USD) - 2013/08/11 11:38:14 ET
Table 'Cydonia IX 40-100 bb' 6-max Seat #6 is the button
Seat 1: x_QUIXTAR_x ($327.65 in chips) 
Seat 2: ilir3 ($659.70 in chips) 
Seat 3: Y-Yx777 ($615.61 in chips) 
Seat 4: patapong ($625.38 in chips) 
Seat 6: LuckyBiitch ($650.84 in chips) 
x_QUIXTAR_x: posts small blind $3
ilir3: posts big blind $6
*** HOLE CARDS ***
Y-Yx777: folds 
patapong: raises $9 to $15
LuckyBiitch: folds 
x_QUIXTAR_x: folds 
ilir3: folds 
Uncalled bet ($9) returned to patapong
patapong collected $15 from pot
*** SUMMARY ***
Total pot $15 | Rake $0 
Seat 1: x_QUIXTAR_x (small blind) folded before Flop
Seat 2: ilir3 (big blind) folded before Flop
Seat 3: Y-Yx777 folded before Flop (didn't bet)
Seat 4: patapong collected ($15)
Seat 6: LuckyBiitch (button) folded before Flop (didn't bet)


PokerStars Game #102609539932:  Hold'em No Limit ($3/$6 USD) - 2013/08/11 11:38:37 ET
Table 'Cydonia IX 40-100 bb' 6-max Seat #1 is the button
Seat 1: x_QUIXTAR_x ($324.65 in chips) 
Seat 2: ilir3 ($653.70 in chips) 
Seat 3: Y-Yx777 ($615.61 in chips) 
Seat 4: patapong ($634.38 in chips) 
Seat 6: LuckyBiitch ($650.84 in chips) 
ilir3: posts small blind $3
Y-Yx777: posts big blind $6
*** HOLE CARDS ***
patapong: folds 
LuckyBiitch: folds 
x_QUIXTAR_x: raises $7.50 to $13.50
ilir3: folds 
Y-Yx777 is connected 
Y-Yx777: calls $7.50
*** FLOP *** [Kd 9d 6h]
Y-Yx777: checks 
x_QUIXTAR_x: bets $18
Y-Yx777: calls $18
*** TURN *** [Kd 9d 6h] [Ah]
Y-Yx777: checks 
x_QUIXTAR_x: bets $24
Y-Yx777: raises $36 to $60
x_QUIXTAR_x: calls $36
*** RIVER *** [Kd 9d 6h Ah] [7h]
Y-Yx777: bets $102
x_QUIXTAR_x: folds 
Uncalled bet ($102) returned to Y-Yx777
Y-Yx777 collected $183.20 from pot
*** SUMMARY ***
Total pot $186 | Rake $2.80 
Board [Kd 9d 6h Ah 7h]
Seat 1: x_QUIXTAR_x (button) folded on the River
Seat 2: ilir3 (small blind) folded before Flop
Seat 3: Y-Yx777 (big blind) collected ($183.20)
Seat 4: patapong folded before Flop (didn't bet)
Seat 6: LuckyBiitch folded before Flop (didn't bet)


PokerStars Game #102610809806:  Hold'em No Limit ($3/$6 USD) - 2013/08/11 12:10:04 ET
Table 'Cydonia IX 40-100 bb' 6-max Seat #2 is the button
Seat 1: x_QUIXTAR_x ($500.20 in chips) 
Seat 2: ilir3 ($600 in chips) 
Seat 3: Y-Yx777 ($1121.61 in chips) 
Seat 4: patapong ($600 in chips) 
Seat 5: shevliak ($518.53 in chips) 
Y-Yx777: posts small blind $3
patapong: posts big blind $6
*** HOLE CARDS ***
shevliak: folds 
x_QUIXTAR_x: folds 
ilir3: raises $6 to $12
Y-Yx777: calls $9
patapong: calls $6
*** FLOP *** [5s 4c Qh]
Y-Yx777: checks 
patapong: checks 
ilir3: bets $24
Y-Yx777: calls $24
patapong: folds 
*** TURN *** [5s 4c Qh] [3c]
Y-Yx777: checks 
ilir3: checks 
*** RIVER *** [5s 4c Qh 3c] [7h]
Y-Yx777: checks 
ilir3: checks 
*** SHOW DOWN ***
Y-Yx777: shows [Qc 2c] (a pair of Queens)
ilir3: mucks hand 
Y-Yx777 collected $81.20 from pot
*** SUMMARY ***
Total pot $84 | Rake $2.80 
Board [5s 4c Qh 3c 7h]
Seat 1: x_QUIXTAR_x folded before Flop (didn't bet)
Seat 2: ilir3 (button) mucked
Seat 3: Y-Yx777 (small blind) showed [Qc 2c] and won ($81.20) with a pair of Queens
Seat 4: patapong (big blind) folded on the Flop
Seat 5: shevliak folded before Flop (didn't bet)


PokerStars Game #102610843519:  Hold'em No Limit ($3/$6 USD) - 2013/08/11 12:10:51 ET
Table 'Cydonia IX 40-100 bb' 6-max Seat #3 is the button
Seat 1: x_QUIXTAR_x ($500.20 in chips) 
Seat 2: ilir3 ($600 in chips) 
Seat 3: Y-Yx777 ($1166.81 in chips) 
Seat 4: patapong ($600 in chips) 
Seat 5: shevliak ($518.53 in chips) 
patapong: posts small blind $3
shevliak: posts big blind $6
*** HOLE CARDS ***
x_QUIXTAR_x: folds 
ilir3: folds 
Y-Yx777: folds 
patapong: calls $3
shevliak: raises $12 to $18
patapong: calls $12
*** FLOP *** [5d 7h Th]
patapong: checks 
shevliak: bets $22
patapong: raises $38 to $60
shevliak: raises $51 to $111
patapong: calls $51
*** TURN *** [5d 7h Th] [2c]
patapong: checks 
shevliak: bets $177
patapong: folds 
Uncalled bet ($177) returned to shevliak
shevliak collected $255.20 from pot
shevliak: doesn't show hand 
*** SUMMARY ***
Total pot $258 | Rake $2.80 
Board [5d 7h Th 2c]
Seat 1: x_QUIXTAR_x folded before Flop (didn't bet)
Seat 2: ilir3 folded before Flop (didn't bet)
Seat 3: Y-Yx777 (button) folded before Flop (didn't bet)
Seat 4: patapong (small blind) folded on the Turn
Seat 5: shevliak (big blind) collected ($255.20)


PokerStars Game #102610890165:  Hold'em No Limit ($3/$6 USD) - 2013/08/11 12:11:55 ET
Table 'Cydonia IX 40-100 bb' 6-max Seat #4 is the button
Seat 1: x_QUIXTAR_x ($500.20 in chips) 
Seat 2: ilir3 ($600 in chips) 
Seat 3: Y-Yx777 ($1166.81 in chips) 
Seat 4: patapong ($600 in chips) 
Seat 5: shevliak ($644.73 in chips) 
shevliak: posts small blind $3
x_QUIXTAR_x: posts big blind $6
*** HOLE CARDS ***
ilir3: folds 
Y-Yx777: folds 
patapong: raises $6 to $12
shevliak: folds 
x_QUIXTAR_x: raises $24 to $36
patapong: calls $24
*** FLOP *** [7d 4s Kd]
x_QUIXTAR_x: bets $50
patapong: calls $50
*** TURN *** [7d 4s Kd] [4d]
x_QUIXTAR_x: bets $125
patapong said, "plz dont fold ok"
patapong: raises $389 to $514 and is all-in
x_QUIXTAR_x: calls $289.20 and is all-in
Uncalled bet ($99.80) returned to patapong
*** FIRST RIVER *** [7d 4s Kd 4d] [3c]
*** SECOND RIVER *** [7d 4s Kd 4d] [5c]
*** FIRST SHOW DOWN ***
x_QUIXTAR_x: shows [Ks Kh] (a full house, Kings full of Fours)
patapong: mucks hand 
x_QUIXTAR_x said, "i think u lose this one"
x_QUIXTAR_x collected $500.30 from pot
*** SECOND SHOW DOWN ***
x_QUIXTAR_x: shows [Ks Kh] (a full house, Kings full of Fours)
patapong: mucks hand 
x_QUIXTAR_x collected $500.30 from pot
*** SUMMARY ***
Total pot $1003.40 | Rake $2.80 
Hand was run twice
FIRST Board [7d 4s Kd 4d 3c]
SECOND Board [7d 4s Kd 4d 5c]
Seat 1: x_QUIXTAR_x (big blind) showed [Ks Kh] and won ($500.30) with a full house, Kings full of Fours, and won ($500.30) with a full house, Kings full of Fours
Seat 2: ilir3 folded before Flop (didn't bet)
Seat 3: Y-Yx777 folded before Flop (didn't bet)
Seat 4: patapong (button) mucked
Seat 5: shevliak (small blind) folded before Flop


PokerStars Game #102610953634:  Hold'em No Limit ($3/$6 USD) - 2013/08/11 12:13:23 ET
Table 'Cydonia IX 40-100 bb' 6-max Seat #5 is the button
Seat 1: x_QUIXTAR_x ($1000.60 in chips) 
Seat 2: ilir3 ($600 in chips) 
Seat 3: Y-Yx777 ($1166.81 in chips) 
Seat 4: patapong ($600 in chips) 
Seat 5: shevliak ($641.73 in chips) 
x_QUIXTAR_x: posts small blind $3
ilir3: posts big blind $6
*** HOLE CARDS ***
patapong said, ":("
Y-Yx777: raises $6 to $12
patapong: folds 
shevliak: folds 
x_QUIXTAR_x: folds 
ilir3: folds 
Uncalled bet ($6) returned to Y-Yx777
Y-Yx777 collected $15 from pot
patapong said, "thats a big bet"
*** SUMMARY ***
Total pot $15 | Rake $0 
Seat 1: x_QUIXTAR_x (small blind) folded before Flop
Seat 2: ilir3 (big blind) folded before Flop
Seat 3: Y-Yx777 collected ($15)
Seat 4: patapong folded before Flop (didn't bet)
Seat 5: shevliak (button) folded before Flop (didn't bet)


PokerStars Game #102610966381:  Hold'em No Limit ($3/$6 USD) - 2013/08/11 12:13:40 ET
Table 'Cydonia IX 40-100 bb' 6-max Seat #1 is the button
Seat 1: x_QUIXTAR_x ($997.60 in chips) 
Seat 2: ilir3 ($600 in chips) 
Seat 3: Y-Yx777 ($1175.81 in chips) 
Seat 4: patapong ($600 in chips) 
Seat 5: shevliak ($641.73 in chips) 
ilir3: posts small blind $3
Y-Yx777: posts big blind $6
*** HOLE CARDS ***
patapong said, "for a big boat!"
patapong: folds 
shevliak: raises $9 to $15
x_QUIXTAR_x: folds 
ilir3: folds 
Y-Yx777: calls $9
*** FLOP *** [Qs 9d 5c]
Y-Yx777: checks 
shevliak: bets $17.02
x_QUIXTAR_x said, "i have two big nipple boats"
Y-Yx777: calls $17.02
*** TURN *** [Qs 9d 5c] [3s]
ilir3 said, "4/10"
Y-Yx777: checks 
patapong said, "^^"
shevliak: checks 
*** RIVER *** [Qs 9d 5c 3s] [Jh]
Y-Yx777: bets $54
shevliak: folds 
Uncalled bet ($54) returned to Y-Yx777
Y-Yx777 collected $64.24 from pot
*** SUMMARY ***
Total pot $67.04 | Rake $2.80 
Board [Qs 9d 5c 3s Jh]
Seat 1: x_QUIXTAR_x (button) folded before Flop (didn't bet)
Seat 2: ilir3 (small blind) folded before Flop
Seat 3: Y-Yx777 (big blind) collected ($64.24)
Seat 4: patapong folded before Flop (didn't bet)
Seat 5: shevliak folded on the River


PokerStars Game #102611013467:  Hold'em No Limit ($3/$6 USD) - 2013/08/11 12:14:45 ET
Table 'Cydonia IX 40-100 bb' 6-max Seat #2 is the button
Seat 1: x_QUIXTAR_x ($997.60 in chips) 
Seat 2: ilir3 ($600 in chips) 
Seat 3: Y-Yx777 ($1208.03 in chips) 
Seat 4: patapong ($600 in chips) 
Seat 5: shevliak ($609.71 in chips) 
Y-Yx777: posts small blind $3
patapong: posts big blind $6
*** HOLE CARDS ***
shevliak: folds 
x_QUIXTAR_x: raises $7.50 to $13.50
ilir3: folds 
Y-Yx777: calls $10.50
patapong: raises $58.50 to $72
x_QUIXTAR_x: calls $58.50
Y-Yx777: folds 
*** FLOP *** [5s 2c Ts]
patapong: checks 
x_QUIXTAR_x: checks 
*** TURN *** [5s 2c Ts] [6c]
patapong: checks 
x_QUIXTAR_x: bets $100
patapong: folds 
Uncalled bet ($100) returned to x_QUIXTAR_x
x_QUIXTAR_x collected $154.70 from pot
x_QUIXTAR_x: doesn't show hand 
*** SUMMARY ***
Total pot $157.50 | Rake $2.80 
Board [5s 2c Ts 6c]
Seat 1: x_QUIXTAR_x collected ($154.70)
Seat 2: ilir3 (button) folded before Flop (didn't bet)
Seat 3: Y-Yx777 (small blind) folded before Flop
Seat 4: patapong (big blind) folded on the Turn
Seat 5: shevliak folded before Flop (didn't bet)


PokerStars Game #102610603648:  Hold'em No Limit ($3/$6 USD) - 2013/08/11 12:05:21 ET
Table 'Cydonia IX 40-100 bb' 6-max Seat #1 is the button
Seat 1: x_QUIXTAR_x ($356.80 in chips) 
Seat 2: ilir3 ($600 in chips) 
Seat 3: Y-Yx777 ($1225.61 in chips) 
Seat 4: patapong ($600 in chips) 
Seat 5: shevliak ($505.29 in chips) 
Seat 6: LuckyBiitch ($711.40 in chips) 
ilir3: posts small blind $3
Y-Yx777: posts big blind $6
*** HOLE CARDS ***
patapong: raises $9 to $15
shevliak: folds 
LuckyBiitch: folds 
x_QUIXTAR_x said, "what patapong likes the dong?"
x_QUIXTAR_x: calls $15
ilir3: folds 
Y-Yx777: calls $9
*** FLOP *** [Th 8d Kh]
Y-Yx777: checks 
patapong: checks 
x_QUIXTAR_x: checks 
*** TURN *** [Th 8d Kh] [Ac]
Y-Yx777: checks 
patapong: checks 
patapong said, "when are u gonna be a man quixtard"
x_QUIXTAR_x: checks 
*** RIVER *** [Th 8d Kh Ac] [6d]
Y-Yx777: bets $18
x_QUIXTAR_x said, "im actually a girl"
patapong: folds 
patapong said, "make sense"
x_QUIXTAR_x said, "patapong likes dong like me"
x_QUIXTAR_x: calls $18
*** SHOW DOWN ***
Y-Yx777: shows [Tc 9h] (a pair of Tens)
x_QUIXTAR_x: shows [As 4s] (a pair of Aces)
x_QUIXTAR_x collected $81.20 from pot
*** SUMMARY ***
Total pot $84 | Rake $2.80 
Board [Th 8d Kh Ac 6d]
Seat 1: x_QUIXTAR_x (button) showed [As 4s] and won ($81.20) with a pair of Aces
Seat 2: ilir3 (small blind) folded before Flop
Seat 3: Y-Yx777 (big blind) showed [Tc 9h] and lost with a pair of Tens
Seat 4: patapong folded on the River
Seat 5: shevliak folded before Flop (didn't bet)
Seat 6: LuckyBiitch folded before Flop (didn't bet)


PokerStars Game #102610689207:  Hold'em No Limit ($3/$6 USD) - 2013/08/11 12:07:18 ET
Table 'Cydonia IX 40-100 bb' 6-max Seat #2 is the button
Seat 1: x_QUIXTAR_x ($405 in chips) 
Seat 2: ilir3 ($600 in chips) 
Seat 3: Y-Yx777 ($1192.61 in chips) 
Seat 4: patapong ($600 in chips) 
Seat 5: shevliak ($505.29 in chips) 
Seat 6: LuckyBiitch ($711.40 in chips) 
Y-Yx777: posts small blind $3
patapong: posts big blind $6
*** HOLE CARDS ***
patapong said, "only little scared girl play short :)"
shevliak: folds 
LuckyBiitch: folds 
ilir3 said, "pics or gtfo"
x_QUIXTAR_x said, "yes"
x_QUIXTAR_x: raises $7.50 to $13.50
ilir3: folds 
Y-Yx777: folds 
patapong: folds 
Uncalled bet ($7.50) returned to x_QUIXTAR_x
ilir3 said, "girls online don't exist"
x_QUIXTAR_x collected $15 from pot
x_QUIXTAR_x: doesn't show hand 
*** SUMMARY ***
Total pot $15 | Rake $0 
Seat 1: x_QUIXTAR_x collected ($15)
Seat 2: ilir3 (button) folded before Flop (didn't bet)
Seat 3: Y-Yx777 (small blind) folded before Flop
Seat 4: patapong (big blind) folded before Flop
Seat 5: shevliak folded before Flop (didn't bet)
Seat 6: LuckyBiitch folded before Flop (didn't bet)


PokerStars Game #102610709133:  Hold'em No Limit ($3/$6 USD) - 2013/08/11 12:07:45 ET
Table 'Cydonia IX 40-100 bb' 6-max Seat #3 is the button
Seat 1: x_QUIXTAR_x ($414 in chips) 
Seat 2: ilir3 ($600 in chips) 
Seat 3: Y-Yx777 ($1189.61 in chips) 
Seat 4: patapong ($600 in chips) 
Seat 5: shevliak ($505.29 in chips) 
Seat 6: LuckyBiitch ($711.40 in chips) 
ilir3 said, "common knowledge"
patapong: posts small blind $3
shevliak: posts big blind $6
*** HOLE CARDS ***
LuckyBiitch: folds 
x_QUIXTAR_x: folds 
ilir3: raises $6 to $12
Y-Yx777: folds 
patapong: folds 
shevliak: folds 
Uncalled bet ($6) returned to ilir3
ilir3 collected $15 from pot
*** SUMMARY ***
Total pot $15 | Rake $0 
Seat 1: x_QUIXTAR_x folded before Flop (didn't bet)
Seat 2: ilir3 collected ($15)
Seat 3: Y-Yx777 (button) folded before Flop (didn't bet)
Seat 4: patapong (small blind) folded before Flop
Seat 5: shevliak (big blind) folded before Flop
Seat 6: LuckyBiitch folded before Flop (didn't bet)


PokerStars Game #102610727642:  Hold'em No Limit ($3/$6 USD) - 2013/08/11 12:08:10 ET
Table 'Cydonia IX 40-100 bb' 6-max Seat #4 is the button
Seat 1: x_QUIXTAR_x ($414 in chips) 
Seat 2: ilir3 ($609 in chips) 
Seat 3: Y-Yx777 ($1189.61 in chips) 
Seat 4: patapong ($600 in chips) 
Seat 5: shevliak ($499.29 in chips) 
shevliak: posts small blind $3
LuckyBiitch: is sitting out 
x_QUIXTAR_x: posts big blind $6
*** HOLE CARDS ***
ilir3: folds 
Y-Yx777: folds 
patapong: raises $6 to $12
shevliak: folds 
x_QUIXTAR_x said, "im a girl... look at my teetays!"
x_QUIXTAR_x: raises $24 to $36
patapong: folds 
Uncalled bet ($24) returned to x_QUIXTAR_x
x_QUIXTAR_x collected $27 from pot
x_QUIXTAR_x: doesn't show hand 
*** SUMMARY ***
Total pot $27 | Rake $0 
Seat 1: x_QUIXTAR_x (big blind) collected ($27)
Seat 2: ilir3 folded before Flop (didn't bet)
Seat 3: Y-Yx777 folded before Flop (didn't bet)
Seat 4: patapong (button) folded before Flop
Seat 5: shevliak (small blind) folded before Flop


PokerStars Game #102610746916:  Hold'em No Limit ($3/$6 USD) - 2013/08/11 12:08:37 ET
Table 'Cydonia IX 40-100 bb' 6-max Seat #5 is the button
Seat 1: x_QUIXTAR_x ($429 in chips) 
Seat 2: ilir3 ($609 in chips) 
Seat 3: Y-Yx777 ($1189.61 in chips) 
Seat 4: patapong ($600 in chips) 
Seat 5: shevliak ($496.29 in chips) 
x_QUIXTAR_x: posts small blind $3
ilir3: posts big blind $6
*** HOLE CARDS ***
Y-Yx777: raises $6 to $12
patapong: folds 
shevliak: folds 
x_QUIXTAR_x: calls $9
ilir3: calls $6
*** FLOP *** [3s 8s 8d]
x_QUIXTAR_x: checks 
ilir3: checks 
Y-Yx777: bets $24
x_QUIXTAR_x: raises $26 to $50
ilir3: folds 
Y-Yx777: calls $26
*** TURN *** [3s 8s 8d] [3c]
x_QUIXTAR_x: bets $100
Y-Yx777: folds 
Uncalled bet ($100) returned to x_QUIXTAR_x
x_QUIXTAR_x collected $133.20 from pot
x_QUIXTAR_x: doesn't show hand 
*** SUMMARY ***
Total pot $136 | Rake $2.80 
Board [3s 8s 8d 3c]
Seat 1: x_QUIXTAR_x (small blind) collected ($133.20)
Seat 2: ilir3 (big blind) folded on the Flop
Seat 3: Y-Yx777 folded on the Turn
Seat 4: patapong folded before Flop (didn't bet)
Seat 5: shevliak (button) folded before Flop (didn't bet)


PokerStars Game #102610789246:  Hold'em No Limit ($3/$6 USD) - 2013/08/11 12:09:36 ET
Table 'Cydonia IX 40-100 bb' 6-max Seat #1 is the button
Seat 1: x_QUIXTAR_x ($500.20 in chips) 
Seat 2: ilir3 ($600 in chips) 
Seat 3: Y-Yx777 ($1127.61 in chips) 
Seat 4: patapong ($600 in chips) 
Seat 5: shevliak ($496.29 in chips) 
ilir3: posts small blind $3
Y-Yx777: posts big blind $6
*** HOLE CARDS ***
patapong: raises $9 to $15
shevliak: calls $15
x_QUIXTAR_x: folds 
ilir3: folds 
Y-Yx777: folds 
*** FLOP *** [Ah Kh Ts]
patapong: checks 
shevliak: bets $23.83
patapong: folds 
Uncalled bet ($23.83) returned to shevliak
shevliak collected $37.24 from pot
shevliak: doesn't show hand 
*** SUMMARY ***
Total pot $39 | Rake $1.76 
Board [Ah Kh Ts]
Seat 1: x_QUIXTAR_x (button) folded before Flop (didn't bet)
Seat 2: ilir3 (small blind) folded before Flop
Seat 3: Y-Yx777 (big blind) folded before Flop
Seat 4: patapong folded on the Flop
Seat 5: shevliak collected ($37.24)


PokerStars Game #102610443450:  Hold'em No Limit ($3/$6 USD) - 2013/08/11 12:01:35 ET
Table 'Cydonia IX 40-100 bb' 6-max Seat #1 is the button
Seat 1: x_QUIXTAR_x ($365.80 in chips) 
Seat 2: ilir3 ($600 in chips) 
Seat 3: Y-Yx777 ($1299.71 in chips) 
Seat 4: patapong ($600 in chips) 
Seat 5: shevliak ($340.09 in chips) 
Seat 6: LuckyBiitch ($726.40 in chips) 
ilir3: posts small blind $3
Y-Yx777: posts big blind $6
*** HOLE CARDS ***
patapong: folds 
shevliak: folds 
LuckyBiitch: folds 
x_QUIXTAR_x: folds 
ilir3: calls $3
Y-Yx777: checks 
*** FLOP *** [Jc Js Kc]
ilir3: bets $6
Y-Yx777: calls $6
*** TURN *** [Jc Js Kc] [3h]
ilir3: checks 
Y-Yx777: bets $12
ilir3: calls $12
*** RIVER *** [Jc Js Kc 3h] [2s]
ilir3: checks 
Y-Yx777: bets $30
ilir3: calls $30
*** SHOW DOWN ***
Y-Yx777: shows [7c Jd] (three of a kind, Jacks)
ilir3: mucks hand 
Y-Yx777 collected $105.20 from pot
*** SUMMARY ***
Total pot $108 | Rake $2.80 
Board [Jc Js Kc 3h 2s]
Seat 1: x_QUIXTAR_x (button) folded before Flop (didn't bet)
Seat 2: ilir3 (small blind) mucked
Seat 3: Y-Yx777 (big blind) showed [7c Jd] and won ($105.20) with three of a kind, Jacks
Seat 4: patapong folded before Flop (didn't bet)
Seat 5: shevliak folded before Flop (didn't bet)
Seat 6: LuckyBiitch folded before Flop (didn't bet)


PokerStars Game #102610468215:  Hold'em No Limit ($3/$6 USD) - 2013/08/11 12:02:12 ET
Table 'Cydonia IX 40-100 bb' 6-max Seat #2 is the button
Seat 1: x_QUIXTAR_x ($365.80 in chips) 
Seat 2: ilir3 ($600 in chips) 
Seat 3: Y-Yx777 ($1350.91 in chips) 
Seat 4: patapong ($600 in chips) 
Seat 5: shevliak ($340.09 in chips) 
Seat 6: LuckyBiitch ($726.40 in chips) 
Y-Yx777: posts small blind $3
patapong: posts big blind $6
*** HOLE CARDS ***
shevliak: folds 
LuckyBiitch: folds 
x_QUIXTAR_x: folds 
ilir3: folds 
Y-Yx777: raises $6 to $12
patapong: calls $6
*** FLOP *** [Qd 5c Ts]
Y-Yx777: bets $12
patapong: folds 
Uncalled bet ($12) returned to Y-Yx777
Y-Yx777 collected $22.92 from pot
*** SUMMARY ***
Total pot $24 | Rake $1.08 
Board [Qd 5c Ts]
Seat 1: x_QUIXTAR_x folded before Flop (didn't bet)
Seat 2: ilir3 (button) folded before Flop (didn't bet)
Seat 3: Y-Yx777 (small blind) collected ($22.92)
Seat 4: patapong (big blind) folded on the Flop
Seat 5: shevliak folded before Flop (didn't bet)
Seat 6: LuckyBiitch folded before Flop (didn't bet)


PokerStars Game #102610496461:  Hold'em No Limit ($3/$6 USD) - 2013/08/11 12:02:53 ET
Table 'Cydonia IX 40-100 bb' 6-max Seat #3 is the button
Seat 1: x_QUIXTAR_x ($365.80 in chips) 
Seat 2: ilir3 ($600 in chips) 
Seat 3: Y-Yx777 ($1361.83 in chips) 
Seat 4: patapong ($600 in chips) 
Seat 5: shevliak ($340.09 in chips) 
Seat 6: LuckyBiitch ($726.40 in chips) 
patapong: posts small blind $3
shevliak: posts big blind $6
*** HOLE CARDS ***
LuckyBiitch: folds 
x_QUIXTAR_x: folds 
ilir3: folds 
Y-Yx777: raises $6 to $12
patapong: folds 
shevliak: folds 
Uncalled bet ($6) returned to Y-Yx777
Y-Yx777 collected $15 from pot
*** SUMMARY ***
Total pot $15 | Rake $0 
Seat 1: x_QUIXTAR_x folded before Flop (didn't bet)
Seat 2: ilir3 folded before Flop (didn't bet)
Seat 3: Y-Yx777 (button) collected ($15)
Seat 4: patapong (small blind) folded before Flop
Seat 5: shevliak (big blind) folded before Flop
Seat 6: LuckyBiitch folded before Flop (didn't bet)


PokerStars Game #102610509378:  Hold'em No Limit ($3/$6 USD) - 2013/08/11 12:03:11 ET
Table 'Cydonia IX 40-100 bb' 6-max Seat #4 is the button
Seat 1: x_QUIXTAR_x ($365.80 in chips) 
Seat 2: ilir3 ($600 in chips) 
Seat 3: Y-Yx777 ($1370.83 in chips) 
Seat 4: patapong ($600 in chips) 
Seat 5: shevliak ($334.09 in chips) 
Seat 6: LuckyBiitch ($726.40 in chips) 
shevliak: posts small blind $3
LuckyBiitch: posts big blind $6
*** HOLE CARDS ***
x_QUIXTAR_x: folds 
ilir3: folds 
Y-Yx777: raises $6 to $12
patapong: folds 
shevliak: folds 
LuckyBiitch: calls $6
*** FLOP *** [Kh 4c 3c]
LuckyBiitch: checks 
Y-Yx777: bets $12
LuckyBiitch: folds 
Uncalled bet ($12) returned to Y-Yx777
Y-Yx777 collected $25.78 from pot
*** SUMMARY ***
Total pot $27 | Rake $1.22 
Board [Kh 4c 3c]
Seat 1: x_QUIXTAR_x folded before Flop (didn't bet)
Seat 2: ilir3 folded before Flop (didn't bet)
Seat 3: Y-Yx777 collected ($25.78)
Seat 4: patapong (button) folded before Flop (didn't bet)
Seat 5: shevliak (small blind) folded before Flop
Seat 6: LuckyBiitch (big blind) folded on the Flop


PokerStars Game #102610536092:  Hold'em No Limit ($3/$6 USD) - 2013/08/11 12:03:49 ET
Table 'Cydonia IX 40-100 bb' 6-max Seat #5 is the button
Seat 1: x_QUIXTAR_x ($365.80 in chips) 
Seat 2: ilir3 ($600 in chips) 
Seat 3: Y-Yx777 ($1384.61 in chips) 
Seat 4: patapong ($600 in chips) 
Seat 5: shevliak ($331.09 in chips) 
Seat 6: LuckyBiitch ($714.40 in chips) 
LuckyBiitch: posts small blind $3
x_QUIXTAR_x: posts big blind $6
*** HOLE CARDS ***
ilir3: folds 
Y-Yx777: folds 
patapong: folds 
shevliak: raises $6 to $12
LuckyBiitch: folds 
x_QUIXTAR_x: folds 
Uncalled bet ($6) returned to shevliak
shevliak collected $15 from pot
shevliak: doesn't show hand 
*** SUMMARY ***
Total pot $15 | Rake $0 
Seat 1: x_QUIXTAR_x (big blind) folded before Flop
Seat 2: ilir3 folded before Flop (didn't bet)
Seat 3: Y-Yx777 folded before Flop (didn't bet)
Seat 4: patapong folded before Flop (didn't bet)
Seat 5: shevliak (button) collected ($15)
Seat 6: LuckyBiitch (small blind) folded before Flop


PokerStars Game #102610554885:  Hold'em No Limit ($3/$6 USD) - 2013/08/11 12:04:15 ET
Table 'Cydonia IX 40-100 bb' 6-max Seat #6 is the button
Seat 1: x_QUIXTAR_x ($359.80 in chips) 
Seat 2: ilir3 ($600 in chips) 
Seat 3: Y-Yx777 ($1384.61 in chips) 
Seat 4: patapong ($600 in chips) 
Seat 5: shevliak ($340.09 in chips) 
Seat 6: LuckyBiitch ($711.40 in chips) 
x_QUIXTAR_x: posts small blind $3
ilir3: posts big blind $6
*** HOLE CARDS ***
Y-Yx777: raises $6 to $12
patapong: folds 
shevliak: raises $36 to $48
LuckyBiitch: folds 
x_QUIXTAR_x: folds 
ilir3: folds 
Y-Yx777: calls $36
*** FLOP *** [Th 8d 3h]
Y-Yx777: checks 
shevliak: bets $45
Y-Yx777: calls $45
*** TURN *** [Th 8d 3h] [2d]
Y-Yx777: checks 
shevliak: checks 
*** RIVER *** [Th 8d 3h 2d] [4s]
Y-Yx777: bets $66
shevliak: calls $66
*** SHOW DOWN ***
Y-Yx777: shows [Qd As] (high card Ace)
shevliak: shows [Ad Kc] (high card Ace - King kicker)
shevliak collected $324.20 from pot
*** SUMMARY ***
Total pot $327 | Rake $2.80 
Board [Th 8d 3h 2d 4s]
Seat 1: x_QUIXTAR_x (small blind) folded before Flop
Seat 2: ilir3 (big blind) folded before Flop
Seat 3: Y-Yx777 showed [Qd As] and lost with high card Ace
Seat 4: patapong folded before Flop (didn't bet)
Seat 5: shevliak showed [Ad Kc] and won ($324.20) with high card Ace
Seat 6: LuckyBiitch (button) folded before Flop (didn't bet)


PokerStars Game #102610267189:  Hold'em No Limit ($3/$6 USD) - 2013/08/11 11:56:02 ET
Table 'Cydonia IX 40-100 bb' 6-max Seat #1 is the button
Seat 1: x_QUIXTAR_x ($407.80 in chips) 
Seat 2: ilir3 ($623.70 in chips) 
Seat 3: Y-Yx777 ($600.81 in chips) 
Seat 4: patapong ($651.72 in chips) 
Seat 5: shevliak ($298.40 in chips) 
Seat 6: LuckyBiitch ($735.40 in chips) 
ilir3: posts small blind $3
Y-Yx777: posts big blind $6
*** HOLE CARDS ***
patapong: raises $9 to $15
shevliak: calls $15
LuckyBiitch: folds 
x_QUIXTAR_x: folds 
ilir3: folds 
Y-Yx777: folds 
*** FLOP *** [2s 5h 3c]
patapong: bets $18.21
shevliak: folds 
Uncalled bet ($18.21) returned to patapong
patapong collected $37.24 from pot
*** SUMMARY ***
Total pot $39 | Rake $1.76 
Board [2s 5h 3c]
Seat 1: x_QUIXTAR_x (button) folded before Flop (didn't bet)
Seat 2: ilir3 (small blind) folded before Flop
Seat 3: Y-Yx777 (big blind) folded before Flop
Seat 4: patapong collected ($37.24)
Seat 5: shevliak folded on the Flop
Seat 6: LuckyBiitch folded before Flop (didn't bet)


PokerStars Game #102610286743:  Hold'em No Limit ($3/$6 USD) - 2013/08/11 11:56:41 ET
Table 'Cydonia IX 40-100 bb' 6-max Seat #2 is the button
Seat 1: x_QUIXTAR_x ($407.80 in chips) 
Seat 2: ilir3 ($620.70 in chips) 
Seat 3: Y-Yx777 ($594.81 in chips) 
Seat 4: patapong ($673.96 in chips) 
Seat 5: shevliak ($283.40 in chips) 
Seat 6: LuckyBiitch ($735.40 in chips) 
Y-Yx777: posts small blind $3
patapong: posts big blind $6
*** HOLE CARDS ***
shevliak: raises $9 to $15
LuckyBiitch: folds 
x_QUIXTAR_x: folds 
ilir3: folds 
Y-Yx777: folds 
patapong: calls $9
*** FLOP *** [9d Js 4c]
patapong: checks 
shevliak: checks 
*** TURN *** [9d Js 4c] [9c]
patapong: bets $20.49
shevliak: calls $20.49
*** RIVER *** [9d Js 4c 9c] [2d]
patapong: checks 
shevliak: bets $45.55
patapong: folds 
Uncalled bet ($45.55) returned to shevliak
shevliak collected $71.18 from pot
shevliak: doesn't show hand 
*** SUMMARY ***
Total pot $73.98 | Rake $2.80 
Board [9d Js 4c 9c 2d]
Seat 1: x_QUIXTAR_x folded before Flop (didn't bet)
Seat 2: ilir3 (button) folded before Flop (didn't bet)
Seat 3: Y-Yx777 (small blind) folded before Flop
Seat 4: patapong (big blind) folded on the River
Seat 5: shevliak collected ($71.18)
Seat 6: LuckyBiitch folded before Flop (didn't bet)


PokerStars Game #102610316680:  Hold'em No Limit ($3/$6 USD) - 2013/08/11 11:57:42 ET
Table 'Cydonia IX 40-100 bb' 6-max Seat #3 is the button
Seat 1: x_QUIXTAR_x ($407.80 in chips) 
Seat 2: ilir3 ($620.70 in chips) 
Seat 3: Y-Yx777 ($591.81 in chips) 
Seat 4: patapong ($638.47 in chips) 
Seat 5: shevliak ($319.09 in chips) 
Seat 6: LuckyBiitch ($735.40 in chips) 
patapong: posts small blind $3
shevliak: posts big blind $6
*** HOLE CARDS ***
LuckyBiitch: folds 
x_QUIXTAR_x: folds 
ilir3: folds 
Y-Yx777: raises $6 to $12
patapong: raises $36 to $48
shevliak: folds 
Y-Yx777: raises $84 to $132
patapong: folds 
Uncalled bet ($84) returned to Y-Yx777
Y-Yx777 collected $102 from pot
*** SUMMARY ***
Total pot $102 | Rake $0 
Seat 1: x_QUIXTAR_x folded before Flop (didn't bet)
Seat 2: ilir3 folded before Flop (didn't bet)
Seat 3: Y-Yx777 (button) collected ($102)
Seat 4: patapong (small blind) folded before Flop
Seat 5: shevliak (big blind) folded before Flop
Seat 6: LuckyBiitch folded before Flop (didn't bet)


PokerStars Game #102610333322:  Hold'em No Limit ($3/$6 USD) - 2013/08/11 11:58:15 ET
Table 'Cydonia IX 40-100 bb' 6-max Seat #4 is the button
Seat 1: x_QUIXTAR_x ($407.80 in chips) 
Seat 2: ilir3 ($620.70 in chips) 
Seat 3: Y-Yx777 ($645.81 in chips) 
Seat 4: patapong ($600 in chips) 
Seat 5: shevliak ($313.09 in chips) 
Seat 6: LuckyBiitch ($735.40 in chips) 
shevliak: posts small blind $3
LuckyBiitch: posts big blind $6
*** HOLE CARDS ***
x_QUIXTAR_x: folds 
ilir3: folds 
Y-Yx777: folds 
patapong: raises $6 to $12
shevliak: raises $27 to $39
LuckyBiitch: folds 
patapong: folds 
Uncalled bet ($27) returned to shevliak
shevliak collected $30 from pot
shevliak: doesn't show hand 
*** SUMMARY ***
Total pot $30 | Rake $0 
Seat 1: x_QUIXTAR_x folded before Flop (didn't bet)
Seat 2: ilir3 folded before Flop (didn't bet)
Seat 3: Y-Yx777 folded before Flop (didn't bet)
Seat 4: patapong (button) folded before Flop
Seat 5: shevliak (small blind) collected ($30)
Seat 6: LuckyBiitch (big blind) folded before Flop


PokerStars Game #102610351157:  Hold'em No Limit ($3/$6 USD) - 2013/08/11 11:58:51 ET
Table 'Cydonia IX 40-100 bb' 6-max Seat #5 is the button
Seat 1: x_QUIXTAR_x ($407.80 in chips) 
Seat 2: ilir3 ($620.70 in chips) 
Seat 3: Y-Yx777 ($645.81 in chips) 
Seat 4: patapong ($600 in chips) 
Seat 5: shevliak ($331.09 in chips) 
Seat 6: LuckyBiitch ($729.40 in chips) 
LuckyBiitch: posts small blind $3
x_QUIXTAR_x: posts big blind $6
*** HOLE CARDS ***
ilir3: folds 
Y-Yx777: folds 
patapong: folds 
shevliak: raises $6 to $12
LuckyBiitch: folds 
x_QUIXTAR_x: folds 
Uncalled bet ($6) returned to shevliak
shevliak collected $15 from pot
shevliak: doesn't show hand 
*** SUMMARY ***
Total pot $15 | Rake $0 
Seat 1: x_QUIXTAR_x (big blind) folded before Flop
Seat 2: ilir3 folded before Flop (didn't bet)
Seat 3: Y-Yx777 folded before Flop (didn't bet)
Seat 4: patapong folded before Flop (didn't bet)
Seat 5: shevliak (button) collected ($15)
Seat 6: LuckyBiitch (small blind) folded before Flop


PokerStars Game #102610365427:  Hold'em No Limit ($3/$6 USD) - 2013/08/11 11:59:19 ET
Table 'Cydonia IX 40-100 bb' 6-max Seat #6 is the button
Seat 1: x_QUIXTAR_x ($401.80 in chips) 
Seat 2: ilir3 ($620.70 in chips) 
Seat 3: Y-Yx777 ($645.81 in chips) 
Seat 4: patapong ($600 in chips) 
Seat 5: shevliak ($340.09 in chips) 
Seat 6: LuckyBiitch ($726.40 in chips) 
x_QUIXTAR_x: posts small blind $3
ilir3: posts big blind $6
*** HOLE CARDS ***
Y-Yx777: raises $6 to $12
patapong: folds 
shevliak: folds 
LuckyBiitch: folds 
x_QUIXTAR_x: raises $24 to $36
ilir3: raises $52 to $88
Y-Yx777: calls $76
x_QUIXTAR_x: folds 
*** FLOP *** [8h 4c Ts]
ilir3: bets $78
Y-Yx777: calls $78
*** TURN *** [8h 4c Ts] [5d]
ilir3: bets $148
Y-Yx777: calls $148
*** RIVER *** [8h 4c Ts 5d] [Qd]
ilir3: bets $306.70 and is all-in
Y-Yx777: calls $306.70
*** SHOW DOWN ***
ilir3: shows [Ks Ad] (high card Ace)
Y-Yx777: shows [Jc Jh] (a pair of Jacks)
Y-Yx777 collected $1274.60 from pot
*** SUMMARY ***
Total pot $1277.40 | Rake $2.80 
Board [8h 4c Ts 5d Qd]
Seat 1: x_QUIXTAR_x (small blind) folded before Flop
Seat 2: ilir3 (big blind) showed [Ks Ad] and lost with high card Ace
Seat 3: Y-Yx777 showed [Jc Jh] and won ($1274.60) with a pair of Jacks
Seat 4: patapong folded before Flop (didn't bet)
Seat 5: shevliak folded before Flop (didn't bet)
Seat 6: LuckyBiitch (button) folded before Flop (didn't bet)


PokerStars Game #102612169050:  Hold'em No Limit ($3/$6 USD) - 2013/08/11 12:40:43 ET
Table 'Cydonia IX 40-100 bb' 6-max Seat #3 is the button
Seat 1: x_QUIXTAR_x ($1005 in chips) 
Seat 2: ilir3 ($823.83 in chips) 
Seat 3: Y-Yx777 ($1122.55 in chips) 
Seat 4: patapong ($648.48 in chips) 
Seat 5: shevliak ($413.41 in chips) 
Seat 6: floriiiiider ($693.40 in chips) 
patapong: posts small blind $3
shevliak: posts big blind $6
*** HOLE CARDS ***
floriiiiider: folds 
x_QUIXTAR_x: folds 
ilir3: folds 
Y-Yx777: raises $6 to $12
patapong: folds 
shevliak: calls $6
*** FLOP *** [Kd Ah As]
shevliak: checks 
Y-Yx777: bets $12
shevliak: calls $12
*** TURN *** [Kd Ah As] [8c]
shevliak: checks 
Y-Yx777: bets $30
shevliak: folds 
Uncalled bet ($30) returned to Y-Yx777
Y-Yx777 collected $48.70 from pot
*** SUMMARY ***
Total pot $51 | Rake $2.30 
Board [Kd Ah As 8c]
Seat 1: x_QUIXTAR_x folded before Flop (didn't bet)
Seat 2: ilir3 folded before Flop (didn't bet)
Seat 3: Y-Yx777 (button) collected ($48.70)
Seat 4: patapong (small blind) folded before Flop
Seat 5: shevliak (big blind) folded on the Turn
Seat 6: floriiiiider folded before Flop (didn't bet)


PokerStars Game #102612210302:  Hold'em No Limit ($3/$6 USD) - 2013/08/11 12:41:37 ET
Table 'Cydonia IX 40-100 bb' 6-max Seat #4 is the button
Seat 1: x_QUIXTAR_x ($1005 in chips) 
Seat 2: ilir3 ($823.83 in chips) 
Seat 3: Y-Yx777 ($1147.25 in chips) 
Seat 4: patapong ($645.48 in chips) 
Seat 5: shevliak ($389.41 in chips) 
Seat 6: floriiiiider ($693.40 in chips) 
shevliak: posts small blind $3
floriiiiider: posts big blind $6
*** HOLE CARDS ***
x_QUIXTAR_x: folds 
ilir3: folds 
Y-Yx777: folds 
patapong: folds 
shevliak: folds 
Uncalled bet ($3) returned to floriiiiider
floriiiiider collected $6 from pot
floriiiiider: doesn't show hand 
*** SUMMARY ***
Total pot $6 | Rake $0 
Seat 1: x_QUIXTAR_x folded before Flop (didn't bet)
Seat 2: ilir3 folded before Flop (didn't bet)
Seat 3: Y-Yx777 folded before Flop (didn't bet)
Seat 4: patapong (button) folded before Flop (didn't bet)
Seat 5: shevliak (small blind) folded before Flop
Seat 6: floriiiiider (big blind) collected ($6)


PokerStars Game #102612225685:  Hold'em No Limit ($3/$6 USD) - 2013/08/11 12:41:57 ET
Table 'Cydonia IX 40-100 bb' 6-max Seat #5 is the button
Seat 1: x_QUIXTAR_x ($1005 in chips) 
Seat 2: ilir3 ($823.83 in chips) 
Seat 3: Y-Yx777 ($1147.25 in chips) 
Seat 4: patapong ($645.48 in chips) 
Seat 5: shevliak ($386.41 in chips) 
Seat 6: floriiiiider ($696.40 in chips) 
floriiiiider: posts small blind $3
x_QUIXTAR_x: posts big blind $6
*** HOLE CARDS ***
ilir3: folds 
Y-Yx777: raises $6 to $12
patapong: folds 
shevliak: folds 
floriiiiider: folds 
x_QUIXTAR_x: folds 
Uncalled bet ($6) returned to Y-Yx777
Y-Yx777 collected $15 from pot
*** SUMMARY ***
Total pot $15 | Rake $0 
Seat 1: x_QUIXTAR_x (big blind) folded before Flop
Seat 2: ilir3 folded before Flop (didn't bet)
Seat 3: Y-Yx777 collected ($15)
Seat 4: patapong folded before Flop (didn't bet)
Seat 5: shevliak (button) folded before Flop (didn't bet)
Seat 6: floriiiiider (small blind) folded before Flop


PokerStars Game #102612254133:  Hold'em No Limit ($3/$6 USD) - 2013/08/11 12:42:34 ET
Table 'Cydonia IX 40-100 bb' 6-max Seat #6 is the button
Seat 1: x_QUIXTAR_x ($999 in chips) 
Seat 2: ilir3 ($823.83 in chips) 
Seat 3: Y-Yx777 ($1156.25 in chips) 
Seat 4: patapong ($645.48 in chips) 
Seat 5: shevliak ($386.41 in chips) 
Seat 6: floriiiiider ($693.40 in chips) 
x_QUIXTAR_x: posts small blind $3
ilir3: posts big blind $6
*** HOLE CARDS ***
Y-Yx777: folds 
patapong: folds 
shevliak: folds 
floriiiiider: folds 
x_QUIXTAR_x: folds 
Uncalled bet ($3) returned to ilir3
ilir3 collected $6 from pot
ilir3: doesn't show hand 
*** SUMMARY ***
Total pot $6 | Rake $0 
Seat 1: x_QUIXTAR_x (small blind) folded before Flop
Seat 2: ilir3 (big blind) collected ($6)
Seat 3: Y-Yx777 folded before Flop (didn't bet)
Seat 4: patapong folded before Flop (didn't bet)
Seat 5: shevliak folded before Flop (didn't bet)
Seat 6: floriiiiider (button) folded before Flop (didn't bet)


PokerStars Game #102612270147:  Hold'em No Limit ($3/$6 USD) - 2013/08/11 12:42:55 ET
Table 'Cydonia IX 40-100 bb' 6-max Seat #1 is the button
Seat 1: x_QUIXTAR_x ($996 in chips) 
Seat 2: ilir3 ($826.83 in chips) 
Seat 3: Y-Yx777 ($1156.25 in chips) 
Seat 4: patapong ($645.48 in chips) 
Seat 5: shevliak ($386.41 in chips) 
Seat 6: floriiiiider ($693.40 in chips) 
ilir3: posts small blind $3
Y-Yx777: posts big blind $6
*** HOLE CARDS ***
patapong: folds 
shevliak: folds 
floriiiiider: folds 
x_QUIXTAR_x: folds 
ilir3: calls $3
Y-Yx777: checks 
*** FLOP *** [9h 8h 5c]
ilir3: bets $6
Y-Yx777: calls $6
*** TURN *** [9h 8h 5c] [6c]
ilir3: bets $18
Y-Yx777: raises $30 to $48
ilir3: calls $30
*** RIVER *** [9h 8h 5c 6c] [4c]
ilir3: checks 
Y-Yx777: bets $54
ilir3: folds 
Uncalled bet ($54) returned to Y-Yx777
Y-Yx777 collected $117.20 from pot
*** SUMMARY ***
Total pot $120 | Rake $2.80 
Board [9h 8h 5c 6c 4c]
Seat 1: x_QUIXTAR_x (button) folded before Flop (didn't bet)
Seat 2: ilir3 (small blind) folded on the River
Seat 3: Y-Yx777 (big blind) collected ($117.20)
Seat 4: patapong folded before Flop (didn't bet)
Seat 5: shevliak folded before Flop (didn't bet)
Seat 6: floriiiiider folded before Flop (didn't bet)


PokerStars Game #102612305165:  Hold'em No Limit ($3/$6 USD) - 2013/08/11 12:43:42 ET
Table 'Cydonia IX 40-100 bb' 6-max Seat #2 is the button
Seat 1: x_QUIXTAR_x ($996 in chips) 
Seat 2: ilir3 ($766.83 in chips) 
Seat 3: Y-Yx777 ($1213.45 in chips) 
Seat 4: patapong ($645.48 in chips) 
Seat 5: shevliak ($386.41 in chips) 
Seat 6: floriiiiider ($693.40 in chips) 
Y-Yx777: posts small blind $3
patapong: posts big blind $6
*** HOLE CARDS ***
shevliak: raises $9 to $15
floriiiiider: folds 
x_QUIXTAR_x: folds 
ilir3: folds 
Y-Yx777: calls $12
patapong: folds 
*** FLOP *** [9d 5d Qh]
Y-Yx777: checks 
shevliak: bets $24
Y-Yx777: calls $24
*** TURN *** [9d 5d Qh] [Tc]
Y-Yx777: checks 
shevliak: bets $68
Y-Yx777: folds 
Uncalled bet ($68) returned to shevliak
shevliak collected $81.20 from pot
shevliak: doesn't show hand 
*** SUMMARY ***
Total pot $84 | Rake $2.80 
Board [9d 5d Qh Tc]
Seat 1: x_QUIXTAR_x folded before Flop (didn't bet)
Seat 2: ilir3 (button) folded before Flop (didn't bet)
Seat 3: Y-Yx777 (small blind) folded on the Turn
Seat 4: patapong (big blind) folded before Flop
Seat 5: shevliak collected ($81.20)
Seat 6: floriiiiider folded before Flop (didn't bet)


PokerStars Game #102612346690:  Hold'em No Limit ($3/$6 USD) - 2013/08/11 12:44:37 ET
Table 'Cydonia IX 40-100 bb' 6-max Seat #3 is the button
Seat 1: x_QUIXTAR_x ($996 in chips) 
Seat 2: ilir3 ($766.83 in chips) 
Seat 3: Y-Yx777 ($1174.45 in chips) 
Seat 4: patapong ($639.48 in chips) 
Seat 5: shevliak ($428.61 in chips) 
Seat 6: floriiiiider ($693.40 in chips) 
patapong: posts small blind $3
shevliak: posts big blind $6
*** HOLE CARDS ***
floriiiiider: folds 
x_QUIXTAR_x: folds 
ilir3: folds 
Y-Yx777: folds 
patapong: calls $3
shevliak: raises $12 to $18
patapong: raises $42 to $60
shevliak: folds 
Uncalled bet ($42) returned to patapong
patapong collected $36 from pot
*** SUMMARY ***
Total pot $36 | Rake $0 
Seat 1: x_QUIXTAR_x folded before Flop (didn't bet)
Seat 2: ilir3 folded before Flop (didn't bet)
Seat 3: Y-Yx777 (button) folded before Flop (didn't bet)
Seat 4: patapong (small blind) collected ($36)
Seat 5: shevliak (big blind) folded before Flop
Seat 6: floriiiiider folded before Flop (didn't bet)


PokerStars Game #102611938618:  Hold'em No Limit ($3/$6 USD) - 2013/08/11 12:35:40 ET
Table 'Cydonia IX 40-100 bb' 6-max Seat #2 is the button
Seat 1: x_QUIXTAR_x ($1164 in chips) 
Seat 2: ilir3 ($747.18 in chips) 
Seat 3: Y-Yx777 ($816.90 in chips) 
Seat 4: patapong ($646.02 in chips) 
Seat 5: shevliak ($679.66 in chips) 
Seat 6: floriiiiider ($663.20 in chips) 
Y-Yx777: posts small blind $3
patapong: posts big blind $6
*** HOLE CARDS ***
shevliak: folds 
floriiiiider: folds 
x_QUIXTAR_x: folds 
ilir3: raises $6 to $12
Y-Yx777: calls $9
patapong: folds 
*** FLOP *** [Qh Th Ac]
Y-Yx777: checks 
ilir3: bets $18
Y-Yx777: folds 
Uncalled bet ($18) returned to ilir3
ilir3 collected $28.65 from pot
ilir3: doesn't show hand 
*** SUMMARY ***
Total pot $30 | Rake $1.35 
Board [Qh Th Ac]
Seat 1: x_QUIXTAR_x folded before Flop (didn't bet)
Seat 2: ilir3 (button) collected ($28.65)
Seat 3: Y-Yx777 (small blind) folded on the Flop
Seat 4: patapong (big blind) folded before Flop
Seat 5: shevliak folded before Flop (didn't bet)
Seat 6: floriiiiider folded before Flop (didn't bet)


PokerStars Game #102611955497:  Hold'em No Limit ($3/$6 USD) - 2013/08/11 12:36:02 ET
Table 'Cydonia IX 40-100 bb' 6-max Seat #3 is the button
Seat 1: x_QUIXTAR_x ($1164 in chips) 
Seat 2: ilir3 ($763.83 in chips) 
Seat 3: Y-Yx777 ($804.90 in chips) 
Seat 4: patapong ($640.02 in chips) 
Seat 5: shevliak ($679.66 in chips) 
Seat 6: floriiiiider ($663.20 in chips) 
patapong: posts small blind $3
shevliak: posts big blind $6
*** HOLE CARDS ***
floriiiiider: folds 
x_QUIXTAR_x: folds 
ilir3: folds 
Y-Yx777: folds 
patapong: calls $3
shevliak: checks 
*** FLOP *** [Qc 7d 9c]
patapong: bets $9
shevliak: folds 
Uncalled bet ($9) returned to patapong
patapong collected $11.46 from pot
*** SUMMARY ***
Total pot $12 | Rake $0.54 
Board [Qc 7d 9c]
Seat 1: x_QUIXTAR_x folded before Flop (didn't bet)
Seat 2: ilir3 folded before Flop (didn't bet)
Seat 3: Y-Yx777 (button) folded before Flop (didn't bet)
Seat 4: patapong (small blind) collected ($11.46)
Seat 5: shevliak (big blind) folded on the Flop
Seat 6: floriiiiider folded before Flop (didn't bet)


PokerStars Game #102611981065:  Hold'em No Limit ($3/$6 USD) - 2013/08/11 12:36:36 ET
Table 'Cydonia IX 40-100 bb' 6-max Seat #4 is the button
Seat 1: x_QUIXTAR_x ($1164 in chips) 
Seat 2: ilir3 ($763.83 in chips) 
Seat 3: Y-Yx777 ($804.90 in chips) 
Seat 4: patapong ($645.48 in chips) 
Seat 5: shevliak ($673.66 in chips) 
Seat 6: floriiiiider ($663.20 in chips) 
shevliak: posts small blind $3
floriiiiider: posts big blind $6
*** HOLE CARDS ***
x_QUIXTAR_x: folds 
ilir3: folds 
Y-Yx777: folds 
patapong: raises $6 to $12
shevliak: folds 
floriiiiider: folds 
Uncalled bet ($6) returned to patapong
patapong collected $15 from pot
*** SUMMARY ***
Total pot $15 | Rake $0 
Seat 1: x_QUIXTAR_x folded before Flop (didn't bet)
Seat 2: ilir3 folded before Flop (didn't bet)
Seat 3: Y-Yx777 folded before Flop (didn't bet)
Seat 4: patapong (button) collected ($15)
Seat 5: shevliak (small blind) folded before Flop
Seat 6: floriiiiider (big blind) folded before Flop


PokerStars Game #102612009681:  Hold'em No Limit ($3/$6 USD) - 2013/08/11 12:37:13 ET
Table 'Cydonia IX 40-100 bb' 6-max Seat #5 is the button
Seat 1: x_QUIXTAR_x ($1164 in chips) 
Seat 2: ilir3 ($763.83 in chips) 
Seat 3: Y-Yx777 ($804.90 in chips) 
Seat 4: patapong ($654.48 in chips) 
Seat 5: shevliak ($670.66 in chips) 
Seat 6: floriiiiider ($657.20 in chips) 
floriiiiider: posts small blind $3
x_QUIXTAR_x: posts big blind $6
*** HOLE CARDS ***
ilir3: folds 
Y-Yx777: raises $6 to $12
patapong: folds 
shevliak: folds 
floriiiiider: raises $36 to $48
x_QUIXTAR_x: folds 
Y-Yx777: calls $36
*** FLOP *** [4s Js 3s]
floriiiiider: bets $66
Y-Yx777: folds 
Uncalled bet ($66) returned to floriiiiider
floriiiiider collected $99.20 from pot
floriiiiider: doesn't show hand 
*** SUMMARY ***
Total pot $102 | Rake $2.80 
Board [4s Js 3s]
Seat 1: x_QUIXTAR_x (big blind) folded before Flop
Seat 2: ilir3 folded before Flop (didn't bet)
Seat 3: Y-Yx777 folded on the Flop
Seat 4: patapong folded before Flop (didn't bet)
Seat 5: shevliak (button) folded before Flop (didn't bet)
Seat 6: floriiiiider (small blind) collected ($99.20)


PokerStars Game #102612036475:  Hold'em No Limit ($3/$6 USD) - 2013/08/11 12:37:48 ET
Table 'Cydonia IX 40-100 bb' 6-max Seat #6 is the button
Seat 1: x_QUIXTAR_x ($1158 in chips) 
Seat 2: ilir3 ($763.83 in chips) 
Seat 3: Y-Yx777 ($756.90 in chips) 
Seat 4: patapong ($654.48 in chips) 
Seat 5: shevliak ($670.66 in chips) 
Seat 6: floriiiiider ($708.40 in chips) 
x_QUIXTAR_x: posts small blind $3
ilir3: posts big blind $6
*** HOLE CARDS ***
Y-Yx777: raises $6 to $12
patapong: folds 
shevliak: folds 
floriiiiider: folds 
x_QUIXTAR_x: raises $36 to $48
ilir3: folds 
Y-Yx777: calls $36
*** FLOP *** [8h Ad 8s]
x_QUIXTAR_x: bets $42
Y-Yx777: raises $60 to $102
x_QUIXTAR_x: folds 
Uncalled bet ($60) returned to Y-Yx777
Y-Yx777 collected $183.20 from pot
*** SUMMARY ***
Total pot $186 | Rake $2.80 
Board [8h Ad 8s]
Seat 1: x_QUIXTAR_x (small blind) folded on the Flop
Seat 2: ilir3 (big blind) folded before Flop
Seat 3: Y-Yx777 collected ($183.20)
Seat 4: patapong folded before Flop (didn't bet)
Seat 5: shevliak folded before Flop (didn't bet)
Seat 6: floriiiiider (button) folded before Flop (didn't bet)


PokerStars Game #102612073747:  Hold'em No Limit ($3/$6 USD) - 2013/08/11 12:38:37 ET
Table 'Cydonia IX 40-100 bb' 6-max Seat #1 is the button
Seat 1: x_QUIXTAR_x ($1068 in chips) 
Seat 2: ilir3 ($757.83 in chips) 
Seat 3: Y-Yx777 ($850.10 in chips) 
Seat 4: patapong ($654.48 in chips) 
Seat 5: shevliak ($670.66 in chips) 
Seat 6: floriiiiider ($708.40 in chips) 
ilir3: posts small blind $3
Y-Yx777: posts big blind $6
*** HOLE CARDS ***
patapong: folds 
shevliak: folds 
floriiiiider: raises $9 to $15
x_QUIXTAR_x: raises $30 to $45
ilir3: raises $65 to $110
Y-Yx777: folds 
floriiiiider: folds 
x_QUIXTAR_x: folds 
Uncalled bet ($65) returned to ilir3
ilir3 collected $111 from pot
ilir3: doesn't show hand 
*** SUMMARY ***
Total pot $111 | Rake $0 
Seat 1: x_QUIXTAR_x (button) folded before Flop
Seat 2: ilir3 (small blind) collected ($111)
Seat 3: Y-Yx777 (big blind) folded before Flop
Seat 4: patapong folded before Flop (didn't bet)
Seat 5: shevliak folded before Flop (didn't bet)
Seat 6: floriiiiider folded before Flop


PokerStars Game #102612120454:  Hold'em No Limit ($3/$6 USD) - 2013/08/11 12:39:39 ET
Table 'Cydonia IX 40-100 bb' 6-max Seat #2 is the button
Seat 1: x_QUIXTAR_x ($1023 in chips) 
Seat 2: ilir3 ($823.83 in chips) 
Seat 3: Y-Yx777 ($844.10 in chips) 
Seat 4: patapong ($654.48 in chips) 
Seat 5: shevliak ($670.66 in chips) 
Seat 6: floriiiiider ($693.40 in chips) 
Y-Yx777: posts small blind $3
patapong: posts big blind $6
*** HOLE CARDS ***
shevliak: raises $12 to $18
floriiiiider: folds 
x_QUIXTAR_x: calls $18
ilir3: folds 
Y-Yx777: calls $15
patapong: folds 
*** FLOP *** [Td 8c 5s]
Y-Yx777: checks 
shevliak: bets $36.67
x_QUIXTAR_x: folds 
Y-Yx777: calls $36.67
*** TURN *** [Td 8c 5s] [7c]
Y-Yx777: checks 
shevliak: bets $83.54
Y-Yx777: calls $83.54
*** RIVER *** [Td 8c 5s 7c] [2c]
Y-Yx777: checks 
shevliak: bets $119.04
Y-Yx777: calls $119.04
*** SHOW DOWN ***
shevliak: shows [Kd Th] (a pair of Tens)
Y-Yx777: shows [7h 7d] (three of a kind, Sevens)
Y-Yx777 collected $535.70 from pot
*** SUMMARY ***
Total pot $538.50 | Rake $2.80 
Board [Td 8c 5s 7c 2c]
Seat 1: x_QUIXTAR_x folded on the Flop
Seat 2: ilir3 (button) folded before Flop (didn't bet)
Seat 3: Y-Yx777 (small blind) showed [7h 7d] and won ($535.70) with three of a kind, Sevens
Seat 4: patapong (big blind) folded before Flop
Seat 5: shevliak showed [Kd Th] and lost with a pair of Tens
Seat 6: floriiiiider folded before Flop (didn't bet)


PokerStars Game #102611698668:  Hold'em No Limit ($3/$6 USD) - 2013/08/11 12:30:25 ET
Table 'Cydonia IX 40-100 bb' 6-max Seat #3 is the button
Seat 1: x_QUIXTAR_x ($1173 in chips) 
Seat 2: ilir3 ($747.18 in chips) 
Seat 3: Y-Yx777 ($1154.93 in chips) 
Seat 4: patapong ($649.02 in chips) 
Seat 5: shevliak ($395.23 in chips) 
Seat 6: floriiiiider ($600 in chips) 
patapong: posts small blind $3
shevliak: posts big blind $6
*** HOLE CARDS ***
floriiiiider: folds 
x_QUIXTAR_x: folds 
ilir3: raises $6 to $12
Y-Yx777: calls $12
patapong: calls $9
shevliak: calls $6
*** FLOP *** [5c Kc Td]
patapong: checks 
shevliak: bets $33
ilir3: folds 
Y-Yx777: calls $33
patapong: folds 
*** TURN *** [5c Kc Td] [Th]
shevliak: bets $71.16
Y-Yx777: raises $126.84 to $198
shevliak: raises $126.84 to $324.84
Y-Yx777: raises $126.84 to $451.68
shevliak: calls $25.39 and is all-in
Uncalled bet ($101.45) returned to Y-Yx777
*** RIVER *** [5c Kc Td Th] [4c]
*** SHOW DOWN ***
shevliak: shows [Tc Kd] (a full house, Tens full of Kings)
Y-Yx777: shows [Ts Ad] (three of a kind, Tens)
shevliak collected $811.66 from pot
*** SUMMARY ***
Total pot $814.46 | Rake $2.80 
Board [5c Kc Td Th 4c]
Seat 1: x_QUIXTAR_x folded before Flop (didn't bet)
Seat 2: ilir3 folded on the Flop
Seat 3: Y-Yx777 (button) showed [Ts Ad] and lost with three of a kind, Tens
Seat 4: patapong (small blind) folded on the Flop
Seat 5: shevliak (big blind) showed [Tc Kd] and won ($811.66) with a full house, Tens full of Kings
Seat 6: floriiiiider folded before Flop (didn't bet)


PokerStars Game #102611781470:  Hold'em No Limit ($3/$6 USD) - 2013/08/11 12:32:14 ET
Table 'Cydonia IX 40-100 bb' 6-max Seat #4 is the button
Seat 1: x_QUIXTAR_x ($1173 in chips) 
Seat 2: ilir3 ($735.18 in chips) 
Seat 3: Y-Yx777 ($759.70 in chips) 
Seat 4: patapong ($637.02 in chips) 
Seat 5: shevliak ($811.66 in chips) 
Seat 6: floriiiiider ($600 in chips) 
shevliak: posts small blind $3
floriiiiider: posts big blind $6
*** HOLE CARDS ***
x_QUIXTAR_x: folds 
ilir3: folds 
Y-Yx777: folds 
patapong: raises $6 to $12
shevliak: folds 
floriiiiider: folds 
Uncalled bet ($6) returned to patapong
patapong collected $15 from pot
*** SUMMARY ***
Total pot $15 | Rake $0 
Seat 1: x_QUIXTAR_x folded before Flop (didn't bet)
Seat 2: ilir3 folded before Flop (didn't bet)
Seat 3: Y-Yx777 folded before Flop (didn't bet)
Seat 4: patapong (button) collected ($15)
Seat 5: shevliak (small blind) folded before Flop
Seat 6: floriiiiider (big blind) folded before Flop


PokerStars Game #102611806011:  Hold'em No Limit ($3/$6 USD) - 2013/08/11 12:32:46 ET
Table 'Cydonia IX 40-100 bb' 6-max Seat #5 is the button
Seat 1: x_QUIXTAR_x ($1173 in chips) 
Seat 2: ilir3 ($735.18 in chips) 
Seat 3: Y-Yx777 ($759.70 in chips) 
Seat 4: patapong ($646.02 in chips) 
Seat 5: shevliak ($808.66 in chips) 
Seat 6: floriiiiider ($600 in chips) 
floriiiiider: posts small blind $3
x_QUIXTAR_x: posts big blind $6
*** HOLE CARDS ***
ilir3: folds 
Y-Yx777: raises $6 to $12
patapong: folds 
shevliak: folds 
floriiiiider: calls $9
x_QUIXTAR_x: folds 
*** FLOP *** [Kd 7h 2s]
floriiiiider: checks 
Y-Yx777: bets $12
floriiiiider: calls $12
*** TURN *** [Kd 7h 2s] [5d]
floriiiiider: checks 
Y-Yx777: checks 
*** RIVER *** [Kd 7h 2s 5d] [Kc]
floriiiiider: bets $36
Y-Yx777: calls $36
*** SHOW DOWN ***
floriiiiider: shows [9h 9s] (two pair, Kings and Nines)
Y-Yx777: mucks hand 
floriiiiider collected $123.20 from pot
*** SUMMARY ***
Total pot $126 | Rake $2.80 
Board [Kd 7h 2s 5d Kc]
Seat 1: x_QUIXTAR_x (big blind) folded before Flop
Seat 2: ilir3 folded before Flop (didn't bet)
Seat 3: Y-Yx777 mucked
Seat 4: patapong folded before Flop (didn't bet)
Seat 5: shevliak (button) folded before Flop (didn't bet)
Seat 6: floriiiiider (small blind) showed [9h 9s] and won ($123.20) with two pair, Kings and Nines


PokerStars Game #102611861164:  Hold'em No Limit ($3/$6 USD) - 2013/08/11 12:33:58 ET
Table 'Cydonia IX 40-100 bb' 6-max Seat #6 is the button
Seat 1: x_QUIXTAR_x ($1167 in chips) 
Seat 2: ilir3 ($735.18 in chips) 
Seat 3: Y-Yx777 ($699.70 in chips) 
Seat 4: patapong ($646.02 in chips) 
Seat 5: shevliak ($808.66 in chips) 
Seat 6: floriiiiider ($663.20 in chips) 
x_QUIXTAR_x: posts small blind $3
ilir3: posts big blind $6
*** HOLE CARDS ***
Y-Yx777: raises $6 to $12
patapong: folds 
shevliak: raises $27 to $39
floriiiiider: folds 
x_QUIXTAR_x: folds 
ilir3: folds 
Y-Yx777: calls $27
*** FLOP *** [2d Td 3c]
Y-Yx777: checks 
shevliak: checks 
*** TURN *** [2d Td 3c] [Ac]
Y-Yx777: bets $30
shevliak: raises $60 to $90
Y-Yx777: raises $108 to $198
shevliak: folds 
Uncalled bet ($108) returned to Y-Yx777
Y-Yx777 collected $264.20 from pot
*** SUMMARY ***
Total pot $267 | Rake $2.80 
Board [2d Td 3c Ac]
Seat 1: x_QUIXTAR_x (small blind) folded before Flop
Seat 2: ilir3 (big blind) folded before Flop
Seat 3: Y-Yx777 collected ($264.20)
Seat 4: patapong folded before Flop (didn't bet)
Seat 5: shevliak folded on the Turn
Seat 6: floriiiiider (button) folded before Flop (didn't bet)


PokerStars Game #102611904331:  Hold'em No Limit ($3/$6 USD) - 2013/08/11 12:34:55 ET
Table 'Cydonia IX 40-100 bb' 6-max Seat #1 is the button
Seat 1: x_QUIXTAR_x ($1164 in chips) 
Seat 2: ilir3 ($729.18 in chips) 
Seat 3: Y-Yx777 ($834.90 in chips) 
Seat 4: patapong ($646.02 in chips) 
Seat 5: shevliak ($679.66 in chips) 
Seat 6: floriiiiider ($663.20 in chips) 
ilir3: posts small blind $3
Y-Yx777: posts big blind $6
*** HOLE CARDS ***
patapong: folds 
shevliak: folds 
floriiiiider: folds 
x_QUIXTAR_x: folds 
ilir3: calls $3
Y-Yx777: raises $12 to $18
ilir3: raises $48 to $66
Y-Yx777: folds 
Uncalled bet ($48) returned to ilir3
ilir3 collected $36 from pot
ilir3: doesn't show hand 
*** SUMMARY ***
Total pot $36 | Rake $0 
Seat 1: x_QUIXTAR_x (button) folded before Flop (didn't bet)
Seat 2: ilir3 (small blind) collected ($36)
Seat 3: Y-Yx777 (big blind) folded before Flop
Seat 4: patapong folded before Flop (didn't bet)
Seat 5: shevliak folded before Flop (didn't bet)
Seat 6: floriiiiider folded before Flop (didn't bet)


PokerStars Game #102611477797:  Hold'em No Limit ($3/$6 USD) - 2013/08/11 12:25:21 ET
Table 'Cydonia IX 40-100 bb' 6-max Seat #3 is the button
Seat 1: x_QUIXTAR_x ($1057.80 in chips) 
Seat 2: ilir3 ($862.18 in chips) 
Seat 3: Y-Yx777 ($1112.73 in chips) 
Seat 4: patapong ($673.02 in chips) 
Seat 5: shevliak ($368.21 in chips) 
patapong: posts small blind $3
shevliak: posts big blind $6
floriiiiider: sits out 
*** HOLE CARDS ***
x_QUIXTAR_x: folds 
ilir3: raises $6 to $12
Y-Yx777: folds 
patapong: folds 
shevliak: folds 
Uncalled bet ($6) returned to ilir3
ilir3 collected $15 from pot
ilir3: doesn't show hand 
*** SUMMARY ***
Total pot $15 | Rake $0 
Seat 1: x_QUIXTAR_x folded before Flop (didn't bet)
Seat 2: ilir3 collected ($15)
Seat 3: Y-Yx777 (button) folded before Flop (didn't bet)
Seat 4: patapong (small blind) folded before Flop
Seat 5: shevliak (big blind) folded before Flop


PokerStars Game #102611489567:  Hold'em No Limit ($3/$6 USD) - 2013/08/11 12:25:37 ET
Table 'Cydonia IX 40-100 bb' 6-max Seat #4 is the button
Seat 1: x_QUIXTAR_x ($1057.80 in chips) 
Seat 2: ilir3 ($871.18 in chips) 
Seat 3: Y-Yx777 ($1112.73 in chips) 
Seat 4: patapong ($670.02 in chips) 
Seat 5: shevliak ($362.21 in chips) 
Seat 6: floriiiiider ($600 in chips) 
shevliak: posts small blind $3
floriiiiider: posts big blind $6
*** HOLE CARDS ***
x_QUIXTAR_x: folds 
ilir3: raises $9 to $15
Y-Yx777: folds 
patapong: folds 
shevliak: folds 
floriiiiider: folds 
Uncalled bet ($9) returned to ilir3
ilir3 collected $15 from pot
*** SUMMARY ***
Total pot $15 | Rake $0 
Seat 1: x_QUIXTAR_x folded before Flop (didn't bet)
Seat 2: ilir3 collected ($15)
Seat 3: Y-Yx777 folded before Flop (didn't bet)
Seat 4: patapong (button) folded before Flop (didn't bet)
Seat 5: shevliak (small blind) folded before Flop
Seat 6: floriiiiider (big blind) folded before Flop


PokerStars Game #102611509613:  Hold'em No Limit ($3/$6 USD) - 2013/08/11 12:26:05 ET
Table 'Cydonia IX 40-100 bb' 6-max Seat #5 is the button
Seat 1: x_QUIXTAR_x ($1057.80 in chips) 
Seat 2: ilir3 ($880.18 in chips) 
Seat 3: Y-Yx777 ($1112.73 in chips) 
Seat 4: patapong ($670.02 in chips) 
Seat 5: shevliak ($359.21 in chips) 
Seat 6: floriiiiider ($600 in chips) 
floriiiiider: posts small blind $3
x_QUIXTAR_x: posts big blind $6
*** HOLE CARDS ***
ilir3: folds 
Y-Yx777: folds 
patapong: folds 
shevliak: raises $6 to $12
floriiiiider: folds 
x_QUIXTAR_x: calls $6
*** FLOP *** [Qc 2c Kc]
x_QUIXTAR_x: checks 
shevliak: bets $16.49
x_QUIXTAR_x: folds 
Uncalled bet ($16.49) returned to shevliak
shevliak collected $25.78 from pot
shevliak: doesn't show hand 
*** SUMMARY ***
Total pot $27 | Rake $1.22 
Board [Qc 2c Kc]
Seat 1: x_QUIXTAR_x (big blind) folded on the Flop
Seat 2: ilir3 folded before Flop (didn't bet)
Seat 3: Y-Yx777 folded before Flop (didn't bet)
Seat 4: patapong folded before Flop (didn't bet)
Seat 5: shevliak (button) collected ($25.78)
Seat 6: floriiiiider (small blind) folded before Flop


PokerStars Game #102611543820:  Hold'em No Limit ($3/$6 USD) - 2013/08/11 12:26:52 ET
Table 'Cydonia IX 40-100 bb' 6-max Seat #6 is the button
Seat 1: x_QUIXTAR_x ($1045.80 in chips) 
Seat 2: ilir3 ($880.18 in chips) 
Seat 3: Y-Yx777 ($1112.73 in chips) 
Seat 4: patapong ($670.02 in chips) 
Seat 5: shevliak ($372.99 in chips) 
Seat 6: floriiiiider ($600 in chips) 
x_QUIXTAR_x: posts small blind $3
ilir3: posts big blind $6
*** HOLE CARDS ***
Y-Yx777: folds 
patapong: raises $9 to $15
shevliak: calls $15
floriiiiider: folds 
x_QUIXTAR_x: folds 
ilir3: folds 
*** FLOP *** [As 4d 8s]
patapong: checks 
shevliak: bets $20.10
patapong: folds 
Uncalled bet ($20.10) returned to shevliak
shevliak collected $37.24 from pot
shevliak: doesn't show hand 
*** SUMMARY ***
Total pot $39 | Rake $1.76 
Board [As 4d 8s]
Seat 1: x_QUIXTAR_x (small blind) folded before Flop
Seat 2: ilir3 (big blind) folded before Flop
Seat 3: Y-Yx777 folded before Flop (didn't bet)
Seat 4: patapong folded on the Flop
Seat 5: shevliak collected ($37.24)
Seat 6: floriiiiider (button) folded before Flop (didn't bet)


PokerStars Game #102611581465:  Hold'em No Limit ($3/$6 USD) - 2013/08/11 12:27:44 ET
Table 'Cydonia IX 40-100 bb' 6-max Seat #1 is the button
Seat 1: x_QUIXTAR_x ($1042.80 in chips) 
Seat 2: ilir3 ($874.18 in chips) 
Seat 3: Y-Yx777 ($1112.73 in chips) 
Seat 4: patapong ($655.02 in chips) 
Seat 5: shevliak ($395.23 in chips) 
Seat 6: floriiiiider ($600 in chips) 
ilir3: posts small blind $3
Y-Yx777: posts big blind $6
*** HOLE CARDS ***
patapong: folds 
shevliak: folds 
floriiiiider: folds 
x_QUIXTAR_x: raises $7.50 to $13.50
ilir3: raises $41.50 to $55
Y-Yx777: folds 
x_QUIXTAR_x: calls $41.50
*** FLOP *** [7c 3s Ac]
ilir3: bets $72
x_QUIXTAR_x: calls $72
*** TURN *** [7c 3s Ac] [Qs]
ilir3: checks 
x_QUIXTAR_x: checks 
*** RIVER *** [7c 3s Ac Qs] [Jc]
ilir3: checks 
x_QUIXTAR_x: bets $100
ilir3: folds 
Uncalled bet ($100) returned to x_QUIXTAR_x
x_QUIXTAR_x collected $257.20 from pot
x_QUIXTAR_x: doesn't show hand 
*** SUMMARY ***
Total pot $260 | Rake $2.80 
Board [7c 3s Ac Qs Jc]
Seat 1: x_QUIXTAR_x (button) collected ($257.20)
Seat 2: ilir3 (small blind) folded on the River
Seat 3: Y-Yx777 (big blind) folded before Flop
Seat 4: patapong folded before Flop (didn't bet)
Seat 5: shevliak folded before Flop (didn't bet)
Seat 6: floriiiiider folded before Flop (didn't bet)


PokerStars Game #102611641850:  Hold'em No Limit ($3/$6 USD) - 2013/08/11 12:29:08 ET
Table 'Cydonia IX 40-100 bb' 6-max Seat #2 is the button
Seat 1: x_QUIXTAR_x ($1173 in chips) 
Seat 2: ilir3 ($747.18 in chips) 
Seat 3: Y-Yx777 ($1106.73 in chips) 
Seat 4: patapong ($655.02 in chips) 
Seat 5: shevliak ($395.23 in chips) 
Seat 6: floriiiiider ($600 in chips) 
Y-Yx777: posts small blind $3
patapong: posts big blind $6
*** HOLE CARDS ***
shevliak: folds 
floriiiiider: raises $12 to $18
x_QUIXTAR_x: folds 
ilir3: folds 
Y-Yx777: calls $15
patapong: folds 
*** FLOP *** [6c Ad 3d]
Y-Yx777: checks 
floriiiiider: bets $27
Y-Yx777: calls $27
*** TURN *** [6c Ad 3d] [3s]
Y-Yx777: checks 
floriiiiider: checks 
*** RIVER *** [6c Ad 3d 3s] [4h]
Y-Yx777: bets $54
floriiiiider: folds 
Uncalled bet ($54) returned to Y-Yx777
Y-Yx777 collected $93.20 from pot
*** SUMMARY ***
Total pot $96 | Rake $2.80 
Board [6c Ad 3d 3s 4h]
Seat 1: x_QUIXTAR_x folded before Flop (didn't bet)
Seat 2: ilir3 (button) folded before Flop (didn't bet)
Seat 3: Y-Yx777 (small blind) collected ($93.20)
Seat 4: patapong (big blind) folded before Flop
Seat 5: shevliak folded before Flop (didn't bet)
Seat 6: floriiiiider folded on the River


PokerStars Game #102611250939:  Hold'em No Limit ($3/$6 USD) - 2013/08/11 12:20:10 ET
Table 'Cydonia IX 40-100 bb' 6-max Seat #2 is the button
Seat 1: x_QUIXTAR_x ($1057.80 in chips) 
Seat 2: ilir3 ($804.40 in chips) 
Seat 3: Y-Yx777 ($1227.73 in chips) 
Seat 4: patapong ($600 in chips) 
Seat 5: shevliak ($389.21 in chips) 
Y-Yx777: posts small blind $3
patapong: posts big blind $6
*** HOLE CARDS ***
shevliak: folds 
x_QUIXTAR_x: folds 
ilir3: raises $6 to $12
Y-Yx777: raises $18 to $30
patapong: folds 
ilir3: calls $18
*** FLOP *** [Tc Jc Qd]
Y-Yx777: checks 
ilir3: checks 
*** TURN *** [Tc Jc Qd] [2s]
Y-Yx777: checks 
ilir3: checks 
*** RIVER *** [Tc Jc Qd 2s] [4d]
Y-Yx777: bets $36
ilir3: calls $36
*** SHOW DOWN ***
Y-Yx777: shows [Ah 9s] (high card Ace)
ilir3: shows [Jd Ad] (a pair of Jacks)
ilir3 collected $135.20 from pot
*** SUMMARY ***
Total pot $138 | Rake $2.80 
Board [Tc Jc Qd 2s 4d]
Seat 1: x_QUIXTAR_x folded before Flop (didn't bet)
Seat 2: ilir3 (button) showed [Jd Ad] and won ($135.20) with a pair of Jacks
Seat 3: Y-Yx777 (small blind) showed [Ah 9s] and lost with high card Ace
Seat 4: patapong (big blind) folded before Flop
Seat 5: shevliak folded before Flop (didn't bet)


PokerStars Game #102611291315:  Hold'em No Limit ($3/$6 USD) - 2013/08/11 12:21:05 ET
Table 'Cydonia IX 40-100 bb' 6-max Seat #3 is the button
Seat 1: x_QUIXTAR_x ($1057.80 in chips) 
Seat 2: ilir3 ($873.60 in chips) 
Seat 3: Y-Yx777 ($1161.73 in chips) 
Seat 4: patapong ($600 in chips) 
Seat 5: shevliak ($389.21 in chips) 
patapong: posts small blind $3
shevliak: posts big blind $6
*** HOLE CARDS ***
x_QUIXTAR_x: folds 
LuckyBiitch leaves the table
ilir3: raises $6 to $12
Y-Yx777: folds 
patapong: calls $9
shevliak: folds 
*** FLOP *** [4d Ad Kc]
patapong: checks 
ilir3: checks 
*** TURN *** [4d Ad Kc] [6s]
patapong: bets $18.62
ilir3: calls $18.62
*** RIVER *** [4d Ad Kc 6s] [Qh]
patapong: checks 
ilir3: checks 
*** SHOW DOWN ***
patapong: shows [Kd 5s] (a pair of Kings)
ilir3: mucks hand 
patapong collected $64.44 from pot
*** SUMMARY ***
Total pot $67.24 | Rake $2.80 
Board [4d Ad Kc 6s Qh]
Seat 1: x_QUIXTAR_x folded before Flop (didn't bet)
Seat 2: ilir3 mucked
Seat 3: Y-Yx777 (button) folded before Flop (didn't bet)
Seat 4: patapong (small blind) showed [Kd 5s] and won ($64.44) with a pair of Kings
Seat 5: shevliak (big blind) folded before Flop


PokerStars Game #102611320339:  Hold'em No Limit ($3/$6 USD) - 2013/08/11 12:21:45 ET
Table 'Cydonia IX 40-100 bb' 6-max Seat #4 is the button
Seat 1: x_QUIXTAR_x ($1057.80 in chips) 
Seat 2: ilir3 ($842.98 in chips) 
Seat 3: Y-Yx777 ($1161.73 in chips) 
Seat 4: patapong ($633.82 in chips) 
Seat 5: shevliak ($383.21 in chips) 
shevliak: posts small blind $3
x_QUIXTAR_x: posts big blind $6
*** HOLE CARDS ***
ilir3: raises $9 to $15
Y-Yx777: folds 
patapong: calls $15
shevliak: folds 
x_QUIXTAR_x: folds 
*** FLOP *** [Kc As 4h]
floriiiiider joins the table at seat #6 
ilir3: bets $24
patapong: calls $24
*** TURN *** [Kc As 4h] [8d]
ilir3: checks 
patapong: checks 
*** RIVER *** [Kc As 4h 8d] [Td]
ilir3: checks 
patapong: bets $114
ilir3: folds 
Uncalled bet ($114) returned to patapong
patapong collected $84.20 from pot
*** SUMMARY ***
Total pot $87 | Rake $2.80 
Board [Kc As 4h 8d Td]
Seat 1: x_QUIXTAR_x (big blind) folded before Flop
Seat 2: ilir3 folded on the River
Seat 3: Y-Yx777 folded before Flop (didn't bet)
Seat 4: patapong (button) collected ($84.20)
Seat 5: shevliak (small blind) folded before Flop


PokerStars Game #102611394079:  Hold'em No Limit ($3/$6 USD) - 2013/08/11 12:23:26 ET
Table 'Cydonia IX 40-100 bb' 6-max Seat #5 is the button
Seat 1: x_QUIXTAR_x ($1051.80 in chips) 
Seat 2: ilir3 ($803.98 in chips) 
Seat 3: Y-Yx777 ($1161.73 in chips) 
Seat 4: patapong ($679.02 in chips) 
Seat 5: shevliak ($380.21 in chips) 
floriiiiider will be allowed to play after the button
x_QUIXTAR_x: posts small blind $3
ilir3: posts big blind $6
*** HOLE CARDS ***
Y-Yx777: raises $6 to $12
patapong: folds 
shevliak: calls $12
x_QUIXTAR_x: folds 
ilir3: calls $6
*** FLOP *** [3h Ac Td]
ilir3: checks 
Y-Yx777: checks 
shevliak: checks 
*** TURN *** [3h Ac Td] [Jh]
ilir3: bets $28
Y-Yx777: calls $28
shevliak: folds 
*** RIVER *** [3h Ac Td Jh] [4d]
ilir3: bets $72
Y-Yx777: folds 
Uncalled bet ($72) returned to ilir3
ilir3 collected $92.20 from pot
ilir3: doesn't show hand 
*** SUMMARY ***
Total pot $95 | Rake $2.80 
Board [3h Ac Td Jh 4d]
Seat 1: x_QUIXTAR_x (small blind) folded before Flop
Seat 2: ilir3 (big blind) collected ($92.20)
Seat 3: Y-Yx777 folded on the River
Seat 4: patapong folded before Flop (didn't bet)
Seat 5: shevliak (button) folded on the Turn


PokerStars Game #102611444826:  Hold'em No Limit ($3/$6 USD) - 2013/08/11 12:24:35 ET
Table 'Cydonia IX 40-100 bb' 6-max Seat #1 is the button
Seat 1: x_QUIXTAR_x ($1048.80 in chips) 
Seat 2: ilir3 ($856.18 in chips) 
Seat 3: Y-Yx777 ($1121.73 in chips) 
Seat 4: patapong ($679.02 in chips) 
Seat 5: shevliak ($368.21 in chips) 
ilir3: posts small blind $3
Y-Yx777: posts big blind $6
floriiiiider: sits out 
*** HOLE CARDS ***
patapong: folds 
shevliak: folds 
x_QUIXTAR_x: raises $7.50 to $13.50
ilir3: folds 
Y-Yx777: folds 
Uncalled bet ($7.50) returned to x_QUIXTAR_x
x_QUIXTAR_x collected $15 from pot
*** SUMMARY ***
Total pot $15 | Rake $0 
Seat 1: x_QUIXTAR_x (button) collected ($15)
Seat 2: ilir3 (small blind) folded before Flop
Seat 3: Y-Yx777 (big blind) folded before Flop
Seat 4: patapong folded before Flop (didn't bet)
Seat 5: shevliak folded before Flop (didn't bet)


PokerStars Game #102611456884:  Hold'em No Limit ($3/$6 USD) - 2013/08/11 12:24:52 ET
Table 'Cydonia IX 40-100 bb' 6-max Seat #2 is the button
Seat 1: x_QUIXTAR_x ($1057.80 in chips) 
Seat 2: ilir3 ($853.18 in chips) 
Seat 3: Y-Yx777 ($1115.73 in chips) 
Seat 4: patapong ($679.02 in chips) 
Seat 5: shevliak ($368.21 in chips) 
Y-Yx777: posts small blind $3
patapong: posts big blind $6
floriiiiider: sits out 
*** HOLE CARDS ***
shevliak: folds 
x_QUIXTAR_x: folds 
ilir3: raises $6 to $12
Y-Yx777: folds 
patapong: folds 
Uncalled bet ($6) returned to ilir3
ilir3 collected $15 from pot
*** SUMMARY ***
Total pot $15 | Rake $0 
Seat 1: x_QUIXTAR_x folded before Flop (didn't bet)
Seat 2: ilir3 (button) collected ($15)
Seat 3: Y-Yx777 (small blind) folded before Flop
Seat 4: patapong (big blind) folded before Flop
Seat 5: shevliak folded before Flop (didn't bet)


PokerStars Game #102611070128:  Hold'em No Limit ($3/$6 USD) - 2013/08/11 12:16:02 ET
Table 'Cydonia IX 40-100 bb' 6-max Seat #3 is the button
Seat 1: x_QUIXTAR_x ($1080.30 in chips) 
Seat 2: ilir3 ($600 in chips) 
Seat 3: Y-Yx777 ($1194.53 in chips) 
Seat 4: patapong ($600 in chips) 
Seat 5: shevliak ($609.71 in chips) 
patapong: posts small blind $3
shevliak: posts big blind $6
*** HOLE CARDS ***
x_QUIXTAR_x: raises $7.50 to $13.50
ilir3: calls $13.50
Y-Yx777: folds 
patapong: folds 
shevliak: calls $7.50
*** FLOP *** [As 7c 5s]
shevliak: checks 
x_QUIXTAR_x: checks 
ilir3: bets $28
shevliak: calls $28
x_QUIXTAR_x: folds 
*** TURN *** [As 7c 5s] [7h]
shevliak: checks 
ilir3: bets $68
shevliak: calls $68
*** RIVER *** [As 7c 5s 7h] [8s]
shevliak: checks 
ilir3: checks 
*** SHOW DOWN ***
shevliak: shows [Ac 9c] (two pair, Aces and Sevens)
ilir3: shows [Qd Ah] (two pair, Aces and Sevens - Queen kicker)
ilir3 collected $232.70 from pot
*** SUMMARY ***
Total pot $235.50 | Rake $2.80 
Board [As 7c 5s 7h 8s]
Seat 1: x_QUIXTAR_x folded on the Flop
Seat 2: ilir3 showed [Qd Ah] and won ($232.70) with two pair, Aces and Sevens
Seat 3: Y-Yx777 (button) folded before Flop (didn't bet)
Seat 4: patapong (small blind) folded before Flop
Seat 5: shevliak (big blind) showed [Ac 9c] and lost with two pair, Aces and Sevens


PokerStars Game #102611119113:  Hold'em No Limit ($3/$6 USD) - 2013/08/11 12:17:09 ET
Table 'Cydonia IX 40-100 bb' 6-max Seat #4 is the button
Seat 1: x_QUIXTAR_x ($1066.80 in chips) 
Seat 2: ilir3 ($723.20 in chips) 
Seat 3: Y-Yx777 ($1194.53 in chips) 
Seat 4: patapong ($600 in chips) 
Seat 5: shevliak ($500.21 in chips) 
shevliak: posts small blind $3
x_QUIXTAR_x: posts big blind $6
*** HOLE CARDS ***
ilir3: raises $9 to $15
Y-Yx777: folds 
patapong: folds 
shevliak: folds 
x_QUIXTAR_x: folds 
Uncalled bet ($9) returned to ilir3
ilir3 collected $15 from pot
ilir3: doesn't show hand 
*** SUMMARY ***
Total pot $15 | Rake $0 
Seat 1: x_QUIXTAR_x (big blind) folded before Flop
Seat 2: ilir3 collected ($15)
Seat 3: Y-Yx777 folded before Flop (didn't bet)
Seat 4: patapong (button) folded before Flop (didn't bet)
Seat 5: shevliak (small blind) folded before Flop


PokerStars Game #102611138386:  Hold'em No Limit ($3/$6 USD) - 2013/08/11 12:17:36 ET
Table 'Cydonia IX 40-100 bb' 6-max Seat #5 is the button
Seat 1: x_QUIXTAR_x ($1060.80 in chips) 
Seat 2: ilir3 ($732.20 in chips) 
Seat 3: Y-Yx777 ($1194.53 in chips) 
Seat 4: patapong ($600 in chips) 
Seat 5: shevliak ($497.21 in chips) 
x_QUIXTAR_x: posts small blind $3
ilir3: posts big blind $6
*** HOLE CARDS ***
Y-Yx777: folds 
patapong: folds 
shevliak: raises $6 to $12
x_QUIXTAR_x: folds 
ilir3: raises $36 to $48
shevliak: calls $36
*** FLOP *** [Jd Kc 9s]
ilir3: bets $60
shevliak: calls $60
*** TURN *** [Jd Kc 9s] [8c]
ilir3: bets $140
shevliak: folds 
Uncalled bet ($140) returned to ilir3
ilir3 collected $216.20 from pot
*** SUMMARY ***
Total pot $219 | Rake $2.80 
Board [Jd Kc 9s 8c]
Seat 1: x_QUIXTAR_x (small blind) folded before Flop
Seat 2: ilir3 (big blind) collected ($216.20)
Seat 3: Y-Yx777 folded before Flop (didn't bet)
Seat 4: patapong folded before Flop (didn't bet)
Seat 5: shevliak (button) folded on the Turn


PokerStars Game #102611190440:  Hold'em No Limit ($3/$6 USD) - 2013/08/11 12:18:47 ET
Table 'Cydonia IX 40-100 bb' 6-max Seat #1 is the button
Seat 1: x_QUIXTAR_x ($1057.80 in chips) 
Seat 2: ilir3 ($840.40 in chips) 
Seat 3: Y-Yx777 ($1194.53 in chips) 
Seat 4: patapong ($600 in chips) 
Seat 5: shevliak ($389.21 in chips) 
ilir3: posts small blind $3
Y-Yx777: posts big blind $6
*** HOLE CARDS ***
patapong: folds 
shevliak: folds 
x_QUIXTAR_x: folds 
ilir3: calls $3
Y-Yx777 is disconnected 
Y-Yx777 is connected 
Y-Yx777: raises $12 to $18
ilir3: calls $12
*** FLOP *** [2h 6c 5h]
ilir3: checks 
Y-Yx777: checks 
*** TURN *** [2h 6c 5h] [4s]
ilir3: bets $18
Y-Yx777: calls $18
*** RIVER *** [2h 6c 5h 4s] [Ac]
ilir3: checks 
Y-Yx777: bets $30
ilir3: folds 
Uncalled bet ($30) returned to Y-Yx777
Y-Yx777 collected $69.20 from pot
*** SUMMARY ***
Total pot $72 | Rake $2.80 
Board [2h 6c 5h 4s Ac]
Seat 1: x_QUIXTAR_x (button) folded before Flop (didn't bet)
Seat 2: ilir3 (small blind) folded on the River
Seat 3: Y-Yx777 (big blind) collected ($69.20)
Seat 4: patapong folded before Flop (didn't bet)
Seat 5: shevliak folded before Flop (didn't bet)


PokerStars Game #102613224593:  Hold'em No Limit ($3/$6 USD) - 2013/08/11 13:05:39 ET
Table 'Cydonia IX 40-100 bb' 6-max Seat #6 is the button
Seat 1: x_QUIXTAR_x ($2219.10 in chips) 
Seat 2: Flying Smile ($672.20 in chips) 
Seat 3: Y-Yx777 ($1102.05 in chips) 
Seat 4: patapong ($963.57 in chips) 
Seat 5: shevliak ($240 in chips) 
Seat 6: floriiiiider ($687.20 in chips) 
x_QUIXTAR_x: posts small blind $3
Flying Smile: posts big blind $6
*** HOLE CARDS ***
Y-Yx777: raises $6 to $12
shevliak said, "ty?"
Y-Yx777 said, "v Ozerax byl?"
patapong has timed out while disconnected
patapong: folds 
shevliak: folds 
floriiiiider: raises $36 to $48
shevliak said, "nea"
x_QUIXTAR_x: folds 
Flying Smile: folds 
Y-Yx777: calls $36
*** FLOP *** [2s 6d 7s]
Y-Yx777: checks 
floriiiiider: bets $72
Y-Yx777: calls $72
*** TURN *** [2s 6d 7s] [Ad]
Y-Yx777: checks 
floriiiiider: checks 
*** RIVER *** [2s 6d 7s Ad] [Kc]
Y-Yx777: bets $84
floriiiiider: calls $84
*** SHOW DOWN ***
Y-Yx777: shows [6h 6c] (three of a kind, Sixes)
floriiiiider: mucks hand 
Y-Yx777 collected $414.20 from pot
*** SUMMARY ***
Total pot $417 | Rake $2.80 
Board [2s 6d 7s Ad Kc]
Seat 1: x_QUIXTAR_x (small blind) folded before Flop
Seat 2: Flying Smile (big blind) folded before Flop
Seat 3: Y-Yx777 showed [6h 6c] and won ($414.20) with three of a kind, Sixes
Seat 4: patapong folded before Flop (didn't bet)
Seat 5: shevliak folded before Flop (didn't bet)
Seat 6: floriiiiider (button) mucked


PokerStars Game #102613296373:  Hold'em No Limit ($3/$6 USD) - 2013/08/11 13:07:10 ET
Table 'Cydonia IX 40-100 bb' 6-max Seat #1 is the button
Seat 1: x_QUIXTAR_x ($2216.10 in chips) 
Seat 2: Flying Smile ($666.20 in chips) 
Seat 3: Y-Yx777 ($1312.25 in chips) 
Seat 5: shevliak ($240 in chips) 
Seat 6: floriiiiider ($600 in chips) 
Flying Smile: posts small blind $3
Y-Yx777: posts big blind $6
*** HOLE CARDS ***
shevliak: folds 
floriiiiider: folds 
x_QUIXTAR_x: folds 
Flying Smile: raises $12 to $18
Y-Yx777: folds 
Uncalled bet ($12) returned to Flying Smile
Flying Smile collected $12 from pot
*** SUMMARY ***
Total pot $12 | Rake $0 
Seat 1: x_QUIXTAR_x (button) folded before Flop (didn't bet)
Seat 2: Flying Smile (small blind) collected ($12)
Seat 3: Y-Yx777 (big blind) folded before Flop
Seat 5: shevliak folded before Flop (didn't bet)
Seat 6: floriiiiider folded before Flop (didn't bet)


PokerStars Game #102613316703:  Hold'em No Limit ($3/$6 USD) - 2013/08/11 13:07:36 ET
Table 'Cydonia IX 40-100 bb' 6-max Seat #2 is the button
Seat 1: x_QUIXTAR_x ($2216.10 in chips) 
Seat 2: Flying Smile ($672.20 in chips) 
Seat 3: Y-Yx777 ($1306.25 in chips) 
Seat 5: shevliak ($240 in chips) 
Seat 6: floriiiiider ($600 in chips) 
Y-Yx777: posts small blind $3
shevliak: posts big blind $6
*** HOLE CARDS ***
floriiiiider: folds 
x_QUIXTAR_x: folds 
Flying Smile: raises $6 to $12
Y-Yx777: calls $9
shevliak: folds 
*** FLOP *** [As 3s Qs]
Y-Yx777: checks 
Flying Smile: bets $18
Y-Yx777: folds 
Uncalled bet ($18) returned to Flying Smile
Flying Smile collected $28.65 from pot
*** SUMMARY ***
Total pot $30 | Rake $1.35 
Board [As 3s Qs]
Seat 1: x_QUIXTAR_x folded before Flop (didn't bet)
Seat 2: Flying Smile (button) collected ($28.65)
Seat 3: Y-Yx777 (small blind) folded on the Flop
Seat 5: shevliak (big blind) folded before Flop
Seat 6: floriiiiider folded before Flop (didn't bet)


PokerStars Game #102613361432:  Hold'em No Limit ($3/$6 USD) - 2013/08/11 13:08:33 ET
Table 'Cydonia IX 40-100 bb' 6-max Seat #3 is the button
Seat 1: x_QUIXTAR_x ($2216.10 in chips) 
Seat 2: Flying Smile ($688.85 in chips) 
Seat 3: Y-Yx777 ($1294.25 in chips) 
Seat 5: shevliak ($240 in chips) 
Seat 6: floriiiiider ($600 in chips) 
shevliak: posts small blind $3
floriiiiider: posts big blind $6
*** HOLE CARDS ***
x_QUIXTAR_x: folds 
Flying Smile: folds 
Y-Yx777: folds 
shevliak: raises $7.08 to $13.08
floriiiiider: calls $7.08
*** FLOP *** [4c 3c 9s]
shevliak: bets $15.98
floriiiiider: calls $15.98
*** TURN *** [4c 3c 9s] [Qs]
shevliak: checks 
floriiiiider: checks 
*** RIVER *** [4c 3c 9s Qs] [Ac]
shevliak: checks 
floriiiiider: bets $39
shevliak: folds 
Uncalled bet ($39) returned to floriiiiider
floriiiiider collected $55.50 from pot
floriiiiider: doesn't show hand 
*** SUMMARY ***
Total pot $58.12 | Rake $2.62 
Board [4c 3c 9s Qs Ac]
Seat 1: x_QUIXTAR_x folded before Flop (didn't bet)
Seat 2: Flying Smile folded before Flop (didn't bet)
Seat 3: Y-Yx777 (button) folded before Flop (didn't bet)
Seat 5: shevliak (small blind) folded on the River
Seat 6: floriiiiider (big blind) collected ($55.50)


PokerStars Game #102613388688:  Hold'em No Limit ($3/$6 USD) - 2013/08/11 13:09:08 ET
Table 'Cydonia IX 40-100 bb' 6-max Seat #5 is the button
Seat 1: x_QUIXTAR_x ($2216.10 in chips) 
Seat 2: Flying Smile ($688.85 in chips) 
Seat 3: Y-Yx777 ($1294.25 in chips) 
Seat 5: shevliak ($240 in chips) 
Seat 6: floriiiiider ($626.44 in chips) 
floriiiiider: posts small blind $3
x_QUIXTAR_x: posts big blind $6
*** HOLE CARDS ***
Flying Smile: folds 
Y-Yx777: folds 
shevliak: raises $6 to $12
floriiiiider: folds 
x_QUIXTAR_x: folds 
Uncalled bet ($6) returned to shevliak
shevliak collected $15 from pot
shevliak: doesn't show hand 
*** SUMMARY ***
Total pot $15 | Rake $0 
Seat 1: x_QUIXTAR_x (big blind) folded before Flop
Seat 2: Flying Smile folded before Flop (didn't bet)
Seat 3: Y-Yx777 folded before Flop (didn't bet)
Seat 5: shevliak (button) collected ($15)
Seat 6: floriiiiider (small blind) folded before Flop


PokerStars Game #102613408996:  Hold'em No Limit ($3/$6 USD) - 2013/08/11 13:09:34 ET
Table 'Cydonia IX 40-100 bb' 6-max Seat #6 is the button
Seat 1: x_QUIXTAR_x ($2210.10 in chips) 
Seat 2: Flying Smile ($688.85 in chips) 
Seat 3: Y-Yx777 ($1294.25 in chips) 
Seat 5: shevliak ($249 in chips) 
Seat 6: floriiiiider ($623.44 in chips) 
x_QUIXTAR_x: posts small blind $3
Flying Smile: posts big blind $6
*** HOLE CARDS ***
Y-Yx777: folds 
shevliak: folds 
floriiiiider: raises $6 to $12
x_QUIXTAR_x: folds 
Flying Smile: calls $6
*** FLOP *** [6h 8c 2c]
Flying Smile: checks 
floriiiiider: checks 
*** TURN *** [6h 8c 2c] [9c]
Flying Smile: checks 
floriiiiider: checks 
*** RIVER *** [6h 8c 2c 9c] [6d]
Flying Smile: bets $21
floriiiiider: folds 
Uncalled bet ($21) returned to Flying Smile
Flying Smile collected $25.78 from pot
*** SUMMARY ***
Total pot $27 | Rake $1.22 
Board [6h 8c 2c 9c 6d]
Seat 1: x_QUIXTAR_x (small blind) folded before Flop
Seat 2: Flying Smile (big blind) collected ($25.78)
Seat 3: Y-Yx777 folded before Flop (didn't bet)
Seat 5: shevliak folded before Flop (didn't bet)
Seat 6: floriiiiider (button) folded on the River


PokerStars Game #102612870548:  Hold'em No Limit ($3/$6 USD) - 2013/08/11 12:56:36 ET
Table 'Cydonia IX 40-100 bb' 6-max Seat #6 is the button
Seat 1: x_QUIXTAR_x ($1876 in chips) 
Seat 3: Y-Yx777 ($1258.85 in chips) 
Seat 4: patapong ($600 in chips) 
Seat 5: shevliak ($402.37 in chips) 
Seat 6: floriiiiider ($600 in chips) 
x_QUIXTAR_x: posts small blind $3
ilir3: is sitting out 
Y-Yx777: posts big blind $6
*** HOLE CARDS ***
patapong: folds 
shevliak: raises $9 to $15
floriiiiider: folds 
ilir3 leaves the table
x_QUIXTAR_x: raises $15 to $30
Y-Yx777: folds 
shevliak: calls $15
*** FLOP *** [6d 6c Qd]
x_QUIXTAR_x: bets $30
shevliak: folds 
Uncalled bet ($30) returned to x_QUIXTAR_x
x_QUIXTAR_x collected $63.20 from pot
x_QUIXTAR_x: doesn't show hand 
*** SUMMARY ***
Total pot $66 | Rake $2.80 
Board [6d 6c Qd]
Seat 1: x_QUIXTAR_x (small blind) collected ($63.20)
Seat 3: Y-Yx777 (big blind) folded before Flop
Seat 4: patapong folded before Flop (didn't bet)
Seat 5: shevliak folded on the Flop
Seat 6: floriiiiider (button) folded before Flop (didn't bet)


PokerStars Game #102612894301:  Hold'em No Limit ($3/$6 USD) - 2013/08/11 12:57:22 ET
Table 'Cydonia IX 40-100 bb' 6-max Seat #1 is the button
Seat 1: x_QUIXTAR_x ($1909.20 in chips) 
Seat 3: Y-Yx777 ($1252.85 in chips) 
Seat 4: patapong ($600 in chips) 
Seat 5: shevliak ($372.37 in chips) 
Seat 6: floriiiiider ($600 in chips) 
Y-Yx777: posts small blind $3
patapong: posts big blind $6
*** HOLE CARDS ***
shevliak: folds 
floriiiiider: folds 
x_QUIXTAR_x: raises $7.50 to $13.50
Y-Yx777: calls $10.50
patapong: folds 
*** FLOP *** [Ad Kd Ah]
Y-Yx777: checks 
x_QUIXTAR_x: bets $30
Y-Yx777: calls $30
*** TURN *** [Ad Kd Ah] [2h]
Y-Yx777: checks 
x_QUIXTAR_x: bets $150
Y-Yx777: folds 
Uncalled bet ($150) returned to x_QUIXTAR_x
x_QUIXTAR_x collected $90.20 from pot
x_QUIXTAR_x: doesn't show hand 
*** SUMMARY ***
Total pot $93 | Rake $2.80 
Board [Ad Kd Ah 2h]
Seat 1: x_QUIXTAR_x (button) collected ($90.20)
Seat 3: Y-Yx777 (small blind) folded on the Turn
Seat 4: patapong (big blind) folded before Flop
Seat 5: shevliak folded before Flop (didn't bet)
Seat 6: floriiiiider folded before Flop (didn't bet)


PokerStars Game #102612918262:  Hold'em No Limit ($3/$6 USD) - 2013/08/11 12:58:08 ET
Table 'Cydonia IX 40-100 bb' 6-max Seat #3 is the button
Seat 1: x_QUIXTAR_x ($1955.90 in chips) 
Seat 3: Y-Yx777 ($1209.35 in chips) 
Seat 4: patapong ($600 in chips) 
Seat 5: shevliak ($372.37 in chips) 
Seat 6: floriiiiider ($600 in chips) 
patapong: posts small blind $3
shevliak: posts big blind $6
*** HOLE CARDS ***
floriiiiider: folds 
x_QUIXTAR_x: folds 
Y-Yx777: raises $6 to $12
patapong: folds 
Flying Smile joins the table at seat #2 
shevliak: raises $27 to $39
Y-Yx777: folds 
Uncalled bet ($27) returned to shevliak
shevliak collected $27 from pot
shevliak: doesn't show hand 
*** SUMMARY ***
Total pot $27 | Rake $0 
Seat 1: x_QUIXTAR_x folded before Flop (didn't bet)
Seat 3: Y-Yx777 (button) folded before Flop
Seat 4: patapong (small blind) folded before Flop
Seat 5: shevliak (big blind) collected ($27)
Seat 6: floriiiiider folded before Flop (didn't bet)


PokerStars Game #102612929695:  Hold'em No Limit ($3/$6 USD) - 2013/08/11 12:58:30 ET
Table 'Cydonia IX 40-100 bb' 6-max Seat #4 is the button
Seat 1: x_QUIXTAR_x ($1955.90 in chips) 
Seat 3: Y-Yx777 ($1197.35 in chips) 
Seat 4: patapong ($600 in chips) 
Seat 5: shevliak ($387.37 in chips) 
Seat 6: floriiiiider ($600 in chips) 
shevliak: posts small blind $3
floriiiiider: posts big blind $6
Flying Smile: sits out 
*** HOLE CARDS ***
x_QUIXTAR_x: folds 
Y-Yx777: folds 
patapong: raises $6 to $12
shevliak: folds 
floriiiiider: folds 
Uncalled bet ($6) returned to patapong
patapong collected $15 from pot
*** SUMMARY ***
Total pot $15 | Rake $0 
Seat 1: x_QUIXTAR_x folded before Flop (didn't bet)
Seat 3: Y-Yx777 folded before Flop (didn't bet)
Seat 4: patapong (button) collected ($15)
Seat 5: shevliak (small blind) folded before Flop
Seat 6: floriiiiider (big blind) folded before Flop


PokerStars Game #102612941309:  Hold'em No Limit ($3/$6 USD) - 2013/08/11 12:58:52 ET
Table 'Cydonia IX 40-100 bb' 6-max Seat #5 is the button
Seat 1: x_QUIXTAR_x ($1955.90 in chips) 
Seat 3: Y-Yx777 ($1197.35 in chips) 
Seat 4: patapong ($609 in chips) 
Seat 5: shevliak ($384.37 in chips) 
Seat 6: floriiiiider ($600 in chips) 
floriiiiider: posts small blind $3
x_QUIXTAR_x: posts big blind $6
Flying Smile: sits out 
*** HOLE CARDS ***
Y-Yx777: raises $6 to $12
patapong: folds 
shevliak: folds 
floriiiiider: folds 
x_QUIXTAR_x: calls $6
*** FLOP *** [As Qc Kd]
x_QUIXTAR_x: checks 
Y-Yx777: bets $12
x_QUIXTAR_x: calls $12
*** TURN *** [As Qc Kd] [Th]
x_QUIXTAR_x: checks 
Y-Yx777: bets $24
x_QUIXTAR_x: folds 
Uncalled bet ($24) returned to Y-Yx777
Y-Yx777 collected $48.70 from pot
*** SUMMARY ***
Total pot $51 | Rake $2.30 
Board [As Qc Kd Th]
Seat 1: x_QUIXTAR_x (big blind) folded on the Turn
Seat 3: Y-Yx777 collected ($48.70)
Seat 4: patapong folded before Flop (didn't bet)
Seat 5: shevliak (button) folded before Flop (didn't bet)
Seat 6: floriiiiider (small blind) folded before Flop


PokerStars Game #102612959919:  Hold'em No Limit ($3/$6 USD) - 2013/08/11 12:59:27 ET
Table 'Cydonia IX 40-100 bb' 6-max Seat #6 is the button
Seat 1: x_QUIXTAR_x ($1931.90 in chips) 
Seat 2: Flying Smile ($600 in chips) 
Seat 3: Y-Yx777 ($1222.05 in chips) 
Seat 4: patapong ($609 in chips) 
Seat 5: shevliak ($384.37 in chips) 
Seat 6: floriiiiider ($600 in chips) 
x_QUIXTAR_x: posts small blind $3
Flying Smile: posts big blind $6
*** HOLE CARDS ***
Y-Yx777: folds 
patapong: raises $9 to $15
shevliak: folds 
floriiiiider: calls $15
x_QUIXTAR_x: folds 
Flying Smile: folds 
*** FLOP *** [5h Qc Th]
patapong: bets $24.21
floriiiiider: folds 
Uncalled bet ($24.21) returned to patapong
patapong collected $37.24 from pot
*** SUMMARY ***
Total pot $39 | Rake $1.76 
Board [5h Qc Th]
Seat 1: x_QUIXTAR_x (small blind) folded before Flop
Seat 2: Flying Smile (big blind) folded before Flop
Seat 3: Y-Yx777 folded before Flop (didn't bet)
Seat 4: patapong collected ($37.24)
Seat 5: shevliak folded before Flop (didn't bet)
Seat 6: floriiiiider (button) folded on the Flop


PokerStars Game #102612983805:  Hold'em No Limit ($3/$6 USD) - 2013/08/11 13:00:08 ET
Table 'Cydonia IX 40-100 bb' 6-max Seat #1 is the button
Seat 1: x_QUIXTAR_x ($1928.90 in chips) 
Seat 2: Flying Smile ($600 in chips) 
Seat 3: Y-Yx777 ($1222.05 in chips) 
Seat 4: patapong ($631.24 in chips) 
Seat 5: shevliak ($384.37 in chips) 
Seat 6: floriiiiider ($600 in chips) 
Flying Smile: posts small blind $3
Y-Yx777: posts big blind $6
*** HOLE CARDS ***
patapong: raises $9 to $15
shevliak: folds 
floriiiiider: folds 
x_QUIXTAR_x: raises $20 to $35
Flying Smile: folds 
Y-Yx777: folds 
patapong: calls $20
*** FLOP *** [6c Td Ac]
patapong: checks 
x_QUIXTAR_x: bets $75
patapong: calls $75
*** TURN *** [6c Td Ac] [6h]
patapong: checks 
x_QUIXTAR_x: bets $180
patapong: calls $180
*** RIVER *** [6c Td Ac 6h] [5d]
patapong: checks 
x_QUIXTAR_x: bets $355
patapong: folds 
Uncalled bet ($355) returned to x_QUIXTAR_x
x_QUIXTAR_x collected $586.20 from pot
x_QUIXTAR_x: doesn't show hand 
*** SUMMARY ***
Total pot $589 | Rake $2.80 
Board [6c Td Ac 6h 5d]
Seat 1: x_QUIXTAR_x (button) collected ($586.20)
Seat 2: Flying Smile (small blind) folded before Flop
Seat 3: Y-Yx777 (big blind) folded before Flop
Seat 4: patapong folded on the River
Seat 5: shevliak folded before Flop (didn't bet)
Seat 6: floriiiiider folded before Flop (didn't bet)


PokerStars Game #102613041827:  Hold'em No Limit ($3/$6 USD) - 2013/08/11 13:01:43 ET
Table 'Cydonia IX 40-100 bb' 6-max Seat #2 is the button
Seat 1: x_QUIXTAR_x ($2225.10 in chips) 
Seat 2: Flying Smile ($600 in chips) 
Seat 3: Y-Yx777 ($1216.05 in chips) 
Seat 4: patapong ($600 in chips) 
Seat 5: shevliak ($384.37 in chips) 
Seat 6: floriiiiider ($600 in chips) 
Y-Yx777: posts small blind $3
patapong: posts big blind $6
*** HOLE CARDS ***
shevliak: folds 
floriiiiider: raises $12 to $18
x_QUIXTAR_x: folds 
Flying Smile: folds 
Y-Yx777: calls $15
patapong: folds 
*** FLOP *** [Ks 2d Qc]
Y-Yx777: checks 
floriiiiider: bets $30
Y-Yx777: calls $30
*** TURN *** [Ks 2d Qc] [6s]
Y-Yx777: checks 
floriiiiider: bets $75
Y-Yx777: folds 
Uncalled bet ($75) returned to floriiiiider
floriiiiider collected $99.20 from pot
floriiiiider: doesn't show hand 
*** SUMMARY ***
Total pot $102 | Rake $2.80 
Board [Ks 2d Qc 6s]
Seat 1: x_QUIXTAR_x folded before Flop (didn't bet)
Seat 2: Flying Smile (button) folded before Flop (didn't bet)
Seat 3: Y-Yx777 (small blind) folded on the Turn
Seat 4: patapong (big blind) folded before Flop
Seat 5: shevliak folded before Flop (didn't bet)
Seat 6: floriiiiider collected ($99.20)


PokerStars Game #102613070898:  Hold'em No Limit ($3/$6 USD) - 2013/08/11 13:02:23 ET
Table 'Cydonia IX 40-100 bb' 6-max Seat #3 is the button
Seat 1: x_QUIXTAR_x ($2225.10 in chips) 
Seat 2: Flying Smile ($600 in chips) 
Seat 3: Y-Yx777 ($1168.05 in chips) 
Seat 4: patapong ($600 in chips) 
Seat 5: shevliak ($384.37 in chips) 
Seat 6: floriiiiider ($651.20 in chips) 
patapong: posts small blind $3
shevliak: posts big blind $6
*** HOLE CARDS ***
floriiiiider: folds 
x_QUIXTAR_x: folds 
Flying Smile: folds 
Y-Yx777: folds 
patapong: calls $3
shevliak: raises $12 to $18
patapong: raises $30 to $48
shevliak: raises $36 to $84
patapong: calls $36
*** FLOP *** [Qd 4d Tc]
patapong: bets $90
shevliak: raises $210.37 to $300.37 and is all-in
patapong: calls $210.37
*** FIRST TURN *** [Qd 4d Tc] [Ac]
*** FIRST RIVER *** [Qd 4d Tc Ac] [Qc]
*** SECOND TURN *** [Qd 4d Tc] [Th]
*** SECOND RIVER *** [Qd 4d Tc Th] [8h]
*** FIRST SHOW DOWN ***
patapong: shows [Qs Ts] (a full house, Queens full of Tens)
shevliak: shows [9d Ad] (two pair, Aces and Queens)
patapong collected $382.97 from pot
*** SECOND SHOW DOWN ***
patapong: shows [Qs Ts] (a full house, Tens full of Queens)
shevliak: shows [9d Ad] (a pair of Tens)
patapong collected $382.97 from pot
*** SUMMARY ***
Total pot $768.74 | Rake $2.80 
Hand was run twice
FIRST Board [Qd 4d Tc Ac Qc]
SECOND Board [Qd 4d Tc Th 8h]
Seat 1: x_QUIXTAR_x folded before Flop (didn't bet)
Seat 2: Flying Smile folded before Flop (didn't bet)
Seat 3: Y-Yx777 (button) folded before Flop (didn't bet)
Seat 4: patapong (small blind) showed [Qs Ts] and won ($382.97) with a full house, Queens full of Tens, and won ($382.97) with a full house, Tens full of Queens
Seat 5: shevliak (big blind) showed [9d Ad] and lost with two pair, Aces and Queens, and lost with a pair of Tens
Seat 6: floriiiiider folded before Flop (didn't bet)


PokerStars Game #102613127193:  Hold'em No Limit ($3/$6 USD) - 2013/08/11 13:03:36 ET
Table 'Cydonia IX 40-100 bb' 6-max Seat #4 is the button
Seat 1: x_QUIXTAR_x ($2225.10 in chips) 
Seat 2: Flying Smile ($600 in chips) 
Seat 3: Y-Yx777 ($1168.05 in chips) 
Seat 4: patapong ($981.57 in chips) 
Seat 5: shevliak ($240 in chips) 
Seat 6: floriiiiider ($651.20 in chips) 
shevliak: posts small blind $3
floriiiiider: posts big blind $6
*** HOLE CARDS ***
x_QUIXTAR_x: folds 
Flying Smile: raises $12 to $18
Y-Yx777: folds 
patapong: calls $18
shevliak: folds 
floriiiiider: raises $51 to $69
Flying Smile: folds 
patapong: folds 
Uncalled bet ($51) returned to floriiiiider
floriiiiider collected $57 from pot
floriiiiider: doesn't show hand 
*** SUMMARY ***
Total pot $57 | Rake $0 
Seat 1: x_QUIXTAR_x folded before Flop (didn't bet)
Seat 2: Flying Smile folded before Flop
Seat 3: Y-Yx777 folded before Flop (didn't bet)
Seat 4: patapong (button) folded before Flop
Seat 5: shevliak (small blind) folded before Flop
Seat 6: floriiiiider (big blind) collected ($57)


PokerStars Game #102613172436:  Hold'em No Limit ($3/$6 USD) - 2013/08/11 13:04:34 ET
Table 'Cydonia IX 40-100 bb' 6-max Seat #5 is the button
Seat 1: x_QUIXTAR_x ($2225.10 in chips) 
Seat 2: Flying Smile ($600 in chips) 
Seat 3: Y-Yx777 ($1168.05 in chips) 
Seat 4: patapong ($963.57 in chips) 
Seat 5: shevliak ($240 in chips) 
Seat 6: floriiiiider ($690.20 in chips) 
floriiiiider: posts small blind $3
x_QUIXTAR_x: posts big blind $6
*** HOLE CARDS ***
Flying Smile: raises $6 to $12
Y-Yx777 said, "shef ty otkuda?"
Y-Yx777: calls $12
patapong: folds 
patapong is disconnected 
shevliak: folds 
floriiiiider: folds 
x_QUIXTAR_x: folds 
*** FLOP *** [9c Qc Kh]
Flying Smile: bets $18
Y-Yx777: calls $18
*** TURN *** [9c Qc Kh] [3h]
shevliak said, "saratov"
Flying Smile: bets $36
Y-Yx777: calls $36
*** RIVER *** [9c Qc Kh 3h] [Js]
Flying Smile: checks 
Y-Yx777: checks 
*** SHOW DOWN ***
Flying Smile: shows [Qd Ah] (a pair of Queens)
Y-Yx777: mucks hand 
Flying Smile collected $138.20 from pot
*** SUMMARY ***
Total pot $141 | Rake $2.80 
Board [9c Qc Kh 3h Js]
Seat 1: x_QUIXTAR_x (big blind) folded before Flop
Seat 2: Flying Smile showed [Qd Ah] and won ($138.20) with a pair of Queens
Seat 3: Y-Yx777 mucked
Seat 4: patapong folded before Flop (didn't bet)
Seat 5: shevliak (button) folded before Flop (didn't bet)
Seat 6: floriiiiider (small blind) folded before Flop


PokerStars Game #102612619459:  Hold'em No Limit ($3/$6 USD) - 2013/08/11 12:50:35 ET
Table 'Cydonia IX 40-100 bb' 6-max Seat #4 is the button
Seat 1: x_QUIXTAR_x ($1628.10 in chips) 
Seat 2: ilir3 ($727.83 in chips) 
Seat 3: Y-Yx777 ($1230.15 in chips) 
Seat 4: patapong ($693.68 in chips) 
Seat 5: shevliak ($410.61 in chips) 
Seat 6: floriiiiider ($600 in chips) 
shevliak: posts small blind $3
floriiiiider: posts big blind $6
*** HOLE CARDS ***
x_QUIXTAR_x: folds 
ilir3: raises $9 to $15
Y-Yx777: folds 
patapong: folds 
shevliak: folds 
floriiiiider: folds 
Uncalled bet ($9) returned to ilir3
ilir3 collected $15 from pot
ilir3: doesn't show hand 
*** SUMMARY ***
Total pot $15 | Rake $0 
Seat 1: x_QUIXTAR_x folded before Flop (didn't bet)
Seat 2: ilir3 collected ($15)
Seat 3: Y-Yx777 folded before Flop (didn't bet)
Seat 4: patapong (button) folded before Flop (didn't bet)
Seat 5: shevliak (small blind) folded before Flop
Seat 6: floriiiiider (big blind) folded before Flop


PokerStars Game #102612637719:  Hold'em No Limit ($3/$6 USD) - 2013/08/11 12:50:59 ET
Table 'Cydonia IX 40-100 bb' 6-max Seat #5 is the button
Seat 1: x_QUIXTAR_x ($1628.10 in chips) 
Seat 2: ilir3 ($736.83 in chips) 
Seat 3: Y-Yx777 ($1230.15 in chips) 
Seat 4: patapong ($693.68 in chips) 
Seat 5: shevliak ($407.61 in chips) 
Seat 6: floriiiiider ($600 in chips) 
floriiiiider: posts small blind $3
x_QUIXTAR_x: posts big blind $6
*** HOLE CARDS ***
ilir3: raises $9 to $15
Y-Yx777: folds 
patapong: folds 
shevliak: folds 
floriiiiider: folds 
x_QUIXTAR_x: raises $20 to $35
ilir3: calls $20
*** FLOP *** [4d 7h Qd]
x_QUIXTAR_x: bets $70
ilir3: folds 
Uncalled bet ($70) returned to x_QUIXTAR_x
x_QUIXTAR_x collected $70.20 from pot
x_QUIXTAR_x: doesn't show hand 
*** SUMMARY ***
Total pot $73 | Rake $2.80 
Board [4d 7h Qd]
Seat 1: x_QUIXTAR_x (big blind) collected ($70.20)
Seat 2: ilir3 folded on the Flop
Seat 3: Y-Yx777 folded before Flop (didn't bet)
Seat 4: patapong folded before Flop (didn't bet)
Seat 5: shevliak (button) folded before Flop (didn't bet)
Seat 6: floriiiiider (small blind) folded before Flop


PokerStars Game #102612670359:  Hold'em No Limit ($3/$6 USD) - 2013/08/11 12:51:42 ET
Table 'Cydonia IX 40-100 bb' 6-max Seat #6 is the button
Seat 1: x_QUIXTAR_x ($1663.30 in chips) 
Seat 2: ilir3 ($701.83 in chips) 
Seat 3: Y-Yx777 ($1230.15 in chips) 
Seat 4: patapong ($693.68 in chips) 
Seat 5: shevliak ($407.61 in chips) 
Seat 6: floriiiiider ($600 in chips) 
x_QUIXTAR_x: posts small blind $3
ilir3: posts big blind $6
*** HOLE CARDS ***
Y-Yx777: folds 
patapong: raises $9 to $15
shevliak: folds 
floriiiiider: folds 
x_QUIXTAR_x: folds 
ilir3: folds 
Uncalled bet ($9) returned to patapong
patapong collected $15 from pot
*** SUMMARY ***
Total pot $15 | Rake $0 
Seat 1: x_QUIXTAR_x (small blind) folded before Flop
Seat 2: ilir3 (big blind) folded before Flop
Seat 3: Y-Yx777 folded before Flop (didn't bet)
Seat 4: patapong collected ($15)
Seat 5: shevliak folded before Flop (didn't bet)
Seat 6: floriiiiider (button) folded before Flop (didn't bet)


PokerStars Game #102612691848:  Hold'em No Limit ($3/$6 USD) - 2013/08/11 12:52:11 ET
Table 'Cydonia IX 40-100 bb' 6-max Seat #1 is the button
Seat 1: x_QUIXTAR_x ($1660.30 in chips) 
Seat 2: ilir3 ($695.83 in chips) 
Seat 3: Y-Yx777 ($1230.15 in chips) 
Seat 4: patapong ($702.68 in chips) 
Seat 5: shevliak ($407.61 in chips) 
Seat 6: floriiiiider ($600 in chips) 
ilir3: posts small blind $3
Y-Yx777: posts big blind $6
*** HOLE CARDS ***
patapong: folds 
shevliak: folds 
floriiiiider: folds 
x_QUIXTAR_x: raises $7.50 to $13.50
ilir3: folds 
Y-Yx777: calls $7.50
*** FLOP *** [Ac 3s 4s]
Y-Yx777: checks 
x_QUIXTAR_x: bets $12
Y-Yx777: raises $18 to $30
x_QUIXTAR_x: calls $18
*** TURN *** [Ac 3s 4s] [9s]
Y-Yx777: checks 
x_QUIXTAR_x: checks 
*** RIVER *** [Ac 3s 4s 9s] [Th]
Y-Yx777: bets $48
x_QUIXTAR_x: folds 
Uncalled bet ($48) returned to Y-Yx777
Y-Yx777 collected $87.20 from pot
*** SUMMARY ***
Total pot $90 | Rake $2.80 
Board [Ac 3s 4s 9s Th]
Seat 1: x_QUIXTAR_x (button) folded on the River
Seat 2: ilir3 (small blind) folded before Flop
Seat 3: Y-Yx777 (big blind) collected ($87.20)
Seat 4: patapong folded before Flop (didn't bet)
Seat 5: shevliak folded before Flop (didn't bet)
Seat 6: floriiiiider folded before Flop (didn't bet)


PokerStars Game #102612728080:  Hold'em No Limit ($3/$6 USD) - 2013/08/11 12:52:59 ET
Table 'Cydonia IX 40-100 bb' 6-max Seat #2 is the button
Seat 1: x_QUIXTAR_x ($1616.80 in chips) 
Seat 2: ilir3 ($692.83 in chips) 
Seat 3: Y-Yx777 ($1273.85 in chips) 
Seat 4: patapong ($702.68 in chips) 
Seat 5: shevliak ($407.61 in chips) 
Seat 6: floriiiiider ($600 in chips) 
Y-Yx777: posts small blind $3
patapong: posts big blind $6
*** HOLE CARDS ***
shevliak: folds 
floriiiiider: folds 
x_QUIXTAR_x: raises $7.50 to $13.50
ilir3: folds 
Y-Yx777: folds 
patapong: folds 
Uncalled bet ($7.50) returned to x_QUIXTAR_x
x_QUIXTAR_x collected $15 from pot
x_QUIXTAR_x: doesn't show hand 
*** SUMMARY ***
Total pot $15 | Rake $0 
Seat 1: x_QUIXTAR_x collected ($15)
Seat 2: ilir3 (button) folded before Flop (didn't bet)
Seat 3: Y-Yx777 (small blind) folded before Flop
Seat 4: patapong (big blind) folded before Flop
Seat 5: shevliak folded before Flop (didn't bet)
Seat 6: floriiiiider folded before Flop (didn't bet)


PokerStars Game #102612748031:  Hold'em No Limit ($3/$6 USD) - 2013/08/11 12:53:25 ET
Table 'Cydonia IX 40-100 bb' 6-max Seat #3 is the button
Seat 1: x_QUIXTAR_x ($1625.80 in chips) 
Seat 2: ilir3 ($692.83 in chips) 
Seat 3: Y-Yx777 ($1270.85 in chips) 
Seat 4: patapong ($696.68 in chips) 
Seat 5: shevliak ($407.61 in chips) 
Seat 6: floriiiiider ($600 in chips) 
patapong: posts small blind $3
shevliak: posts big blind $6
*** HOLE CARDS ***
floriiiiider: folds 
x_QUIXTAR_x: folds 
ilir3: folds 
Y-Yx777: folds 
patapong: calls $3
shevliak: checks 
*** FLOP *** [7s 5c 4h]
patapong: bets $8.02
shevliak: raises $17.60 to $25.62
patapong: folds 
Uncalled bet ($17.60) returned to shevliak
shevliak collected $26.78 from pot
shevliak: doesn't show hand 
*** SUMMARY ***
Total pot $28.04 | Rake $1.26 
Board [7s 5c 4h]
Seat 1: x_QUIXTAR_x folded before Flop (didn't bet)
Seat 2: ilir3 folded before Flop (didn't bet)
Seat 3: Y-Yx777 (button) folded before Flop (didn't bet)
Seat 4: patapong (small blind) folded on the Flop
Seat 5: shevliak (big blind) collected ($26.78)
Seat 6: floriiiiider folded before Flop (didn't bet)


PokerStars Game #102612782957:  Hold'em No Limit ($3/$6 USD) - 2013/08/11 12:54:12 ET
Table 'Cydonia IX 40-100 bb' 6-max Seat #4 is the button
Seat 1: x_QUIXTAR_x ($1625.80 in chips) 
Seat 2: ilir3 ($692.83 in chips) 
Seat 3: Y-Yx777 ($1270.85 in chips) 
Seat 4: patapong ($682.66 in chips) 
Seat 5: shevliak ($420.37 in chips) 
Seat 6: floriiiiider ($600 in chips) 
shevliak: posts small blind $3
floriiiiider: posts big blind $6
*** HOLE CARDS ***
x_QUIXTAR_x: folds 
ilir3: folds 
Y-Yx777: raises $6 to $12
patapong: raises $27 to $39
shevliak: folds 
floriiiiider: calls $33
Y-Yx777: folds 
*** FLOP *** [3c Qh Kh]
floriiiiider: checks 
patapong: checks 
*** TURN *** [3c Qh Kh] [5s]
floriiiiider: checks 
patapong: bets $52.63
floriiiiider: folds 
Uncalled bet ($52.63) returned to patapong
patapong collected $90.20 from pot
*** SUMMARY ***
Total pot $93 | Rake $2.80 
Board [3c Qh Kh 5s]
Seat 1: x_QUIXTAR_x folded before Flop (didn't bet)
Seat 2: ilir3 folded before Flop (didn't bet)
Seat 3: Y-Yx777 folded before Flop
Seat 4: patapong (button) collected ($90.20)
Seat 5: shevliak (small blind) folded before Flop
Seat 6: floriiiiider (big blind) folded on the Turn


PokerStars Game #102612810832:  Hold'em No Limit ($3/$6 USD) - 2013/08/11 12:54:49 ET
Table 'Cydonia IX 40-100 bb' 6-max Seat #5 is the button
Seat 1: x_QUIXTAR_x ($1625.80 in chips) 
Seat 2: ilir3 ($692.83 in chips) 
Seat 3: Y-Yx777 ($1258.85 in chips) 
Seat 4: patapong ($733.86 in chips) 
Seat 5: shevliak ($417.37 in chips) 
Seat 6: floriiiiider ($600 in chips) 
floriiiiider: posts small blind $3
x_QUIXTAR_x: posts big blind $6
*** HOLE CARDS ***
ilir3: raises $9 to $15
Y-Yx777: folds 
patapong: calls $15
shevliak: calls $15
floriiiiider: folds 
x_QUIXTAR_x: calls $9
*** FLOP *** [6c 8d 8h]
x_QUIXTAR_x: checks 
ilir3: checks 
patapong: checks 
shevliak: checks 
*** TURN *** [6c 8d 8h] [9h]
x_QUIXTAR_x: checks 
ilir3: checks 
patapong: bets $45
shevliak: folds 
x_QUIXTAR_x: raises $80 to $125
ilir3: folds 
patapong: raises $80 to $205
x_QUIXTAR_x: calls $80
*** RIVER *** [6c 8d 8h 9h] [Ac]
x_QUIXTAR_x: checks 
patapong: checks 
*** SHOW DOWN ***
x_QUIXTAR_x: shows [8c Kh] (three of a kind, Eights)
patapong: mucks hand 
x_QUIXTAR_x collected $470.20 from pot
*** SUMMARY ***
Total pot $473 | Rake $2.80 
Board [6c 8d 8h 9h Ac]
Seat 1: x_QUIXTAR_x (big blind) showed [8c Kh] and won ($470.20) with three of a kind, Eights
Seat 2: ilir3 folded on the Turn
Seat 3: Y-Yx777 folded before Flop (didn't bet)
Seat 4: patapong mucked
Seat 5: shevliak (button) folded on the Turn
Seat 6: floriiiiider (small blind) folded before Flop


PokerStars Game #102612376769:  Hold'em No Limit ($3/$6 USD) - 2013/08/11 12:45:16 ET
Table 'Cydonia IX 40-100 bb' 6-max Seat #4 is the button
Seat 1: x_QUIXTAR_x ($996 in chips) 
Seat 2: ilir3 ($766.83 in chips) 
Seat 3: Y-Yx777 ($1174.45 in chips) 
Seat 4: patapong ($657.48 in chips) 
Seat 5: shevliak ($410.61 in chips) 
Seat 6: floriiiiider ($693.40 in chips) 
shevliak: posts small blind $3
floriiiiider: posts big blind $6
*** HOLE CARDS ***
x_QUIXTAR_x: folds 
ilir3: folds 
Y-Yx777: raises $6 to $12
patapong: folds 
shevliak: folds 
floriiiiider: folds 
Uncalled bet ($6) returned to Y-Yx777
Y-Yx777 collected $15 from pot
*** SUMMARY ***
Total pot $15 | Rake $0 
Seat 1: x_QUIXTAR_x folded before Flop (didn't bet)
Seat 2: ilir3 folded before Flop (didn't bet)
Seat 3: Y-Yx777 collected ($15)
Seat 4: patapong (button) folded before Flop (didn't bet)
Seat 5: shevliak (small blind) folded before Flop
Seat 6: floriiiiider (big blind) folded before Flop


PokerStars Game #102612389245:  Hold'em No Limit ($3/$6 USD) - 2013/08/11 12:45:32 ET
Table 'Cydonia IX 40-100 bb' 6-max Seat #5 is the button
Seat 1: x_QUIXTAR_x ($996 in chips) 
Seat 2: ilir3 ($766.83 in chips) 
Seat 3: Y-Yx777 ($1183.45 in chips) 
Seat 4: patapong ($657.48 in chips) 
Seat 5: shevliak ($407.61 in chips) 
Seat 6: floriiiiider ($687.40 in chips) 
floriiiiider: posts small blind $3
x_QUIXTAR_x: posts big blind $6
*** HOLE CARDS ***
ilir3: folds 
Y-Yx777: raises $6 to $12
patapong: folds 
shevliak: folds 
floriiiiider: folds 
x_QUIXTAR_x: folds 
Uncalled bet ($6) returned to Y-Yx777
Y-Yx777 collected $15 from pot
*** SUMMARY ***
Total pot $15 | Rake $0 
Seat 1: x_QUIXTAR_x (big blind) folded before Flop
Seat 2: ilir3 folded before Flop (didn't bet)
Seat 3: Y-Yx777 collected ($15)
Seat 4: patapong folded before Flop (didn't bet)
Seat 5: shevliak (button) folded before Flop (didn't bet)
Seat 6: floriiiiider (small blind) folded before Flop


PokerStars Game #102612417142:  Hold'em No Limit ($3/$6 USD) - 2013/08/11 12:46:09 ET
Table 'Cydonia IX 40-100 bb' 6-max Seat #6 is the button
Seat 1: x_QUIXTAR_x ($990 in chips) 
Seat 2: ilir3 ($766.83 in chips) 
Seat 3: Y-Yx777 ($1192.45 in chips) 
Seat 4: patapong ($657.48 in chips) 
Seat 5: shevliak ($407.61 in chips) 
Seat 6: floriiiiider ($684.40 in chips) 
x_QUIXTAR_x: posts small blind $3
ilir3: posts big blind $6
*** HOLE CARDS ***
Y-Yx777: raises $6 to $12
patapong: folds 
shevliak: folds 
floriiiiider: raises $33 to $45
x_QUIXTAR_x: raises $45 to $90
ilir3: folds 
Y-Yx777: folds 
floriiiiider: calls $45
*** FLOP *** [Kh 9h Kc]
x_QUIXTAR_x: bets $135
floriiiiider: calls $135
*** TURN *** [Kh 9h Kc] [5s]
x_QUIXTAR_x: bets $275
floriiiiider: raises $184.40 to $459.40 and is all-in
x_QUIXTAR_x: calls $184.40
*** RIVER *** [Kh 9h Kc 5s] [7h]
*** SHOW DOWN ***
x_QUIXTAR_x: shows [Ah Ac] (two pair, Aces and Kings)
floriiiiider: mucks hand 
x_QUIXTAR_x collected $1384 from pot
*** SUMMARY ***
Total pot $1386.80 | Rake $2.80 
Board [Kh 9h Kc 5s 7h]
Seat 1: x_QUIXTAR_x (small blind) showed [Ah Ac] and won ($1384) with two pair, Aces and Kings
Seat 2: ilir3 (big blind) folded before Flop
Seat 3: Y-Yx777 folded before Flop
Seat 4: patapong folded before Flop (didn't bet)
Seat 5: shevliak folded before Flop (didn't bet)
Seat 6: floriiiiider (button) mucked


PokerStars Game #102612483114:  Hold'em No Limit ($3/$6 USD) - 2013/08/11 12:47:35 ET
Table 'Cydonia IX 40-100 bb' 6-max Seat #1 is the button
Seat 1: x_QUIXTAR_x ($1689.60 in chips) 
Seat 2: ilir3 ($760.83 in chips) 
Seat 3: Y-Yx777 ($1180.45 in chips) 
Seat 4: patapong ($657.48 in chips) 
Seat 5: shevliak ($407.61 in chips) 
Seat 6: floriiiiider ($600 in chips) 
ilir3: posts small blind $3
Y-Yx777: posts big blind $6
*** HOLE CARDS ***
patapong: folds 
shevliak: folds 
floriiiiider: folds 
x_QUIXTAR_x: raises $7.50 to $13.50
ilir3: folds 
Y-Yx777: calls $7.50
*** FLOP *** [4h 2s 7h]
Y-Yx777: checks 
x_QUIXTAR_x: bets $18
Y-Yx777: raises $30 to $48
x_QUIXTAR_x: calls $30
*** TURN *** [4h 2s 7h] [8d]
Y-Yx777: checks 
x_QUIXTAR_x: checks 
*** RIVER *** [4h 2s 7h 8d] [9d]
Y-Yx777: bets $118
x_QUIXTAR_x: folds 
Uncalled bet ($118) returned to Y-Yx777
Y-Yx777 collected $123.20 from pot
*** SUMMARY ***
Total pot $126 | Rake $2.80 
Board [4h 2s 7h 8d 9d]
Seat 1: x_QUIXTAR_x (button) folded on the River
Seat 2: ilir3 (small blind) folded before Flop
Seat 3: Y-Yx777 (big blind) collected ($123.20)
Seat 4: patapong folded before Flop (didn't bet)
Seat 5: shevliak folded before Flop (didn't bet)
Seat 6: floriiiiider folded before Flop (didn't bet)


PokerStars Game #102612552125:  Hold'em No Limit ($3/$6 USD) - 2013/08/11 12:49:06 ET
Table 'Cydonia IX 40-100 bb' 6-max Seat #2 is the button
Seat 1: x_QUIXTAR_x ($1628.10 in chips) 
Seat 2: ilir3 ($757.83 in chips) 
Seat 3: Y-Yx777 ($1242.15 in chips) 
Seat 4: patapong ($657.48 in chips) 
Seat 5: shevliak ($407.61 in chips) 
Seat 6: floriiiiider ($600 in chips) 
Y-Yx777: posts small blind $3
patapong: posts big blind $6
*** HOLE CARDS ***
shevliak: folds 
floriiiiider: folds 
x_QUIXTAR_x: folds 
ilir3: raises $6 to $12
Y-Yx777: calls $9
patapong: calls $6
*** FLOP *** [5h 9c Kc]
Y-Yx777: checks 
patapong: checks 
ilir3: bets $18
Y-Yx777: folds 
patapong: raises $42 to $60
ilir3: folds 
Uncalled bet ($42) returned to patapong
patapong collected $69.20 from pot
*** SUMMARY ***
Total pot $72 | Rake $2.80 
Board [5h 9c Kc]
Seat 1: x_QUIXTAR_x folded before Flop (didn't bet)
Seat 2: ilir3 (button) folded on the Flop
Seat 3: Y-Yx777 (small blind) folded on the Flop
Seat 4: patapong (big blind) collected ($69.20)
Seat 5: shevliak folded before Flop (didn't bet)
Seat 6: floriiiiider folded before Flop (didn't bet)


PokerStars Game #102612590052:  Hold'em No Limit ($3/$6 USD) - 2013/08/11 12:49:57 ET
Table 'Cydonia IX 40-100 bb' 6-max Seat #3 is the button
Seat 1: x_QUIXTAR_x ($1628.10 in chips) 
Seat 2: ilir3 ($727.83 in chips) 
Seat 3: Y-Yx777 ($1230.15 in chips) 
Seat 4: patapong ($696.68 in chips) 
Seat 5: shevliak ($407.61 in chips) 
Seat 6: floriiiiider ($600 in chips) 
patapong: posts small blind $3
shevliak: posts big blind $6
*** HOLE CARDS ***
floriiiiider: folds 
x_QUIXTAR_x: folds 
ilir3: folds 
Y-Yx777: folds 
patapong: folds 
Uncalled bet ($3) returned to shevliak
shevliak collected $6 from pot
shevliak: doesn't show hand 
*** SUMMARY ***
Total pot $6 | Rake $0 
Seat 1: x_QUIXTAR_x folded before Flop (didn't bet)
Seat 2: ilir3 folded before Flop (didn't bet)
Seat 3: Y-Yx777 (button) folded before Flop (didn't bet)
Seat 4: patapong (small blind) folded before Flop
Seat 5: shevliak (big blind) collected ($6)
Seat 6: floriiiiider folded before Flop (didn't bet)


PokerStars Game #102614178084:  Hold'em No Limit ($3/$6 USD) - 2013/08/11 13:25:48 ET
Table 'Cydonia IX 40-100 bb' 6-max Seat #5 is the button
Seat 1: x_QUIXTAR_x ($1703.94 in chips) 
Seat 2: Flying Smile ($682.22 in chips) 
Seat 3: Y-Yx777 ($1226.04 in chips) 
Seat 5: Sir_Fuj1 ($298.58 in chips) 
Seat 6: floriiiiider ($1257.40 in chips) 
floriiiiider: posts small blind $3
x_QUIXTAR_x: posts big blind $6
leo 32824: sits out 
*** HOLE CARDS ***
Flying Smile: folds 
Y-Yx777: folds 
Sir_Fuj1: folds 
floriiiiider: folds 
Uncalled bet ($3) returned to x_QUIXTAR_x
x_QUIXTAR_x collected $6 from pot
x_QUIXTAR_x: doesn't show hand 
*** SUMMARY ***
Total pot $6 | Rake $0 
Seat 1: x_QUIXTAR_x (big blind) collected ($6)
Seat 2: Flying Smile folded before Flop (didn't bet)
Seat 3: Y-Yx777 folded before Flop (didn't bet)
Seat 5: Sir_Fuj1 (button) folded before Flop (didn't bet)
Seat 6: floriiiiider (small blind) folded before Flop


PokerStars Game #102614200690:  Hold'em No Limit ($3/$6 USD) - 2013/08/11 13:26:17 ET
Table 'Cydonia IX 40-100 bb' 6-max Seat #6 is the button
Seat 1: x_QUIXTAR_x ($1706.94 in chips) 
Seat 2: Flying Smile ($682.22 in chips) 
Seat 3: Y-Yx777 ($1226.04 in chips) 
Seat 5: Sir_Fuj1 ($298.58 in chips) 
Seat 6: floriiiiider ($1254.40 in chips) 
x_QUIXTAR_x: posts small blind $3
Flying Smile: posts big blind $6
leo 32824: sits out 
*** HOLE CARDS ***
Y-Yx777: folds 
Sir_Fuj1: folds 
floriiiiider: raises $6 to $12
x_QUIXTAR_x: folds 
Flying Smile: calls $6
*** FLOP *** [4s Js Qc]
Flying Smile: checks 
floriiiiider: bets $21
Flying Smile: folds 
Uncalled bet ($21) returned to floriiiiider
floriiiiider collected $25.78 from pot
floriiiiider: doesn't show hand 
*** SUMMARY ***
Total pot $27 | Rake $1.22 
Board [4s Js Qc]
Seat 1: x_QUIXTAR_x (small blind) folded before Flop
Seat 2: Flying Smile (big blind) folded on the Flop
Seat 3: Y-Yx777 folded before Flop (didn't bet)
Seat 5: Sir_Fuj1 folded before Flop (didn't bet)
Seat 6: floriiiiider (button) collected ($25.78)


PokerStars Game #102614236105:  Hold'em No Limit ($3/$6 USD) - 2013/08/11 13:27:02 ET
Table 'Cydonia IX 40-100 bb' 6-max Seat #1 is the button
Seat 1: x_QUIXTAR_x ($1703.94 in chips) 
Seat 2: Flying Smile ($670.22 in chips) 
Seat 3: Y-Yx777 ($1226.04 in chips) 
Seat 5: Sir_Fuj1 ($298.58 in chips) 
Seat 6: floriiiiider ($1268.18 in chips) 
Flying Smile: posts small blind $3
Y-Yx777: posts big blind $6
leo 32824 is disconnected 
leo 32824 has timed out while disconnected
leo 32824: is sitting out 
*** HOLE CARDS ***
Sir_Fuj1: folds 
floriiiiider: folds 
x_QUIXTAR_x: raises $7.50 to $13.50
Flying Smile: folds 
Y-Yx777: calls $7.50
*** FLOP *** [8h 2c 5h]
Y-Yx777: checks 
x_QUIXTAR_x: bets $18
Y-Yx777: raises $30 to $48
x_QUIXTAR_x: folds 
Uncalled bet ($30) returned to Y-Yx777
Y-Yx777 collected $63.20 from pot
*** SUMMARY ***
Total pot $66 | Rake $2.80 
Board [8h 2c 5h]
Seat 1: x_QUIXTAR_x (button) folded on the Flop
Seat 2: Flying Smile (small blind) folded before Flop
Seat 3: Y-Yx777 (big blind) collected ($63.20)
Seat 5: Sir_Fuj1 folded before Flop (didn't bet)
Seat 6: floriiiiider folded before Flop (didn't bet)


PokerStars Game #102614290437:  Hold'em No Limit ($3/$6 USD) - 2013/08/11 13:28:12 ET
Table 'Cydonia IX 40-100 bb' 6-max Seat #2 is the button
Seat 1: x_QUIXTAR_x ($1672.44 in chips) 
Seat 2: Flying Smile ($667.22 in chips) 
Seat 3: Y-Yx777 ($1257.74 in chips) 
Seat 5: Sir_Fuj1 ($298.58 in chips) 
Seat 6: floriiiiider ($1268.18 in chips) 
Y-Yx777: posts small blind $3
Sir_Fuj1: posts big blind $6
*** HOLE CARDS ***
floriiiiider: raises $12 to $18
x_QUIXTAR_x: folds 
Flying Smile: calls $18
Y-Yx777: folds 
Sir_Fuj1: folds 
*** FLOP *** [Qs Kc Jc]
floriiiiider: bets $30
Flying Smile: calls $30
*** TURN *** [Qs Kc Jc] [8d]
floriiiiider: bets $75
Flying Smile: calls $75
*** RIVER *** [Qs Kc Jc 8d] [2d]
floriiiiider: bets $177
Flying Smile: folds 
Uncalled bet ($177) returned to floriiiiider
floriiiiider collected $252.20 from pot
floriiiiider: doesn't show hand 
*** SUMMARY ***
Total pot $255 | Rake $2.80 
Board [Qs Kc Jc 8d 2d]
Seat 1: x_QUIXTAR_x folded before Flop (didn't bet)
Seat 2: Flying Smile (button) folded on the River
Seat 3: Y-Yx777 (small blind) folded before Flop
Seat 5: Sir_Fuj1 (big blind) folded before Flop
Seat 6: floriiiiider collected ($252.20)


PokerStars Game #102614363355:  Hold'em No Limit ($3/$6 USD) - 2013/08/11 13:29:43 ET
Table 'Cydonia IX 40-100 bb' 6-max Seat #3 is the button
Seat 1: x_QUIXTAR_x ($1672.44 in chips) 
Seat 2: Flying Smile ($600 in chips) 
Seat 3: Y-Yx777 ($1254.74 in chips) 
Seat 5: Sir_Fuj1 ($292.58 in chips) 
Seat 6: floriiiiider ($1397.38 in chips) 
Sir_Fuj1: posts small blind $3
floriiiiider: posts big blind $6
*** HOLE CARDS ***
x_QUIXTAR_x: folds 
Flying Smile: folds 
Y-Yx777: folds 
Sir_Fuj1: calls $3
leo 32824 leaves the table
floriiiiider: raises $15 to $21
Sir_Fuj1: folds 
Uncalled bet ($15) returned to floriiiiider
floriiiiider collected $12 from pot
floriiiiider: doesn't show hand 
*** SUMMARY ***
Total pot $12 | Rake $0 
Seat 1: x_QUIXTAR_x folded before Flop (didn't bet)
Seat 2: Flying Smile folded before Flop (didn't bet)
Seat 3: Y-Yx777 (button) folded before Flop (didn't bet)
Seat 5: Sir_Fuj1 (small blind) folded before Flop
Seat 6: floriiiiider (big blind) collected ($12)


PokerStars Game #102613908371:  Hold'em No Limit ($3/$6 USD) - 2013/08/11 13:20:04 ET
Table 'Cydonia IX 40-100 bb' 6-max Seat #4 is the button
Seat 1: x_QUIXTAR_x ($1747.44 in chips) 
Seat 2: Flying Smile ($654.78 in chips) 
Seat 3: Y-Yx777 ($1259.95 in chips) 
Seat 4: leo 32824 ($591 in chips) 
Seat 5: Sir_Fuj1 ($302.12 in chips) 
Seat 6: floriiiiider ($1215.20 in chips) 
Sir_Fuj1: posts small blind $3
floriiiiider: posts big blind $6
*** HOLE CARDS ***
x_QUIXTAR_x: folds 
Flying Smile: folds 
Y-Yx777: folds 
leo 32824: folds 
Sir_Fuj1: calls $3
floriiiiider: checks 
*** FLOP *** [Kd 2h 8c]
Sir_Fuj1: bets $6
floriiiiider: folds 
Uncalled bet ($6) returned to Sir_Fuj1
Sir_Fuj1 collected $11.46 from pot
Sir_Fuj1: doesn't show hand 
*** SUMMARY ***
Total pot $12 | Rake $0.54 
Board [Kd 2h 8c]
Seat 1: x_QUIXTAR_x folded before Flop (didn't bet)
Seat 2: Flying Smile folded before Flop (didn't bet)
Seat 3: Y-Yx777 folded before Flop (didn't bet)
Seat 4: leo 32824 (button) folded before Flop (didn't bet)
Seat 5: Sir_Fuj1 (small blind) collected ($11.46)
Seat 6: floriiiiider (big blind) folded on the Flop


PokerStars Game #102613941109:  Hold'em No Limit ($3/$6 USD) - 2013/08/11 13:20:46 ET
Table 'Cydonia IX 40-100 bb' 6-max Seat #5 is the button
Seat 1: x_QUIXTAR_x ($1747.44 in chips) 
Seat 2: Flying Smile ($654.78 in chips) 
Seat 3: Y-Yx777 ($1259.95 in chips) 
Seat 4: leo 32824 ($591 in chips) 
Seat 5: Sir_Fuj1 ($307.58 in chips) 
Seat 6: floriiiiider ($1209.20 in chips) 
floriiiiider: posts small blind $3
x_QUIXTAR_x: posts big blind $6
*** HOLE CARDS ***
Flying Smile: raises $12 to $18
Y-Yx777: folds 
leo 32824 is disconnected 
leo 32824 has timed out while disconnected
leo 32824: folds 
Sir_Fuj1: folds 
floriiiiider: folds 
x_QUIXTAR_x: calls $12
*** FLOP *** [8d Ad 8h]
x_QUIXTAR_x: checks 
Flying Smile: bets $24
x_QUIXTAR_x: folds 
Uncalled bet ($24) returned to Flying Smile
Flying Smile collected $37.24 from pot
*** SUMMARY ***
Total pot $39 | Rake $1.76 
Board [8d Ad 8h]
Seat 1: x_QUIXTAR_x (big blind) folded on the Flop
Seat 2: Flying Smile collected ($37.24)
Seat 3: Y-Yx777 folded before Flop (didn't bet)
Seat 4: leo 32824 folded before Flop (didn't bet)
Seat 5: Sir_Fuj1 (button) folded before Flop (didn't bet)
Seat 6: floriiiiider (small blind) folded before Flop


PokerStars Game #102614006712:  Hold'em No Limit ($3/$6 USD) - 2013/08/11 13:22:09 ET
Table 'Cydonia IX 40-100 bb' 6-max Seat #6 is the button
Seat 1: x_QUIXTAR_x ($1729.44 in chips) 
Seat 2: Flying Smile ($674.02 in chips) 
Seat 3: Y-Yx777 ($1259.95 in chips) 
Seat 5: Sir_Fuj1 ($307.58 in chips) 
Seat 6: floriiiiider ($1206.20 in chips) 
x_QUIXTAR_x: posts small blind $3
Flying Smile: posts big blind $6
*** HOLE CARDS ***
Y-Yx777: folds 
Sir_Fuj1: folds 
floriiiiider: folds 
x_QUIXTAR_x: raises $7.50 to $13.50
Flying Smile: calls $7.50
*** FLOP *** [2s Kd Kh]
x_QUIXTAR_x: bets $12
Flying Smile: calls $12
*** TURN *** [2s Kd Kh] [Tc]
x_QUIXTAR_x: checks 
Flying Smile: bets $18
x_QUIXTAR_x: folds 
Uncalled bet ($18) returned to Flying Smile
Flying Smile collected $48.70 from pot
*** SUMMARY ***
Total pot $51 | Rake $2.30 
Board [2s Kd Kh Tc]
Seat 1: x_QUIXTAR_x (small blind) folded on the Turn
Seat 2: Flying Smile (big blind) collected ($48.70)
Seat 3: Y-Yx777 folded before Flop (didn't bet)
Seat 5: Sir_Fuj1 folded before Flop (didn't bet)
Seat 6: floriiiiider (button) folded before Flop (didn't bet)


PokerStars Game #102614064848:  Hold'em No Limit ($3/$6 USD) - 2013/08/11 13:23:23 ET
Table 'Cydonia IX 40-100 bb' 6-max Seat #1 is the button
Seat 1: x_QUIXTAR_x ($1703.94 in chips) 
Seat 2: Flying Smile ($697.22 in chips) 
Seat 3: Y-Yx777 ($1259.95 in chips) 
Seat 5: Sir_Fuj1 ($307.58 in chips) 
Seat 6: floriiiiider ($1206.20 in chips) 
Flying Smile: posts small blind $3
Y-Yx777: posts big blind $6
*** HOLE CARDS ***
Sir_Fuj1: folds 
floriiiiider: raises $9 to $15
x_QUIXTAR_x: folds 
Flying Smile: folds 
Y-Yx777: calls $9
*** FLOP *** [9s Ts 2s]
Y-Yx777: checks 
floriiiiider: checks 
*** TURN *** [9s Ts 2s] [2d]
Y-Yx777: bets $12
floriiiiider: calls $12
*** RIVER *** [9s Ts 2s 2d] [As]
Y-Yx777: checks 
floriiiiider: checks 
*** SHOW DOWN ***
Y-Yx777: shows [Ah 9h] (two pair, Aces and Nines)
floriiiiider: mucks hand 
Y-Yx777 collected $54.44 from pot
*** SUMMARY ***
Total pot $57 | Rake $2.56 
Board [9s Ts 2s 2d As]
Seat 1: x_QUIXTAR_x (button) folded before Flop (didn't bet)
Seat 2: Flying Smile (small blind) folded before Flop
Seat 3: Y-Yx777 (big blind) showed [Ah 9h] and won ($54.44) with two pair, Aces and Nines
Seat 5: Sir_Fuj1 folded before Flop (didn't bet)
Seat 6: floriiiiider mucked


PokerStars Game #102614094424:  Hold'em No Limit ($3/$6 USD) - 2013/08/11 13:24:01 ET
Table 'Cydonia IX 40-100 bb' 6-max Seat #2 is the button
Seat 1: x_QUIXTAR_x ($1703.94 in chips) 
Seat 2: Flying Smile ($694.22 in chips) 
Seat 3: Y-Yx777 ($1287.39 in chips) 
Seat 5: Sir_Fuj1 ($307.58 in chips) 
Seat 6: floriiiiider ($1179.20 in chips) 
Y-Yx777: posts small blind $3
Sir_Fuj1: posts big blind $6
*** HOLE CARDS ***
floriiiiider: folds 
x_QUIXTAR_x: folds 
Flying Smile: raises $6 to $12
Y-Yx777: calls $9
Sir_Fuj1: folds 
*** FLOP *** [Qs 5d 7s]
Y-Yx777: bets $18
Flying Smile: folds 
Uncalled bet ($18) returned to Y-Yx777
Y-Yx777 collected $28.65 from pot
*** SUMMARY ***
Total pot $30 | Rake $1.35 
Board [Qs 5d 7s]
Seat 1: x_QUIXTAR_x folded before Flop (didn't bet)
Seat 2: Flying Smile (button) folded on the Flop
Seat 3: Y-Yx777 (small blind) collected ($28.65)
Seat 5: Sir_Fuj1 (big blind) folded before Flop
Seat 6: floriiiiider folded before Flop (didn't bet)


PokerStars Game #102614124765:  Hold'em No Limit ($3/$6 USD) - 2013/08/11 13:24:39 ET
Table 'Cydonia IX 40-100 bb' 6-max Seat #3 is the button
Seat 1: x_QUIXTAR_x ($1703.94 in chips) 
Seat 2: Flying Smile ($682.22 in chips) 
Seat 3: Y-Yx777 ($1304.04 in chips) 
Seat 5: Sir_Fuj1 ($301.58 in chips) 
Seat 6: floriiiiider ($1179.20 in chips) 
leo 32824 will be allowed to play after the button
Sir_Fuj1: posts small blind $3
floriiiiider: posts big blind $6
*** HOLE CARDS ***
x_QUIXTAR_x: folds 
Flying Smile: folds 
Y-Yx777: raises $6 to $12
Sir_Fuj1: folds 
floriiiiider: calls $6
*** FLOP *** [Ad 3s 6d]
floriiiiider: checks 
Y-Yx777: checks 
*** TURN *** [Ad 3s 6d] [8d]
floriiiiider: bets $18
Y-Yx777: calls $18
*** RIVER *** [Ad 3s 6d 8d] [Kd]
floriiiiider: bets $48
Y-Yx777: calls $48
*** SHOW DOWN ***
floriiiiider: shows [9s Qd] (a flush, Ace high)
Y-Yx777: mucks hand 
floriiiiider collected $156.20 from pot
*** SUMMARY ***
Total pot $159 | Rake $2.80 
Board [Ad 3s 6d 8d Kd]
Seat 1: x_QUIXTAR_x folded before Flop (didn't bet)
Seat 2: Flying Smile folded before Flop (didn't bet)
Seat 3: Y-Yx777 (button) mucked
Seat 5: Sir_Fuj1 (small blind) folded before Flop
Seat 6: floriiiiider (big blind) showed [9s Qd] and won ($156.20) with a flush, Ace high


PokerStars Game #102613683112:  Hold'em No Limit ($3/$6 USD) - 2013/08/11 13:15:22 ET
Table 'Cydonia IX 40-100 bb' 6-max Seat #5 is the button
Seat 1: x_QUIXTAR_x ($2395.44 in chips) 
Seat 2: Flying Smile ($726.78 in chips) 
Seat 3: Y-Yx777 ($1202.75 in chips) 
Seat 5: Sir_Fuj1 ($244.92 in chips) 
Seat 6: floriiiiider ($609 in chips) 
floriiiiider: posts small blind $3
x_QUIXTAR_x: posts big blind $6
leo 32824: sits out 
*** HOLE CARDS ***
Flying Smile: folds 
Y-Yx777: folds 
Sir_Fuj1: folds 
floriiiiider: raises $12 to $18
x_QUIXTAR_x: raises $27 to $45
floriiiiider: raises $60 to $105
x_QUIXTAR_x: raises $2290.44 to $2395.44 and is all-in
floriiiiider: calls $504 and is all-in
Uncalled bet ($1786.44) returned to x_QUIXTAR_x
*** FLOP *** [Kc 7c Qd]
*** TURN *** [Kc 7c Qd] [7h]
*** RIVER *** [Kc 7c Qd 7h] [4d]
*** SHOW DOWN ***
floriiiiider: shows [Qc Qs] (a full house, Queens full of Sevens)
x_QUIXTAR_x: mucks hand 
floriiiiider collected $1215.20 from pot
*** SUMMARY ***
Total pot $1218 | Rake $2.80 
Board [Kc 7c Qd 7h 4d]
Seat 1: x_QUIXTAR_x (big blind) mucked
Seat 2: Flying Smile folded before Flop (didn't bet)
Seat 3: Y-Yx777 folded before Flop (didn't bet)
Seat 5: Sir_Fuj1 (button) folded before Flop (didn't bet)
Seat 6: floriiiiider (small blind) showed [Qc Qs] and won ($1215.20) with a full house, Queens full of Sevens


PokerStars Game #102613729989:  Hold'em No Limit ($3/$6 USD) - 2013/08/11 13:16:21 ET
Table 'Cydonia IX 40-100 bb' 6-max Seat #6 is the button
Seat 1: x_QUIXTAR_x ($1786.44 in chips) 
Seat 2: Flying Smile ($726.78 in chips) 
Seat 3: Y-Yx777 ($1202.75 in chips) 
Seat 5: Sir_Fuj1 ($244.92 in chips) 
Seat 6: floriiiiider ($1215.20 in chips) 
x_QUIXTAR_x: posts small blind $3
Flying Smile: posts big blind $6
leo 32824: sits out 
*** HOLE CARDS ***
Y-Yx777: folds 
Sir_Fuj1: folds 
floriiiiider: folds 
x_QUIXTAR_x: raises $7.50 to $13.50
Flying Smile: folds 
Uncalled bet ($7.50) returned to x_QUIXTAR_x
x_QUIXTAR_x collected $12 from pot
x_QUIXTAR_x: doesn't show hand 
*** SUMMARY ***
Total pot $12 | Rake $0 
Seat 1: x_QUIXTAR_x (small blind) collected ($12)
Seat 2: Flying Smile (big blind) folded before Flop
Seat 3: Y-Yx777 folded before Flop (didn't bet)
Seat 5: Sir_Fuj1 folded before Flop (didn't bet)
Seat 6: floriiiiider (button) folded before Flop (didn't bet)


PokerStars Game #102613750319:  Hold'em No Limit ($3/$6 USD) - 2013/08/11 13:16:46 ET
Table 'Cydonia IX 40-100 bb' 6-max Seat #1 is the button
Seat 1: x_QUIXTAR_x ($1792.44 in chips) 
Seat 2: Flying Smile ($720.78 in chips) 
Seat 3: Y-Yx777 ($1202.75 in chips) 
Seat 5: Sir_Fuj1 ($244.92 in chips) 
Seat 6: floriiiiider ($1215.20 in chips) 
Flying Smile: posts small blind $3
Y-Yx777: posts big blind $6
leo 32824: sits out 
*** HOLE CARDS ***
Sir_Fuj1: raises $12 to $18
floriiiiider: folds 
x_QUIXTAR_x: calls $18
Flying Smile: folds 
Y-Yx777: calls $12
*** FLOP *** [5d Ad 6s]
Y-Yx777: checks 
Sir_Fuj1: bets $27
x_QUIXTAR_x: calls $27
Y-Yx777: folds 
*** TURN *** [5d Ad 6s] [Jc]
Sir_Fuj1: checks 
x_QUIXTAR_x: checks 
*** RIVER *** [5d Ad 6s Jc] [9d]
Sir_Fuj1: checks 
x_QUIXTAR_x: checks 
*** SHOW DOWN ***
Sir_Fuj1: shows [9c 8c] (a pair of Nines)
x_QUIXTAR_x: mucks hand 
Sir_Fuj1 collected $108.20 from pot
*** SUMMARY ***
Total pot $111 | Rake $2.80 
Board [5d Ad 6s Jc 9d]
Seat 1: x_QUIXTAR_x (button) mucked
Seat 2: Flying Smile (small blind) folded before Flop
Seat 3: Y-Yx777 (big blind) folded on the Flop
Seat 5: Sir_Fuj1 showed [9c 8c] and won ($108.20) with a pair of Nines
Seat 6: floriiiiider folded before Flop (didn't bet)


PokerStars Game #102613806336:  Hold'em No Limit ($3/$6 USD) - 2013/08/11 13:17:56 ET
Table 'Cydonia IX 40-100 bb' 6-max Seat #2 is the button
Seat 1: x_QUIXTAR_x ($1747.44 in chips) 
Seat 2: Flying Smile ($717.78 in chips) 
Seat 3: Y-Yx777 ($1184.75 in chips) 
Seat 4: leo 32824 ($600 in chips) 
Seat 5: Sir_Fuj1 ($308.12 in chips) 
Seat 6: floriiiiider ($1215.20 in chips) 
Y-Yx777: posts small blind $3
leo 32824: posts big blind $6
*** HOLE CARDS ***
Sir_Fuj1: folds 
floriiiiider: folds 
x_QUIXTAR_x: folds 
Flying Smile: raises $6 to $12
Y-Yx777: calls $9
leo 32824: folds 
*** FLOP *** [Qs 7h 4d]
Y-Yx777: checks 
Flying Smile: bets $18
Y-Yx777: calls $18
*** TURN *** [Qs 7h 4d] [9s]
Y-Yx777: checks 
Flying Smile: bets $33
Y-Yx777: calls $33
*** RIVER *** [Qs 7h 4d 9s] [3s]
Y-Yx777: checks 
Flying Smile: checks 
*** SHOW DOWN ***
Y-Yx777: shows [Kh 9h] (a pair of Nines)
Flying Smile: mucks hand 
Y-Yx777 collected $129.20 from pot
*** SUMMARY ***
Total pot $132 | Rake $2.80 
Board [Qs 7h 4d 9s 3s]
Seat 1: x_QUIXTAR_x folded before Flop (didn't bet)
Seat 2: Flying Smile (button) mucked
Seat 3: Y-Yx777 (small blind) showed [Kh 9h] and won ($129.20) with a pair of Nines
Seat 4: leo 32824 (big blind) folded before Flop
Seat 5: Sir_Fuj1 folded before Flop (didn't bet)
Seat 6: floriiiiider folded before Flop (didn't bet)


PokerStars Game #102613867117:  Hold'em No Limit ($3/$6 USD) - 2013/08/11 13:19:12 ET
Table 'Cydonia IX 40-100 bb' 6-max Seat #3 is the button
Seat 1: x_QUIXTAR_x ($1747.44 in chips) 
Seat 2: Flying Smile ($654.78 in chips) 
Seat 3: Y-Yx777 ($1250.95 in chips) 
Seat 4: leo 32824 ($594 in chips) 
Seat 5: Sir_Fuj1 ($308.12 in chips) 
Seat 6: floriiiiider ($1215.20 in chips) 
leo 32824: posts small blind $3
Sir_Fuj1: posts big blind $6
*** HOLE CARDS ***
floriiiiider: folds 
x_QUIXTAR_x: folds 
Flying Smile: folds 
Y-Yx777: raises $6 to $12
leo 32824: folds 
Sir_Fuj1: folds 
Uncalled bet ($6) returned to Y-Yx777
Y-Yx777 collected $15 from pot
*** SUMMARY ***
Total pot $15 | Rake $0 
Seat 1: x_QUIXTAR_x folded before Flop (didn't bet)
Seat 2: Flying Smile folded before Flop (didn't bet)
Seat 3: Y-Yx777 (button) collected ($15)
Seat 4: leo 32824 (small blind) folded before Flop
Seat 5: Sir_Fuj1 (big blind) folded before Flop
Seat 6: floriiiiider folded before Flop (didn't bet)


PokerStars Game #102613447842:  Hold'em No Limit ($3/$6 USD) - 2013/08/11 13:10:24 ET
Table 'Cydonia IX 40-100 bb' 6-max Seat #1 is the button
Seat 1: x_QUIXTAR_x ($2207.10 in chips) 
Seat 2: Flying Smile ($702.63 in chips) 
Seat 3: Y-Yx777 ($1294.25 in chips) 
Seat 5: shevliak ($249 in chips) 
Seat 6: floriiiiider ($611.44 in chips) 
Flying Smile: posts small blind $3
Y-Yx777: posts big blind $6
*** HOLE CARDS ***
shevliak: folds 
floriiiiider: raises $9 to $15
x_QUIXTAR_x: calls $15
Flying Smile: folds 
Y-Yx777: calls $9
*** FLOP *** [Jh 4c 2c]
Y-Yx777: checks 
floriiiiider: checks 
x_QUIXTAR_x: bets $18
Y-Yx777: folds 
floriiiiider: folds 
Uncalled bet ($18) returned to x_QUIXTAR_x
x_QUIXTAR_x collected $45.84 from pot
x_QUIXTAR_x: doesn't show hand 
*** SUMMARY ***
Total pot $48 | Rake $2.16 
Board [Jh 4c 2c]
Seat 1: x_QUIXTAR_x (button) collected ($45.84)
Seat 2: Flying Smile (small blind) folded before Flop
Seat 3: Y-Yx777 (big blind) folded on the Flop
Seat 5: shevliak folded before Flop (didn't bet)
Seat 6: floriiiiider folded on the Flop


PokerStars Game #102613491900:  Hold'em No Limit ($3/$6 USD) - 2013/08/11 13:11:20 ET
Table 'Cydonia IX 40-100 bb' 6-max Seat #2 is the button
Seat 1: x_QUIXTAR_x ($2237.94 in chips) 
Seat 2: Flying Smile ($699.63 in chips) 
Seat 3: Y-Yx777 ($1279.25 in chips) 
Seat 6: floriiiiider ($600 in chips) 
Y-Yx777: posts small blind $3
shevliak: is sitting out 
floriiiiider: posts big blind $6
*** HOLE CARDS ***
shevliak leaves the table
x_QUIXTAR_x: folds 
Flying Smile: raises $6 to $12
Y-Yx777: calls $9
floriiiiider: calls $6
*** FLOP *** [9c 3s As]
Y-Yx777: checks 
floriiiiider: checks 
Flying Smile: checks 
*** TURN *** [9c 3s As] [6h]
Y-Yx777: bets $12
floriiiiider: folds 
Flying Smile: folds 
Uncalled bet ($12) returned to Y-Yx777
Y-Yx777 collected $34.50 from pot
*** SUMMARY ***
Total pot $36 | Rake $1.50 
Board [9c 3s As 6h]
Seat 1: x_QUIXTAR_x folded before Flop (didn't bet)
Seat 2: Flying Smile (button) folded on the Turn
Seat 3: Y-Yx777 (small blind) collected ($34.50)
Seat 6: floriiiiider (big blind) folded on the Turn


PokerStars Game #102613518199:  Hold'em No Limit ($3/$6 USD) - 2013/08/11 13:11:53 ET
Table 'Cydonia IX 40-100 bb' 6-max Seat #3 is the button
Seat 1: x_QUIXTAR_x ($2237.94 in chips) 
Seat 2: Flying Smile ($687.63 in chips) 
Seat 3: Y-Yx777 ($1301.75 in chips) 
Seat 6: floriiiiider ($600 in chips) 
floriiiiider: posts small blind $3
x_QUIXTAR_x: posts big blind $6
*** HOLE CARDS ***
Flying Smile: folds 
Sir_Fuj1 joins the table at seat #5 
Y-Yx777: raises $6 to $12
floriiiiider: raises $33 to $45
x_QUIXTAR_x: calls $39
Y-Yx777: calls $33
*** FLOP *** [Qs Qh 8h]
floriiiiider: bets $72
x_QUIXTAR_x: calls $72
Y-Yx777: folds 
*** TURN *** [Qs Qh 8h] [6h]
floriiiiider: checks 
x_QUIXTAR_x: bets $240
floriiiiider: folds 
Uncalled bet ($240) returned to x_QUIXTAR_x
x_QUIXTAR_x collected $277.50 from pot
x_QUIXTAR_x: doesn't show hand 
*** SUMMARY ***
Total pot $279 | Rake $1.50 
Board [Qs Qh 8h 6h]
Seat 1: x_QUIXTAR_x (big blind) collected ($277.50)
Seat 2: Flying Smile folded before Flop (didn't bet)
Seat 3: Y-Yx777 (button) folded on the Flop
Seat 6: floriiiiider (small blind) folded on the Turn


PokerStars Game #102613571566:  Hold'em No Limit ($3/$6 USD) - 2013/08/11 13:13:01 ET
Table 'Cydonia IX 40-100 bb' 6-max Seat #6 is the button
Seat 1: x_QUIXTAR_x ($2398.44 in chips) 
Seat 2: Flying Smile ($687.63 in chips) 
Seat 3: Y-Yx777 ($1256.75 in chips) 
Seat 6: floriiiiider ($600 in chips) 
x_QUIXTAR_x: posts small blind $3
Flying Smile: posts big blind $6
Sir_Fuj1: sits out 
*** HOLE CARDS ***
Y-Yx777: raises $6 to $12
floriiiiider: raises $33 to $45
x_QUIXTAR_x: folds 
Flying Smile: folds 
Y-Yx777: folds 
Uncalled bet ($33) returned to floriiiiider
floriiiiider collected $33 from pot
floriiiiider: doesn't show hand 
*** SUMMARY ***
Total pot $33 | Rake $0 
Seat 1: x_QUIXTAR_x (small blind) folded before Flop
Seat 2: Flying Smile (big blind) folded before Flop
Seat 3: Y-Yx777 folded before Flop
Seat 6: floriiiiider (button) collected ($33)


PokerStars Game #102613582679:  Hold'em No Limit ($3/$6 USD) - 2013/08/11 13:13:16 ET
Table 'Cydonia IX 40-100 bb' 6-max Seat #1 is the button
Seat 1: x_QUIXTAR_x ($2395.44 in chips) 
Seat 2: Flying Smile ($681.63 in chips) 
Seat 3: Y-Yx777 ($1244.75 in chips) 
Seat 6: floriiiiider ($621 in chips) 
Flying Smile: posts small blind $3
Y-Yx777: posts big blind $6
Sir_Fuj1: sits out 
*** HOLE CARDS ***
floriiiiider: folds 
x_QUIXTAR_x: folds 
Flying Smile: calls $3
Y-Yx777: checks 
*** FLOP *** [Qs Qh 7d]
Flying Smile: checks 
Y-Yx777: bets $6
Flying Smile: calls $6
*** TURN *** [Qs Qh 7d] [9s]
Flying Smile: checks 
Y-Yx777: bets $18
Flying Smile: calls $18
*** RIVER *** [Qs Qh 7d 9s] [7c]
Flying Smile: checks 
Y-Yx777: checks 
*** SHOW DOWN ***
Flying Smile: shows [Qd 3d] (a full house, Queens full of Sevens)
Y-Yx777: mucks hand 
Flying Smile collected $58.50 from pot
*** SUMMARY ***
Total pot $60 | Rake $1.50 
Board [Qs Qh 7d 9s 7c]
Seat 1: x_QUIXTAR_x (button) folded before Flop (didn't bet)
Seat 2: Flying Smile (small blind) showed [Qd 3d] and won ($58.50) with a full house, Queens full of Sevens
Seat 3: Y-Yx777 (big blind) mucked
Seat 6: floriiiiider folded before Flop (didn't bet)


PokerStars Game #102613624726:  Hold'em No Limit ($3/$6 USD) - 2013/08/11 13:14:09 ET
Table 'Cydonia IX 40-100 bb' 6-max Seat #2 is the button
Seat 1: x_QUIXTAR_x ($2395.44 in chips) 
Seat 2: Flying Smile ($710.13 in chips) 
Seat 3: Y-Yx777 ($1214.75 in chips) 
Seat 5: Sir_Fuj1 ($240 in chips) 
Seat 6: floriiiiider ($621 in chips) 
Y-Yx777: posts small blind $3
Sir_Fuj1: posts big blind $6
*** HOLE CARDS ***
floriiiiider: folds 
x_QUIXTAR_x: folds 
Flying Smile: raises $6 to $12
Y-Yx777: calls $9
Sir_Fuj1: folds 
*** FLOP *** [Qc 2d Kh]
Y-Yx777: checks 
Flying Smile: bets $18
Y-Yx777: folds 
Uncalled bet ($18) returned to Flying Smile
Flying Smile collected $28.65 from pot
*** SUMMARY ***
Total pot $30 | Rake $1.35 
Board [Qc 2d Kh]
Seat 1: x_QUIXTAR_x folded before Flop (didn't bet)
Seat 2: Flying Smile (button) collected ($28.65)
Seat 3: Y-Yx777 (small blind) folded on the Flop
Seat 5: Sir_Fuj1 (big blind) folded before Flop
Seat 6: floriiiiider folded before Flop (didn't bet)


PokerStars Game #102613643755:  Hold'em No Limit ($3/$6 USD) - 2013/08/11 13:14:34 ET
Table 'Cydonia IX 40-100 bb' 6-max Seat #3 is the button
Seat 1: x_QUIXTAR_x ($2395.44 in chips) 
Seat 2: Flying Smile ($726.78 in chips) 
Seat 3: Y-Yx777 ($1202.75 in chips) 
Seat 5: Sir_Fuj1 ($234 in chips) 
Seat 6: floriiiiider ($621 in chips) 
Sir_Fuj1: posts small blind $3
floriiiiider: posts big blind $6
*** HOLE CARDS ***
x_QUIXTAR_x: folds 
Flying Smile: folds 
Y-Yx777: folds 
patapong was removed from the table for failing to post
leo 32824 joins the table at seat #4 
Sir_Fuj1: calls $3
floriiiiider: checks 
*** FLOP *** [3s 4d Ac]
Sir_Fuj1: bets $6
floriiiiider: calls $6
*** TURN *** [3s 4d Ac] [Tc]
Sir_Fuj1: bets $18
floriiiiider: folds 
Uncalled bet ($18) returned to Sir_Fuj1
Sir_Fuj1 collected $22.92 from pot
Sir_Fuj1: doesn't show hand 
*** SUMMARY ***
Total pot $24 | Rake $1.08 
Board [3s 4d Ac Tc]
Seat 1: x_QUIXTAR_x folded before Flop (didn't bet)
Seat 2: Flying Smile folded before Flop (didn't bet)
Seat 3: Y-Yx777 (button) folded before Flop (didn't bet)
Seat 5: Sir_Fuj1 (small blind) collected ($22.92)
Seat 6: floriiiiider (big blind) folded on the Turn


PokerStars Game #102615198629:  Hold'em No Limit ($3/$6 USD) - 2013/08/11 13:46:30 ET
Table 'Cydonia IX 40-100 bb' 6-max Seat #5 is the button
Seat 1: x_QUIXTAR_x ($2061.08 in chips) 
Seat 2: Flying Smile ($600 in chips) 
Seat 3: Y-Yx777 ($1069.81 in chips) 
Seat 4: maloyd ($601.50 in chips) 
Seat 5: Sir_Fuj1 ($349.93 in chips) 
Seat 6: floriiiiider ($1268.38 in chips) 
floriiiiider: posts small blind $3
x_QUIXTAR_x: posts big blind $6
*** HOLE CARDS ***
Flying Smile: raises $12 to $18
Y-Yx777: folds 
maloyd: calls $18
Sir_Fuj1: folds 
floriiiiider: raises $51 to $69
x_QUIXTAR_x: folds 
Flying Smile: calls $51
maloyd: calls $51
*** FLOP *** [Jc 4d 3c]
floriiiiider: bets $123
Flying Smile: folds 
maloyd: folds 
Uncalled bet ($123) returned to floriiiiider
floriiiiider collected $210.20 from pot
floriiiiider: doesn't show hand 
*** SUMMARY ***
Total pot $213 | Rake $2.80 
Board [Jc 4d 3c]
Seat 1: x_QUIXTAR_x (big blind) folded before Flop
Seat 2: Flying Smile folded on the Flop
Seat 3: Y-Yx777 folded before Flop (didn't bet)
Seat 4: maloyd folded on the Flop
Seat 5: Sir_Fuj1 (button) folded before Flop (didn't bet)
Seat 6: floriiiiider (small blind) collected ($210.20)


PokerStars Game #102615250179:  Hold'em No Limit ($3/$6 USD) - 2013/08/11 13:47:32 ET
Table 'Cydonia IX 40-100 bb' 6-max Seat #6 is the button
Seat 1: x_QUIXTAR_x ($2055.08 in chips) 
Seat 2: Flying Smile ($600 in chips) 
Seat 3: Y-Yx777 ($1069.81 in chips) 
Seat 4: maloyd ($600 in chips) 
Seat 5: Sir_Fuj1 ($349.93 in chips) 
Seat 6: floriiiiider ($1409.58 in chips) 
x_QUIXTAR_x: posts small blind $3
Flying Smile: posts big blind $6
*** HOLE CARDS ***
Y-Yx777: raises $6 to $12
maloyd: folds 
Sir_Fuj1: folds 
floriiiiider: folds 
x_QUIXTAR_x: folds 
Flying Smile: calls $6
*** FLOP *** [Kh 6c Ks]
Flying Smile: checks 
Y-Yx777: checks 
*** TURN *** [Kh 6c Ks] [Qc]
Flying Smile: checks 
Y-Yx777: bets $12
Flying Smile: folds 
Uncalled bet ($12) returned to Y-Yx777
Y-Yx777 collected $25.78 from pot
*** SUMMARY ***
Total pot $27 | Rake $1.22 
Board [Kh 6c Ks Qc]
Seat 1: x_QUIXTAR_x (small blind) folded before Flop
Seat 2: Flying Smile (big blind) folded on the Turn
Seat 3: Y-Yx777 collected ($25.78)
Seat 4: maloyd folded before Flop (didn't bet)
Seat 5: Sir_Fuj1 folded before Flop (didn't bet)
Seat 6: floriiiiider (button) folded before Flop (didn't bet)


PokerStars Game #102615293882:  Hold'em No Limit ($3/$6 USD) - 2013/08/11 13:48:24 ET
Table 'Cydonia IX 40-100 bb' 6-max Seat #1 is the button
Seat 1: x_QUIXTAR_x ($2052.08 in chips) 
Seat 2: Flying Smile ($600 in chips) 
Seat 3: Y-Yx777 ($1083.59 in chips) 
Seat 4: maloyd ($600 in chips) 
Seat 5: Sir_Fuj1 ($349.93 in chips) 
Seat 6: floriiiiider ($1409.58 in chips) 
Flying Smile: posts small blind $3
Y-Yx777: posts big blind $6
*** HOLE CARDS ***
maloyd: folds 
Sir_Fuj1: folds 
floriiiiider: folds 
x_QUIXTAR_x: raises $7.50 to $13.50
Flying Smile: folds 
Y-Yx777: folds 
Uncalled bet ($7.50) returned to x_QUIXTAR_x
x_QUIXTAR_x collected $15 from pot
x_QUIXTAR_x: doesn't show hand 
*** SUMMARY ***
Total pot $15 | Rake $0 
Seat 1: x_QUIXTAR_x (button) collected ($15)
Seat 2: Flying Smile (small blind) folded before Flop
Seat 3: Y-Yx777 (big blind) folded before Flop
Seat 4: maloyd folded before Flop (didn't bet)
Seat 5: Sir_Fuj1 folded before Flop (didn't bet)
Seat 6: floriiiiider folded before Flop (didn't bet)


PokerStars Game #102615315510:  Hold'em No Limit ($3/$6 USD) - 2013/08/11 13:48:50 ET
Table 'Cydonia IX 40-100 bb' 6-max Seat #2 is the button
Seat 1: x_QUIXTAR_x ($2061.08 in chips) 
Seat 2: Flying Smile ($600 in chips) 
Seat 3: Y-Yx777 ($1077.59 in chips) 
Seat 4: maloyd ($600 in chips) 
Seat 5: Sir_Fuj1 ($349.93 in chips) 
Seat 6: floriiiiider ($1409.58 in chips) 
Y-Yx777: posts small blind $3
maloyd: posts big blind $6
*** HOLE CARDS ***
Sir_Fuj1: folds 
floriiiiider: folds 
x_QUIXTAR_x: folds 
Flying Smile: raises $6 to $12
Y-Yx777: folds 
maloyd: folds 
Uncalled bet ($6) returned to Flying Smile
Flying Smile collected $15 from pot
*** SUMMARY ***
Total pot $15 | Rake $0 
Seat 1: x_QUIXTAR_x folded before Flop (didn't bet)
Seat 2: Flying Smile (button) collected ($15)
Seat 3: Y-Yx777 (small blind) folded before Flop
Seat 4: maloyd (big blind) folded before Flop
Seat 5: Sir_Fuj1 folded before Flop (didn't bet)
Seat 6: floriiiiider folded before Flop (didn't bet)


PokerStars Game #102615343377:  Hold'em No Limit ($3/$6 USD) - 2013/08/11 13:49:24 ET
Table 'Cydonia IX 40-100 bb' 6-max Seat #3 is the button
Seat 1: x_QUIXTAR_x ($2061.08 in chips) 
Seat 2: Flying Smile ($609 in chips) 
Seat 3: Y-Yx777 ($1074.59 in chips) 
Seat 4: maloyd ($600 in chips) 
Seat 5: Sir_Fuj1 ($349.93 in chips) 
Seat 6: floriiiiider ($1409.58 in chips) 
maloyd: posts small blind $3
Sir_Fuj1: posts big blind $6
*** HOLE CARDS ***
floriiiiider: folds 
x_QUIXTAR_x: folds 
Flying Smile: folds 
Y-Yx777: folds 
maloyd: folds 
Uncalled bet ($3) returned to Sir_Fuj1
Sir_Fuj1 collected $6 from pot
Sir_Fuj1: doesn't show hand 
*** SUMMARY ***
Total pot $6 | Rake $0 
Seat 1: x_QUIXTAR_x folded before Flop (didn't bet)
Seat 2: Flying Smile folded before Flop (didn't bet)
Seat 3: Y-Yx777 (button) folded before Flop (didn't bet)
Seat 4: maloyd (small blind) folded before Flop
Seat 5: Sir_Fuj1 (big blind) collected ($6)
Seat 6: floriiiiider folded before Flop (didn't bet)


PokerStars Game #102615360447:  Hold'em No Limit ($3/$6 USD) - 2013/08/11 13:49:45 ET
Table 'Cydonia IX 40-100 bb' 6-max Seat #4 is the button
Seat 1: x_QUIXTAR_x ($2061.08 in chips) 
Seat 2: Flying Smile ($609 in chips) 
Seat 3: Y-Yx777 ($1074.59 in chips) 
Seat 4: maloyd ($600 in chips) 
Seat 5: Sir_Fuj1 ($352.93 in chips) 
Seat 6: floriiiiider ($1409.58 in chips) 
Sir_Fuj1: posts small blind $3
floriiiiider: posts big blind $6
*** HOLE CARDS ***
x_QUIXTAR_x: folds 
Flying Smile: raises $6 to $12
Y-Yx777: folds 
maloyd: folds 
Sir_Fuj1: folds 
floriiiiider: folds 
Uncalled bet ($6) returned to Flying Smile
Flying Smile collected $15 from pot
*** SUMMARY ***
Total pot $15 | Rake $0 
Seat 1: x_QUIXTAR_x folded before Flop (didn't bet)
Seat 2: Flying Smile collected ($15)
Seat 3: Y-Yx777 folded before Flop (didn't bet)
Seat 4: maloyd (button) folded before Flop (didn't bet)
Seat 5: Sir_Fuj1 (small blind) folded before Flop
Seat 6: floriiiiider (big blind) folded before Flop


PokerStars Game #102614914673:  Hold'em No Limit ($3/$6 USD) - 2013/08/11 13:40:47 ET
Table 'Cydonia IX 40-100 bb' 6-max Seat #6 is the button
Seat 1: x_QUIXTAR_x ($1749.14 in chips) 
Seat 2: Flying Smile ($624.98 in chips) 
Seat 3: Y-Yx777 ($1202.54 in chips) 
Seat 4: maloyd ($618 in chips) 
Seat 5: Sir_Fuj1 ($412.93 in chips) 
Seat 6: floriiiiider ($1274.38 in chips) 
x_QUIXTAR_x: posts small blind $3
Flying Smile: posts big blind $6
*** HOLE CARDS ***
Y-Yx777: folds 
maloyd: folds 
Sir_Fuj1: folds 
floriiiiider: folds 
x_QUIXTAR_x: raises $7.50 to $13.50
Flying Smile: raises $31.50 to $45
x_QUIXTAR_x: raises $45 to $90
Flying Smile: calls $45
*** FLOP *** [6s 9h 2h]
x_QUIXTAR_x: checks 
Flying Smile: checks 
*** TURN *** [6s 9h 2h] [6d]
x_QUIXTAR_x: bets $140
Flying Smile: folds 
Uncalled bet ($140) returned to x_QUIXTAR_x
x_QUIXTAR_x collected $177.20 from pot
x_QUIXTAR_x: doesn't show hand 
*** SUMMARY ***
Total pot $180 | Rake $2.80 
Board [6s 9h 2h 6d]
Seat 1: x_QUIXTAR_x (small blind) collected ($177.20)
Seat 2: Flying Smile (big blind) folded on the Turn
Seat 3: Y-Yx777 folded before Flop (didn't bet)
Seat 4: maloyd folded before Flop (didn't bet)
Seat 5: Sir_Fuj1 folded before Flop (didn't bet)
Seat 6: floriiiiider (button) folded before Flop (didn't bet)


PokerStars Game #102614971237:  Hold'em No Limit ($3/$6 USD) - 2013/08/11 13:41:55 ET
Table 'Cydonia IX 40-100 bb' 6-max Seat #1 is the button
Seat 1: x_QUIXTAR_x ($1836.34 in chips) 
Seat 2: Flying Smile ($600 in chips) 
Seat 3: Y-Yx777 ($1202.54 in chips) 
Seat 4: maloyd ($618 in chips) 
Seat 5: Sir_Fuj1 ($412.93 in chips) 
Seat 6: floriiiiider ($1274.38 in chips) 
Flying Smile: posts small blind $3
Y-Yx777: posts big blind $6
*** HOLE CARDS ***
maloyd: folds 
Sir_Fuj1: folds 
floriiiiider: folds 
x_QUIXTAR_x: raises $7.50 to $13.50
Flying Smile: folds 
Y-Yx777: calls $7.50
*** FLOP *** [Ah Qh Ks]
Y-Yx777: checks 
x_QUIXTAR_x: bets $12
Y-Yx777: raises $18 to $30
x_QUIXTAR_x: folds 
Uncalled bet ($18) returned to Y-Yx777
Y-Yx777 collected $51.57 from pot
*** SUMMARY ***
Total pot $54 | Rake $2.43 
Board [Ah Qh Ks]
Seat 1: x_QUIXTAR_x (button) folded on the Flop
Seat 2: Flying Smile (small blind) folded before Flop
Seat 3: Y-Yx777 (big blind) collected ($51.57)
Seat 4: maloyd folded before Flop (didn't bet)
Seat 5: Sir_Fuj1 folded before Flop (didn't bet)
Seat 6: floriiiiider folded before Flop (didn't bet)


PokerStars Game #102615006265:  Hold'em No Limit ($3/$6 USD) - 2013/08/11 13:42:38 ET
Table 'Cydonia IX 40-100 bb' 6-max Seat #2 is the button
Seat 1: x_QUIXTAR_x ($1810.84 in chips) 
Seat 2: Flying Smile ($600 in chips) 
Seat 3: Y-Yx777 ($1228.61 in chips) 
Seat 4: maloyd ($618 in chips) 
Seat 5: Sir_Fuj1 ($412.93 in chips) 
Seat 6: floriiiiider ($1274.38 in chips) 
Y-Yx777: posts small blind $3
maloyd: posts big blind $6
*** HOLE CARDS ***
Sir_Fuj1: folds 
floriiiiider: folds 
x_QUIXTAR_x: raises $7.50 to $13.50
Flying Smile: calls $13.50
Y-Yx777: folds 
maloyd: calls $7.50
*** FLOP *** [Qd 5s 7h]
maloyd: checks 
x_QUIXTAR_x: bets $12
Flying Smile: folds 
maloyd: folds 
Uncalled bet ($12) returned to x_QUIXTAR_x
x_QUIXTAR_x collected $41.54 from pot
x_QUIXTAR_x: doesn't show hand 
*** SUMMARY ***
Total pot $43.50 | Rake $1.96 
Board [Qd 5s 7h]
Seat 1: x_QUIXTAR_x collected ($41.54)
Seat 2: Flying Smile (button) folded on the Flop
Seat 3: Y-Yx777 (small blind) folded before Flop
Seat 4: maloyd (big blind) folded on the Flop
Seat 5: Sir_Fuj1 folded before Flop (didn't bet)
Seat 6: floriiiiider folded before Flop (didn't bet)


PokerStars Game #102615048740:  Hold'em No Limit ($3/$6 USD) - 2013/08/11 13:43:29 ET
Table 'Cydonia IX 40-100 bb' 6-max Seat #3 is the button
Seat 1: x_QUIXTAR_x ($1838.88 in chips) 
Seat 2: Flying Smile ($600 in chips) 
Seat 3: Y-Yx777 ($1225.61 in chips) 
Seat 4: maloyd ($604.50 in chips) 
Seat 5: Sir_Fuj1 ($412.93 in chips) 
Seat 6: floriiiiider ($1274.38 in chips) 
maloyd: posts small blind $3
Sir_Fuj1: posts big blind $6
*** HOLE CARDS ***
floriiiiider: folds 
x_QUIXTAR_x: folds 
Flying Smile: folds 
Y-Yx777: raises $6 to $12
maloyd: folds 
Sir_Fuj1: calls $6
*** FLOP *** [Td 7c As]
Sir_Fuj1: checks 
Y-Yx777: bets $12
Sir_Fuj1: calls $12
*** TURN *** [Td 7c As] [5h]
Sir_Fuj1: checks 
Y-Yx777: checks 
*** RIVER *** [Td 7c As 5h] [Ac]
Sir_Fuj1: bets $36
Y-Yx777: raises $60 to $96
Sir_Fuj1: folds 
Uncalled bet ($60) returned to Y-Yx777
Y-Yx777 collected $120.20 from pot
*** SUMMARY ***
Total pot $123 | Rake $2.80 
Board [Td 7c As 5h Ac]
Seat 1: x_QUIXTAR_x folded before Flop (didn't bet)
Seat 2: Flying Smile folded before Flop (didn't bet)
Seat 3: Y-Yx777 (button) collected ($120.20)
Seat 4: maloyd (small blind) folded before Flop
Seat 5: Sir_Fuj1 (big blind) folded on the River
Seat 6: floriiiiider folded before Flop (didn't bet)


PokerStars Game #102615104056:  Hold'em No Limit ($3/$6 USD) - 2013/08/11 13:44:37 ET
Table 'Cydonia IX 40-100 bb' 6-max Seat #4 is the button
Seat 1: x_QUIXTAR_x ($1838.88 in chips) 
Seat 2: Flying Smile ($600 in chips) 
Seat 3: Y-Yx777 ($1285.81 in chips) 
Seat 4: maloyd ($601.50 in chips) 
Seat 5: Sir_Fuj1 ($352.93 in chips) 
Seat 6: floriiiiider ($1274.38 in chips) 
Sir_Fuj1: posts small blind $3
floriiiiider: posts big blind $6
*** HOLE CARDS ***
x_QUIXTAR_x: raises $7.50 to $13.50
Flying Smile: folds 
Y-Yx777: raises $22.50 to $36
maloyd: folds 
Sir_Fuj1: folds 
floriiiiider: folds 
x_QUIXTAR_x: calls $22.50
*** FLOP *** [4d Kd 4h]
x_QUIXTAR_x: checks 
Y-Yx777: bets $42
x_QUIXTAR_x: raises $48 to $90
Y-Yx777: calls $48
*** TURN *** [4d Kd 4h] [7c]
x_QUIXTAR_x: bets $90
Y-Yx777: calls $90
*** RIVER *** [4d Kd 4h 7c] [As]
x_QUIXTAR_x: checks 
Y-Yx777: checks 
*** SHOW DOWN ***
x_QUIXTAR_x: shows [Ad 5d] (two pair, Aces and Fours)
Y-Yx777: mucks hand 
x_QUIXTAR_x collected $438.20 from pot
*** SUMMARY ***
Total pot $441 | Rake $2.80 
Board [4d Kd 4h 7c As]
Seat 1: x_QUIXTAR_x showed [Ad 5d] and won ($438.20) with two pair, Aces and Fours
Seat 2: Flying Smile folded before Flop (didn't bet)
Seat 3: Y-Yx777 mucked
Seat 4: maloyd (button) folded before Flop (didn't bet)
Seat 5: Sir_Fuj1 (small blind) folded before Flop
Seat 6: floriiiiider (big blind) folded before Flop


PokerStars Game #102614653188:  Hold'em No Limit ($3/$6 USD) - 2013/08/11 13:35:32 ET
Table 'Cydonia IX 40-100 bb' 6-max Seat #5 is the button
Seat 1: x_QUIXTAR_x ($1777.64 in chips) 
Seat 2: Flying Smile ($613.78 in chips) 
Seat 3: Y-Yx777 ($1281.94 in chips) 
Seat 4: maloyd ($600 in chips) 
Seat 5: Sir_Fuj1 ($294.23 in chips) 
Seat 6: floriiiiider ($1298.38 in chips) 
floriiiiider: posts small blind $3
x_QUIXTAR_x: posts big blind $6
*** HOLE CARDS ***
Flying Smile: folds 
Y-Yx777: raises $6 to $12
maloyd: folds 
Sir_Fuj1: raises $18 to $30
floriiiiider: folds 
x_QUIXTAR_x: folds 
Y-Yx777: calls $18
*** FLOP *** [2d Qh 9c]
Y-Yx777: checks 
Sir_Fuj1: bets $33
Y-Yx777: calls $33
*** TURN *** [2d Qh 9c] [5h]
Y-Yx777: checks 
Sir_Fuj1: bets $99
Y-Yx777: folds 
Uncalled bet ($99) returned to Sir_Fuj1
Sir_Fuj1 collected $132.20 from pot
Sir_Fuj1: doesn't show hand 
*** SUMMARY ***
Total pot $135 | Rake $2.80 
Board [2d Qh 9c 5h]
Seat 1: x_QUIXTAR_x (big blind) folded before Flop
Seat 2: Flying Smile folded before Flop (didn't bet)
Seat 3: Y-Yx777 folded on the Turn
Seat 4: maloyd folded before Flop (didn't bet)
Seat 5: Sir_Fuj1 (button) collected ($132.20)
Seat 6: floriiiiider (small blind) folded before Flop


PokerStars Game #102614707218:  Hold'em No Limit ($3/$6 USD) - 2013/08/11 13:36:36 ET
Table 'Cydonia IX 40-100 bb' 6-max Seat #6 is the button
Seat 1: x_QUIXTAR_x ($1771.64 in chips) 
Seat 2: Flying Smile ($613.78 in chips) 
Seat 3: Y-Yx777 ($1218.94 in chips) 
Seat 4: maloyd ($600 in chips) 
Seat 5: Sir_Fuj1 ($363.43 in chips) 
Seat 6: floriiiiider ($1295.38 in chips) 
x_QUIXTAR_x: posts small blind $3
Flying Smile: posts big blind $6
*** HOLE CARDS ***
Y-Yx777: folds 
maloyd: folds 
Sir_Fuj1: folds 
floriiiiider: raises $6 to $12
x_QUIXTAR_x: folds 
Flying Smile: calls $6
*** FLOP *** [8h 7c 4h]
Flying Smile: checks 
floriiiiider: checks 
*** TURN *** [8h 7c 4h] [9c]
Flying Smile: bets $27
floriiiiider: folds 
Uncalled bet ($27) returned to Flying Smile
Flying Smile collected $25.78 from pot
*** SUMMARY ***
Total pot $27 | Rake $1.22 
Board [8h 7c 4h 9c]
Seat 1: x_QUIXTAR_x (small blind) folded before Flop
Seat 2: Flying Smile (big blind) collected ($25.78)
Seat 3: Y-Yx777 folded before Flop (didn't bet)
Seat 4: maloyd folded before Flop (didn't bet)
Seat 5: Sir_Fuj1 folded before Flop (didn't bet)
Seat 6: floriiiiider (button) folded on the Turn


PokerStars Game #102614740151:  Hold'em No Limit ($3/$6 USD) - 2013/08/11 13:37:16 ET
Table 'Cydonia IX 40-100 bb' 6-max Seat #1 is the button
Seat 1: x_QUIXTAR_x ($1768.64 in chips) 
Seat 2: Flying Smile ($627.56 in chips) 
Seat 3: Y-Yx777 ($1218.94 in chips) 
Seat 4: maloyd ($600 in chips) 
Seat 5: Sir_Fuj1 ($363.43 in chips) 
Seat 6: floriiiiider ($1283.38 in chips) 
Flying Smile: posts small blind $3
Y-Yx777: posts big blind $6
*** HOLE CARDS ***
maloyd: folds 
Sir_Fuj1: raises $12 to $18
floriiiiider: folds 
x_QUIXTAR_x: folds 
Flying Smile: folds 
Y-Yx777: folds 
Uncalled bet ($12) returned to Sir_Fuj1
Sir_Fuj1 collected $15 from pot
Sir_Fuj1: doesn't show hand 
*** SUMMARY ***
Total pot $15 | Rake $0 
Seat 1: x_QUIXTAR_x (button) folded before Flop (didn't bet)
Seat 2: Flying Smile (small blind) folded before Flop
Seat 3: Y-Yx777 (big blind) folded before Flop
Seat 4: maloyd folded before Flop (didn't bet)
Seat 5: Sir_Fuj1 collected ($15)
Seat 6: floriiiiider folded before Flop (didn't bet)


PokerStars Game #102614766437:  Hold'em No Limit ($3/$6 USD) - 2013/08/11 13:37:48 ET
Table 'Cydonia IX 40-100 bb' 6-max Seat #2 is the button
Seat 1: x_QUIXTAR_x ($1768.64 in chips) 
Seat 2: Flying Smile ($624.56 in chips) 
Seat 3: Y-Yx777 ($1212.94 in chips) 
Seat 4: maloyd ($600 in chips) 
Seat 5: Sir_Fuj1 ($372.43 in chips) 
Seat 6: floriiiiider ($1283.38 in chips) 
Y-Yx777: posts small blind $3
maloyd: posts big blind $6
*** HOLE CARDS ***
Sir_Fuj1: folds 
floriiiiider: folds 
x_QUIXTAR_x: folds 
Flying Smile: raises $6 to $12
Y-Yx777: calls $9
maloyd: folds 
*** FLOP *** [7d 3h 3c]
Y-Yx777: checks 
Flying Smile: bets $18
Y-Yx777: calls $18
*** TURN *** [7d 3h 3c] [7s]
Y-Yx777: checks 
Flying Smile: bets $36
Y-Yx777: calls $36
*** RIVER *** [7d 3h 3c 7s] [9d]
Y-Yx777: checks 
Flying Smile: checks 
*** SHOW DOWN ***
Y-Yx777: shows [Qc Th] (two pair, Sevens and Threes)
Flying Smile: shows [Qh 8s] (two pair, Sevens and Threes)
Y-Yx777 collected $67.60 from pot
Flying Smile collected $67.60 from pot
*** SUMMARY ***
Total pot $138 | Rake $2.80 
Board [7d 3h 3c 7s 9d]
Seat 1: x_QUIXTAR_x folded before Flop (didn't bet)
Seat 2: Flying Smile (button) showed [Qh 8s] and won ($67.60) with two pair, Sevens and Threes
Seat 3: Y-Yx777 (small blind) showed [Qc Th] and won ($67.60) with two pair, Sevens and Threes
Seat 4: maloyd (big blind) folded before Flop
Seat 5: Sir_Fuj1 folded before Flop (didn't bet)
Seat 6: floriiiiider folded before Flop (didn't bet)


PokerStars Game #102614820645:  Hold'em No Limit ($3/$6 USD) - 2013/08/11 13:38:53 ET
Table 'Cydonia IX 40-100 bb' 6-max Seat #3 is the button
Seat 1: x_QUIXTAR_x ($1768.64 in chips) 
Seat 2: Flying Smile ($626.16 in chips) 
Seat 3: Y-Yx777 ($1214.54 in chips) 
Seat 4: maloyd ($600 in chips) 
Seat 5: Sir_Fuj1 ($372.43 in chips) 
Seat 6: floriiiiider ($1283.38 in chips) 
maloyd: posts small blind $3
Sir_Fuj1: posts big blind $6
*** HOLE CARDS ***
floriiiiider: folds 
x_QUIXTAR_x: folds 
Flying Smile: folds 
Y-Yx777: raises $6 to $12
maloyd: raises $36 to $48
Sir_Fuj1: folds 
Y-Yx777: folds 
Uncalled bet ($36) returned to maloyd
maloyd collected $30 from pot
*** SUMMARY ***
Total pot $30 | Rake $0 
Seat 1: x_QUIXTAR_x folded before Flop (didn't bet)
Seat 2: Flying Smile folded before Flop (didn't bet)
Seat 3: Y-Yx777 (button) folded before Flop
Seat 4: maloyd (small blind) collected ($30)
Seat 5: Sir_Fuj1 (big blind) folded before Flop
Seat 6: floriiiiider folded before Flop (didn't bet)


PokerStars Game #102614835606:  Hold'em No Limit ($3/$6 USD) - 2013/08/11 13:39:11 ET
Table 'Cydonia IX 40-100 bb' 6-max Seat #4 is the button
Seat 1: x_QUIXTAR_x ($1768.64 in chips) 
Seat 2: Flying Smile ($626.16 in chips) 
Seat 3: Y-Yx777 ($1202.54 in chips) 
Seat 4: maloyd ($618 in chips) 
Seat 5: Sir_Fuj1 ($366.43 in chips) 
Seat 6: floriiiiider ($1283.38 in chips) 
Sir_Fuj1: posts small blind $3
floriiiiider: posts big blind $6
*** HOLE CARDS ***
x_QUIXTAR_x: raises $7.50 to $13.50
Flying Smile: raises $31.50 to $45
Y-Yx777: folds 
maloyd: folds 
Sir_Fuj1: raises $321.43 to $366.43 and is all-in
floriiiiider: folds 
x_QUIXTAR_x: folds 
Flying Smile: folds 
Uncalled bet ($321.43) returned to Sir_Fuj1
Sir_Fuj1 collected $109.50 from pot
*** SUMMARY ***
Total pot $109.50 | Rake $0 
Seat 1: x_QUIXTAR_x folded before Flop
Seat 2: Flying Smile folded before Flop
Seat 3: Y-Yx777 folded before Flop (didn't bet)
Seat 4: maloyd (button) folded before Flop (didn't bet)
Seat 5: Sir_Fuj1 (small blind) collected ($109.50)
Seat 6: floriiiiider (big blind) folded before Flop


PokerStars Game #102614860113:  Hold'em No Limit ($3/$6 USD) - 2013/08/11 13:39:40 ET
Table 'Cydonia IX 40-100 bb' 6-max Seat #5 is the button
Seat 1: x_QUIXTAR_x ($1755.14 in chips) 
Seat 2: Flying Smile ($600 in chips) 
Seat 3: Y-Yx777 ($1202.54 in chips) 
Seat 4: maloyd ($618 in chips) 
Seat 5: Sir_Fuj1 ($430.93 in chips) 
Seat 6: floriiiiider ($1277.38 in chips) 
floriiiiider: posts small blind $3
x_QUIXTAR_x: posts big blind $6
*** HOLE CARDS ***
Flying Smile: raises $12 to $18
Y-Yx777: folds 
maloyd: folds 
Sir_Fuj1: calls $18
floriiiiider: folds 
x_QUIXTAR_x: folds 
*** FLOP *** [6h 8c 6d]
Flying Smile: bets $24
Sir_Fuj1: folds 
Uncalled bet ($24) returned to Flying Smile
Flying Smile collected $42.98 from pot
*** SUMMARY ***
Total pot $45 | Rake $2.02 
Board [6h 8c 6d]
Seat 1: x_QUIXTAR_x (big blind) folded before Flop
Seat 2: Flying Smile collected ($42.98)
Seat 3: Y-Yx777 folded before Flop (didn't bet)
Seat 4: maloyd folded before Flop (didn't bet)
Seat 5: Sir_Fuj1 (button) folded on the Flop
Seat 6: floriiiiider (small blind) folded before Flop


PokerStars Game #102614393637:  Hold'em No Limit ($3/$6 USD) - 2013/08/11 13:30:22 ET
Table 'Cydonia IX 40-100 bb' 6-max Seat #5 is the button
Seat 1: x_QUIXTAR_x ($1672.44 in chips) 
Seat 2: Flying Smile ($600 in chips) 
Seat 3: Y-Yx777 ($1254.74 in chips) 
Seat 5: Sir_Fuj1 ($286.58 in chips) 
Seat 6: floriiiiider ($1403.38 in chips) 
floriiiiider: posts small blind $3
x_QUIXTAR_x: posts big blind $6
*** HOLE CARDS ***
Flying Smile: folds 
Y-Yx777: raises $6 to $12
Sir_Fuj1: folds 
floriiiiider: raises $33 to $45
x_QUIXTAR_x: raises $45 to $90
Y-Yx777: folds 
floriiiiider: calls $45
*** FLOP *** [9c 5c 9h]
floriiiiider: checks 
x_QUIXTAR_x: checks 
*** TURN *** [9c 5c 9h] [Kc]
floriiiiider: checks 
maloyd joins the table at seat #4 
x_QUIXTAR_x: bets $60
floriiiiider: folds 
Uncalled bet ($60) returned to x_QUIXTAR_x
x_QUIXTAR_x collected $189.20 from pot
x_QUIXTAR_x: doesn't show hand 
*** SUMMARY ***
Total pot $192 | Rake $2.80 
Board [9c 5c 9h Kc]
Seat 1: x_QUIXTAR_x (big blind) collected ($189.20)
Seat 2: Flying Smile folded before Flop (didn't bet)
Seat 3: Y-Yx777 folded before Flop
Seat 5: Sir_Fuj1 (button) folded before Flop (didn't bet)
Seat 6: floriiiiider (small blind) folded on the Turn


PokerStars Game #102614458571:  Hold'em No Limit ($3/$6 USD) - 2013/08/11 13:31:40 ET
Table 'Cydonia IX 40-100 bb' 6-max Seat #6 is the button
Seat 1: x_QUIXTAR_x ($1771.64 in chips) 
Seat 2: Flying Smile ($600 in chips) 
Seat 3: Y-Yx777 ($1242.74 in chips) 
Seat 5: Sir_Fuj1 ($286.58 in chips) 
Seat 6: floriiiiider ($1313.38 in chips) 
x_QUIXTAR_x: posts small blind $3
Flying Smile: posts big blind $6
maloyd: sits out 
*** HOLE CARDS ***
Y-Yx777: folds 
Sir_Fuj1: folds 
floriiiiider: folds 
x_QUIXTAR_x: raises $7.50 to $13.50
Flying Smile: folds 
Uncalled bet ($7.50) returned to x_QUIXTAR_x
x_QUIXTAR_x collected $12 from pot
x_QUIXTAR_x: doesn't show hand 
*** SUMMARY ***
Total pot $12 | Rake $0 
Seat 1: x_QUIXTAR_x (small blind) collected ($12)
Seat 2: Flying Smile (big blind) folded before Flop
Seat 3: Y-Yx777 folded before Flop (didn't bet)
Seat 5: Sir_Fuj1 folded before Flop (didn't bet)
Seat 6: floriiiiider (button) folded before Flop (didn't bet)


PokerStars Game #102614481449:  Hold'em No Limit ($3/$6 USD) - 2013/08/11 13:32:07 ET
Table 'Cydonia IX 40-100 bb' 6-max Seat #1 is the button
Seat 1: x_QUIXTAR_x ($1777.64 in chips) 
Seat 2: Flying Smile ($600 in chips) 
Seat 3: Y-Yx777 ($1242.74 in chips) 
Seat 5: Sir_Fuj1 ($286.58 in chips) 
Seat 6: floriiiiider ($1313.38 in chips) 
Flying Smile: posts small blind $3
Y-Yx777: posts big blind $6
maloyd: sits out 
*** HOLE CARDS ***
Sir_Fuj1: folds 
floriiiiider: folds 
x_QUIXTAR_x: folds 
Flying Smile: raises $12 to $18
Y-Yx777: calls $12
*** FLOP *** [Jh 3c Tc]
Flying Smile: bets $18
Y-Yx777: calls $18
*** TURN *** [Jh 3c Tc] [2h]
Flying Smile: checks 
Y-Yx777: bets $42
Flying Smile: folds 
Uncalled bet ($42) returned to Y-Yx777
Y-Yx777 collected $69.20 from pot
*** SUMMARY ***
Total pot $72 | Rake $2.80 
Board [Jh 3c Tc 2h]
Seat 1: x_QUIXTAR_x (button) folded before Flop (didn't bet)
Seat 2: Flying Smile (small blind) folded on the Turn
Seat 3: Y-Yx777 (big blind) collected ($69.20)
Seat 5: Sir_Fuj1 folded before Flop (didn't bet)
Seat 6: floriiiiider folded before Flop (didn't bet)


PokerStars Game #102614515806:  Hold'em No Limit ($3/$6 USD) - 2013/08/11 13:32:48 ET
Table 'Cydonia IX 40-100 bb' 6-max Seat #2 is the button
Seat 1: x_QUIXTAR_x ($1777.64 in chips) 
Seat 2: Flying Smile ($600 in chips) 
Seat 3: Y-Yx777 ($1275.94 in chips) 
Seat 4: maloyd ($600 in chips) 
Seat 5: Sir_Fuj1 ($286.58 in chips) 
Seat 6: floriiiiider ($1313.38 in chips) 
Y-Yx777: posts small blind $3
maloyd: posts big blind $6
*** HOLE CARDS ***
Sir_Fuj1: folds 
floriiiiider: folds 
x_QUIXTAR_x: folds 
Flying Smile: raises $6 to $12
Y-Yx777: folds 
maloyd: calls $6
*** FLOP *** [Qh 7h 2d]
maloyd: checks 
Flying Smile: bets $18
maloyd: folds 
Uncalled bet ($18) returned to Flying Smile
Flying Smile collected $25.78 from pot
*** SUMMARY ***
Total pot $27 | Rake $1.22 
Board [Qh 7h 2d]
Seat 1: x_QUIXTAR_x folded before Flop (didn't bet)
Seat 2: Flying Smile (button) collected ($25.78)
Seat 3: Y-Yx777 (small blind) folded before Flop
Seat 4: maloyd (big blind) folded on the Flop
Seat 5: Sir_Fuj1 folded before Flop (didn't bet)
Seat 6: floriiiiider folded before Flop (didn't bet)


PokerStars Game #102614569519:  Hold'em No Limit ($3/$6 USD) - 2013/08/11 13:33:52 ET
Table 'Cydonia IX 40-100 bb' 6-max Seat #3 is the button
Seat 1: x_QUIXTAR_x ($1777.64 in chips) 
Seat 2: Flying Smile ($613.78 in chips) 
Seat 3: Y-Yx777 ($1272.94 in chips) 
Seat 4: maloyd ($600 in chips) 
Seat 5: Sir_Fuj1 ($286.58 in chips) 
Seat 6: floriiiiider ($1313.38 in chips) 
maloyd: posts small blind $3
Sir_Fuj1: posts big blind $6
*** HOLE CARDS ***
floriiiiider: folds 
x_QUIXTAR_x: folds 
Flying Smile: folds 
Y-Yx777: raises $6 to $12
maloyd: folds 
Sir_Fuj1: folds 
Uncalled bet ($6) returned to Y-Yx777
Y-Yx777 collected $15 from pot
*** SUMMARY ***
Total pot $15 | Rake $0 
Seat 1: x_QUIXTAR_x folded before Flop (didn't bet)
Seat 2: Flying Smile folded before Flop (didn't bet)
Seat 3: Y-Yx777 (button) collected ($15)
Seat 4: maloyd (small blind) folded before Flop
Seat 5: Sir_Fuj1 (big blind) folded before Flop
Seat 6: floriiiiider folded before Flop (didn't bet)


PokerStars Game #102614609666:  Hold'em No Limit ($3/$6 USD) - 2013/08/11 13:34:39 ET
Table 'Cydonia IX 40-100 bb' 6-max Seat #4 is the button
Seat 1: x_QUIXTAR_x ($1777.64 in chips) 
Seat 2: Flying Smile ($613.78 in chips) 
Seat 3: Y-Yx777 ($1281.94 in chips) 
Seat 4: maloyd ($600 in chips) 
Seat 5: Sir_Fuj1 ($280.58 in chips) 
Seat 6: floriiiiider ($1313.38 in chips) 
Sir_Fuj1: posts small blind $3
floriiiiider: posts big blind $6
*** HOLE CARDS ***
x_QUIXTAR_x: folds 
Flying Smile: folds 
Y-Yx777: folds 
maloyd: folds 
Sir_Fuj1: calls $3
floriiiiider: checks 
*** FLOP *** [2s 3d 5d]
Sir_Fuj1: bets $9
floriiiiider: calls $9
*** TURN *** [2s 3d 5d] [6d]
Sir_Fuj1: checks 
floriiiiider: checks 
*** RIVER *** [2s 3d 5d 6d] [9h]
Sir_Fuj1: bets $21
floriiiiider: folds 
Uncalled bet ($21) returned to Sir_Fuj1
Sir_Fuj1 collected $28.65 from pot
Sir_Fuj1: doesn't show hand 
*** SUMMARY ***
Total pot $30 | Rake $1.35 
Board [2s 3d 5d 6d 9h]
Seat 1: x_QUIXTAR_x folded before Flop (didn't bet)
Seat 2: Flying Smile folded before Flop (didn't bet)
Seat 3: Y-Yx777 folded before Flop (didn't bet)
Seat 4: maloyd (button) folded before Flop (didn't bet)
Seat 5: Sir_Fuj1 (small blind) collected ($28.65)
Seat 6: floriiiiider (big blind) folded on the River


PokerStars Game #102616003202:  Hold'em No Limit ($3/$6 USD) - 2013/08/11 14:05:00 ET
Table 'Cydonia IX 40-100 bb' 6-max Seat #3 is the button
Seat 2: Flying Smile ($690 in chips) 
Seat 3: Y-Yx777 ($1255.95 in chips) 
Seat 4: maloyd ($757.58 in chips) 
Seat 5: Sir_Fuj1 ($256.93 in chips) 
Seat 6: floriiiiider ($1160.88 in chips) 
maloyd: posts small blind $3
Sir_Fuj1: posts big blind $6
*** HOLE CARDS ***
TTSIP joins the table at seat #1 
floriiiiider: folds 
Flying Smile: folds 
Y-Yx777: folds 
maloyd: raises $7.80 to $13.80
Sir_Fuj1: folds 
Uncalled bet ($7.80) returned to maloyd
maloyd collected $12 from pot
*** SUMMARY ***
Total pot $12 | Rake $0 
Seat 2: Flying Smile folded before Flop (didn't bet)
Seat 3: Y-Yx777 (button) folded before Flop (didn't bet)
Seat 4: maloyd (small blind) collected ($12)
Seat 5: Sir_Fuj1 (big blind) folded before Flop
Seat 6: floriiiiider folded before Flop (didn't bet)


PokerStars Game #102616027461:  Hold'em No Limit ($3/$6 USD) - 2013/08/11 14:05:28 ET
Table 'Cydonia IX 40-100 bb' 6-max Seat #4 is the button
Seat 2: Flying Smile ($690 in chips) 
Seat 3: Y-Yx777 ($1255.95 in chips) 
Seat 4: maloyd ($763.58 in chips) 
Seat 5: Sir_Fuj1 ($250.93 in chips) 
Seat 6: floriiiiider ($1160.88 in chips) 
Sir_Fuj1: posts small blind $3
floriiiiider: posts big blind $6
TTSIP: sits out 
*** HOLE CARDS ***
Flying Smile: folds 
Y-Yx777: folds 
maloyd: raises $6 to $12
Sir_Fuj1: folds 
floriiiiider: calls $6
*** FLOP *** [9d 3d 7s]
floriiiiider: checks 
maloyd: bets $18
floriiiiider: raises $45 to $63
maloyd: calls $45
*** TURN *** [9d 3d 7s] [8s]
floriiiiider: checks 
maloyd: bets $129
floriiiiider: folds 
Uncalled bet ($129) returned to maloyd
maloyd collected $150.20 from pot
*** SUMMARY ***
Total pot $153 | Rake $2.80 
Board [9d 3d 7s 8s]
Seat 2: Flying Smile folded before Flop (didn't bet)
Seat 3: Y-Yx777 folded before Flop (didn't bet)
Seat 4: maloyd (button) collected ($150.20)
Seat 5: Sir_Fuj1 (small blind) folded before Flop
Seat 6: floriiiiider (big blind) folded on the Turn


PokerStars Game #102616098460:  Hold'em No Limit ($3/$6 USD) - 2013/08/11 14:06:50 ET
Table 'Cydonia IX 40-100 bb' 6-max Seat #5 is the button
Seat 1: TTSIP ($600 in chips) 
Seat 2: Flying Smile ($690 in chips) 
Seat 3: Y-Yx777 ($1255.95 in chips) 
Seat 4: maloyd ($838.78 in chips) 
Seat 5: Sir_Fuj1 ($247.93 in chips) 
Seat 6: floriiiiider ($1085.88 in chips) 
floriiiiider: posts small blind $3
TTSIP: posts big blind $6
*** HOLE CARDS ***
Flying Smile: folds 
Y-Yx777: folds 
maloyd: raises $7.80 to $13.80
Sir_Fuj1: folds 
floriiiiider: folds 
TTSIP: calls $7.80
*** FLOP *** [3c 7c 6d]
TTSIP: checks 
maloyd: bets $21
TTSIP: folds 
Uncalled bet ($21) returned to maloyd
maloyd collected $29.22 from pot
*** SUMMARY ***
Total pot $30.60 | Rake $1.38 
Board [3c 7c 6d]
Seat 1: TTSIP (big blind) folded on the Flop
Seat 2: Flying Smile folded before Flop (didn't bet)
Seat 3: Y-Yx777 folded before Flop (didn't bet)
Seat 4: maloyd collected ($29.22)
Seat 5: Sir_Fuj1 (button) folded before Flop (didn't bet)
Seat 6: floriiiiider (small blind) folded before Flop


PokerStars Game #102616137496:  Hold'em No Limit ($3/$6 USD) - 2013/08/11 14:07:35 ET
Table 'Cydonia IX 40-100 bb' 6-max Seat #6 is the button
Seat 1: TTSIP ($600 in chips) 
Seat 2: Flying Smile ($690 in chips) 
Seat 3: Y-Yx777 ($1255.95 in chips) 
Seat 4: maloyd ($854.20 in chips) 
Seat 5: Sir_Fuj1 ($247.93 in chips) 
Seat 6: floriiiiider ($1082.88 in chips) 
TTSIP: posts small blind $3
Flying Smile: posts big blind $6
*** HOLE CARDS ***
Y-Yx777: folds 
maloyd: folds 
Sir_Fuj1: folds 
floriiiiider: folds 
TTSIP: folds 
Uncalled bet ($3) returned to Flying Smile
Flying Smile collected $6 from pot
*** SUMMARY ***
Total pot $6 | Rake $0 
Seat 1: TTSIP (small blind) folded before Flop
Seat 2: Flying Smile (big blind) collected ($6)
Seat 3: Y-Yx777 folded before Flop (didn't bet)
Seat 4: maloyd folded before Flop (didn't bet)
Seat 5: Sir_Fuj1 folded before Flop (didn't bet)
Seat 6: floriiiiider (button) folded before Flop (didn't bet)


PokerStars Game #102616150541:  Hold'em No Limit ($3/$6 USD) - 2013/08/11 14:07:50 ET
Table 'Cydonia IX 40-100 bb' 6-max Seat #1 is the button
Seat 1: TTSIP ($600 in chips) 
Seat 2: Flying Smile ($693 in chips) 
Seat 3: Y-Yx777 ($1255.95 in chips) 
Seat 4: maloyd ($854.20 in chips) 
Seat 5: Sir_Fuj1 ($247.93 in chips) 
Seat 6: floriiiiider ($1082.88 in chips) 
Flying Smile: posts small blind $3
Y-Yx777: posts big blind $6
*** HOLE CARDS ***
maloyd: folds 
Sir_Fuj1: folds 
floriiiiider: folds 
TTSIP: raises $6 to $12
Flying Smile: folds 
Y-Yx777: calls $6
*** FLOP *** [4d 6h 8h]
Y-Yx777: checks 
TTSIP: bets $18
Y-Yx777: calls $18
*** TURN *** [4d 6h 8h] [Kc]
Y-Yx777: checks 
TTSIP: bets $48
Y-Yx777: raises $60 to $108
TTSIP: calls $60
*** RIVER *** [4d 6h 8h Kc] [Qd]
Y-Yx777: checks 
TTSIP: bets $222
Y-Yx777: folds 
Uncalled bet ($222) returned to TTSIP
TTSIP collected $276.20 from pot
*** SUMMARY ***
Total pot $279 | Rake $2.80 
Board [4d 6h 8h Kc Qd]
Seat 1: TTSIP (button) collected ($276.20)
Seat 2: Flying Smile (small blind) folded before Flop
Seat 3: Y-Yx777 (big blind) folded on the River
Seat 4: maloyd folded before Flop (didn't bet)
Seat 5: Sir_Fuj1 folded before Flop (didn't bet)
Seat 6: floriiiiider folded before Flop (didn't bet)


PokerStars Game #102616247827:  Hold'em No Limit ($3/$6 USD) - 2013/08/11 14:09:43 ET
Table 'Cydonia IX 40-100 bb' 6-max Seat #2 is the button
Seat 1: TTSIP ($738.20 in chips) 
Seat 2: Flying Smile ($690 in chips) 
Seat 3: Y-Yx777 ($1117.95 in chips) 
Seat 4: maloyd ($854.20 in chips) 
Seat 5: Sir_Fuj1 ($247.93 in chips) 
Seat 6: floriiiiider ($1082.88 in chips) 
Y-Yx777: posts small blind $3
maloyd: posts big blind $6
*** HOLE CARDS ***
Sir_Fuj1: raises $12 to $18
floriiiiider: folds 
TTSIP: folds 
Flying Smile: folds 
Y-Yx777: folds 
maloyd: raises $36 to $54
Sir_Fuj1: raises $193.93 to $247.93 and is all-in
maloyd: calls $193.93
*** FIRST FLOP *** [9s 4c 5s]
*** FIRST TURN *** [9s 4c 5s] [8d]
*** FIRST RIVER *** [9s 4c 5s 8d] [Qd]
*** SECOND FLOP *** [4d Jd 2c]
*** SECOND TURN *** [4d Jd 2c] [Ts]
*** SECOND RIVER *** [4d Jd 2c Ts] [9h]
*** FIRST SHOW DOWN ***
maloyd: shows [Ac Kc] (high card Ace)
Sir_Fuj1: shows [Kh Kd] (a pair of Kings)
Sir_Fuj1 collected $248.03 from pot
*** SECOND SHOW DOWN ***
maloyd: shows [Ac Kc] (high card Ace)
Sir_Fuj1: shows [Kh Kd] (a pair of Kings)
Sir_Fuj1 collected $248.03 from pot
*** SUMMARY ***
Total pot $498.86 | Rake $2.80 
Hand was run twice
FIRST Board [9s 4c 5s 8d Qd]
SECOND Board [4d Jd 2c Ts 9h]
Seat 1: TTSIP folded before Flop (didn't bet)
Seat 2: Flying Smile (button) folded before Flop (didn't bet)
Seat 3: Y-Yx777 (small blind) folded before Flop
Seat 4: maloyd (big blind) showed [Ac Kc] and lost with high card Ace, and lost with high card Ace
Seat 5: Sir_Fuj1 showed [Kh Kd] and won ($248.03) with a pair of Kings, and won ($248.03) with a pair of Kings
Seat 6: floriiiiider folded before Flop (didn't bet)


PokerStars Game #102615623341:  Hold'em No Limit ($3/$6 USD) - 2013/08/11 13:55:07 ET
Table 'Cydonia IX 40-100 bb' 6-max Seat #1 is the button
Seat 1: x_QUIXTAR_x ($2010.08 in chips) 
Seat 2: Flying Smile ($630.20 in chips) 
Seat 3: Y-Yx777 ($1076.57 in chips) 
Seat 4: maloyd ($609 in chips) 
Seat 5: Sir_Fuj1 ($349.93 in chips) 
Seat 6: floriiiiider ($1430.88 in chips) 
Flying Smile: posts small blind $3
Y-Yx777: posts big blind $6
*** HOLE CARDS ***
maloyd: folds 
Sir_Fuj1: raises $12 to $18
floriiiiider: folds 
x_QUIXTAR_x: folds 
Flying Smile: folds 
Y-Yx777: calls $12
*** FLOP *** [6c 4s Tc]
Y-Yx777: checks 
Sir_Fuj1: bets $18
Y-Yx777: calls $18
*** TURN *** [6c 4s Tc] [Kc]
Y-Yx777: checks 
Sir_Fuj1: checks 
*** RIVER *** [6c 4s Tc Kc] [Jc]
Y-Yx777: checks 
Sir_Fuj1: checks 
*** SHOW DOWN ***
Y-Yx777: shows [Ks Qh] (a pair of Kings)
Sir_Fuj1: mucks hand 
Y-Yx777 collected $72.20 from pot
*** SUMMARY ***
Total pot $75 | Rake $2.80 
Board [6c 4s Tc Kc Jc]
Seat 1: x_QUIXTAR_x (button) folded before Flop (didn't bet)
Seat 2: Flying Smile (small blind) folded before Flop
Seat 3: Y-Yx777 (big blind) showed [Ks Qh] and won ($72.20) with a pair of Kings
Seat 4: maloyd folded before Flop (didn't bet)
Seat 5: Sir_Fuj1 mucked
Seat 6: floriiiiider folded before Flop (didn't bet)


PokerStars Game #102615663587:  Hold'em No Limit ($3/$6 USD) - 2013/08/11 13:56:21 ET
Table 'Cydonia IX 40-100 bb' 6-max Seat #2 is the button
Seat 1: x_QUIXTAR_x ($2010.08 in chips) 
Seat 2: Flying Smile ($627.20 in chips) 
Seat 3: Y-Yx777 ($1112.77 in chips) 
Seat 4: maloyd ($609 in chips) 
Seat 5: Sir_Fuj1 ($313.93 in chips) 
Seat 6: floriiiiider ($1430.88 in chips) 
Y-Yx777: posts small blind $3
maloyd: posts big blind $6
*** HOLE CARDS ***
Sir_Fuj1: raises $12 to $18
floriiiiider: folds 
x_QUIXTAR_x: folds 
Flying Smile: folds 
Y-Yx777: calls $15
maloyd: folds 
*** FLOP *** [6c Qc Kc]
Y-Yx777: checks 
Sir_Fuj1: bets $30
Y-Yx777: calls $30
*** TURN *** [6c Qc Kc] [Jh]
Y-Yx777: checks 
Sir_Fuj1: checks 
*** RIVER *** [6c Qc Kc Jh] [8s]
Y-Yx777: bets $72
Sir_Fuj1: folds 
Uncalled bet ($72) returned to Y-Yx777
Y-Yx777 collected $99.20 from pot
*** SUMMARY ***
Total pot $102 | Rake $2.80 
Board [6c Qc Kc Jh 8s]
Seat 1: x_QUIXTAR_x folded before Flop (didn't bet)
Seat 2: Flying Smile (button) folded before Flop (didn't bet)
Seat 3: Y-Yx777 (small blind) collected ($99.20)
Seat 4: maloyd (big blind) folded before Flop
Seat 5: Sir_Fuj1 folded on the River
Seat 6: floriiiiider folded before Flop (didn't bet)


PokerStars Game #102615689621:  Hold'em No Limit ($3/$6 USD) - 2013/08/11 13:57:13 ET
Table 'Cydonia IX 40-100 bb' 6-max Seat #3 is the button
Seat 1: x_QUIXTAR_x ($2010.08 in chips) 
Seat 2: Flying Smile ($627.20 in chips) 
Seat 3: Y-Yx777 ($1163.97 in chips) 
Seat 4: maloyd ($603 in chips) 
Seat 5: Sir_Fuj1 ($265.93 in chips) 
Seat 6: floriiiiider ($1430.88 in chips) 
maloyd: posts small blind $3
Sir_Fuj1: posts big blind $6
*** HOLE CARDS ***
floriiiiider: folds 
x_QUIXTAR_x: folds 
Flying Smile: folds 
Y-Yx777: raises $6 to $12
maloyd: raises $36 to $48
Sir_Fuj1: folds 
Y-Yx777: calls $36
*** FLOP *** [Kh 3d 7h]
maloyd: bets $60
Y-Yx777: calls $60
*** TURN *** [Kh 3d 7h] [3h]
maloyd: bets $132
Y-Yx777: folds 
Uncalled bet ($132) returned to maloyd
maloyd collected $219.20 from pot
*** SUMMARY ***
Total pot $222 | Rake $2.80 
Board [Kh 3d 7h 3h]
Seat 1: x_QUIXTAR_x folded before Flop (didn't bet)
Seat 2: Flying Smile folded before Flop (didn't bet)
Seat 3: Y-Yx777 (button) folded on the Turn
Seat 4: maloyd (small blind) collected ($219.20)
Seat 5: Sir_Fuj1 (big blind) folded before Flop
Seat 6: floriiiiider folded before Flop (didn't bet)


PokerStars Game #102615709520:  Hold'em No Limit ($3/$6 USD) - 2013/08/11 13:57:52 ET
Table 'Cydonia IX 40-100 bb' 6-max Seat #4 is the button
Seat 1: x_QUIXTAR_x ($2010.08 in chips) 
Seat 2: Flying Smile ($627.20 in chips) 
Seat 3: Y-Yx777 ($1055.97 in chips) 
Seat 4: maloyd ($714.20 in chips) 
Seat 5: Sir_Fuj1 ($259.93 in chips) 
Seat 6: floriiiiider ($1430.88 in chips) 
Sir_Fuj1: posts small blind $3
floriiiiider: posts big blind $6
*** HOLE CARDS ***
x_QUIXTAR_x: folds 
Flying Smile: raises $6 to $12
Y-Yx777: folds 
maloyd: folds 
Sir_Fuj1: folds 
floriiiiider: folds 
Uncalled bet ($6) returned to Flying Smile
Flying Smile collected $15 from pot
*** SUMMARY ***
Total pot $15 | Rake $0 
Seat 1: x_QUIXTAR_x folded before Flop (didn't bet)
Seat 2: Flying Smile collected ($15)
Seat 3: Y-Yx777 folded before Flop (didn't bet)
Seat 4: maloyd (button) folded before Flop (didn't bet)
Seat 5: Sir_Fuj1 (small blind) folded before Flop
Seat 6: floriiiiider (big blind) folded before Flop


PokerStars Game #102615718013:  Hold'em No Limit ($3/$6 USD) - 2013/08/11 13:58:09 ET
Table 'Cydonia IX 40-100 bb' 6-max Seat #5 is the button
Seat 1: x_QUIXTAR_x ($2010.08 in chips) 
Seat 2: Flying Smile ($636.20 in chips) 
Seat 3: Y-Yx777 ($1055.97 in chips) 
Seat 4: maloyd ($714.20 in chips) 
Seat 5: Sir_Fuj1 ($256.93 in chips) 
Seat 6: floriiiiider ($1424.88 in chips) 
floriiiiider: posts small blind $3
x_QUIXTAR_x: posts big blind $6
*** HOLE CARDS ***
Flying Smile: folds 
Y-Yx777: folds 
maloyd: folds 
Sir_Fuj1: folds 
floriiiiider: folds 
Uncalled bet ($3) returned to x_QUIXTAR_x
x_QUIXTAR_x collected $6 from pot
x_QUIXTAR_x: doesn't show hand 
*** SUMMARY ***
Total pot $6 | Rake $0 
Seat 1: x_QUIXTAR_x (big blind) collected ($6)
Seat 2: Flying Smile folded before Flop (didn't bet)
Seat 3: Y-Yx777 folded before Flop (didn't bet)
Seat 4: maloyd folded before Flop (didn't bet)
Seat 5: Sir_Fuj1 (button) folded before Flop (didn't bet)
Seat 6: floriiiiider (small blind) folded before Flop


PokerStars Game #102615724731:  Hold'em No Limit ($3/$6 USD) - 2013/08/11 13:58:22 ET
Table 'Cydonia IX 40-100 bb' 6-max Seat #6 is the button
Seat 1: x_QUIXTAR_x ($2013.08 in chips) 
Seat 2: Flying Smile ($636.20 in chips) 
Seat 3: Y-Yx777 ($1055.97 in chips) 
Seat 4: maloyd ($714.20 in chips) 
Seat 5: Sir_Fuj1 ($256.93 in chips) 
Seat 6: floriiiiider ($1421.88 in chips) 
x_QUIXTAR_x: posts small blind $3
Flying Smile: posts big blind $6
*** HOLE CARDS ***
Y-Yx777: raises $6 to $12
maloyd: folds 
Sir_Fuj1: folds 
floriiiiider: folds 
x_QUIXTAR_x: folds 
Flying Smile: calls $6
*** FLOP *** [5c Kc Kh]
Flying Smile: checks 
Y-Yx777: checks 
*** TURN *** [5c Kc Kh] [Qh]
Flying Smile: checks 
Y-Yx777: bets $12
Flying Smile: folds 
Uncalled bet ($12) returned to Y-Yx777
Y-Yx777 collected $25.78 from pot
*** SUMMARY ***
Total pot $27 | Rake $1.22 
Board [5c Kc Kh Qh]
Seat 1: x_QUIXTAR_x (small blind) folded before Flop
Seat 2: Flying Smile (big blind) folded on the Turn
Seat 3: Y-Yx777 collected ($25.78)
Seat 4: maloyd folded before Flop (didn't bet)
Seat 5: Sir_Fuj1 folded before Flop (didn't bet)
Seat 6: floriiiiider (button) folded before Flop (didn't bet)


PokerStars Game #102615748696:  Hold'em No Limit ($3/$6 USD) - 2013/08/11 13:59:09 ET
Table 'Cydonia IX 40-100 bb' 6-max Seat #1 is the button
Seat 1: x_QUIXTAR_x ($2010.08 in chips) 
Seat 2: Flying Smile ($624.20 in chips) 
Seat 3: Y-Yx777 ($1069.75 in chips) 
Seat 4: maloyd ($714.20 in chips) 
Seat 5: Sir_Fuj1 ($256.93 in chips) 
Seat 6: floriiiiider ($1421.88 in chips) 
Flying Smile: posts small blind $3
Y-Yx777: posts big blind $6
*** HOLE CARDS ***
maloyd: folds 
Sir_Fuj1: folds 
floriiiiider: raises $9 to $15
x_QUIXTAR_x: folds 
Flying Smile: raises $36 to $51
Y-Yx777: calls $45
floriiiiider: calls $36
*** FLOP *** [6h 5d As]
Flying Smile: checks 
Y-Yx777: checks 
floriiiiider: checks 
*** TURN *** [6h 5d As] [3d]
Flying Smile: checks 
Y-Yx777: bets $108
floriiiiider: calls $108
Flying Smile: folds 
*** RIVER *** [6h 5d As 3d] [Kc]
Y-Yx777: bets $186
floriiiiider: folds 
Uncalled bet ($186) returned to Y-Yx777
Y-Yx777 collected $366.20 from pot
*** SUMMARY ***
Total pot $369 | Rake $2.80 
Board [6h 5d As 3d Kc]
Seat 1: x_QUIXTAR_x (button) folded before Flop (didn't bet)
Seat 2: Flying Smile (small blind) folded on the Turn
Seat 3: Y-Yx777 (big blind) collected ($366.20)
Seat 4: maloyd folded before Flop (didn't bet)
Seat 5: Sir_Fuj1 folded before Flop (didn't bet)
Seat 6: floriiiiider folded on the River


PokerStars Game #102615838117:  Hold'em No Limit ($3/$6 USD) - 2013/08/11 14:01:38 ET
Table 'Cydonia IX 40-100 bb' 6-max Seat #2 is the button
Seat 1: x_QUIXTAR_x ($2010.08 in chips) 
Seat 2: Flying Smile ($600 in chips) 
Seat 3: Y-Yx777 ($1276.95 in chips) 
Seat 4: maloyd ($714.20 in chips) 
Seat 5: Sir_Fuj1 ($256.93 in chips) 
Seat 6: floriiiiider ($1262.88 in chips) 
Y-Yx777: posts small blind $3
maloyd: posts big blind $6
*** HOLE CARDS ***
Sir_Fuj1: folds 
floriiiiider: folds 
x_QUIXTAR_x: folds 
Flying Smile: raises $6 to $12
Y-Yx777: folds 
maloyd: raises $36 to $48
Flying Smile: folds 
Uncalled bet ($36) returned to maloyd
maloyd collected $27 from pot
*** SUMMARY ***
Total pot $27 | Rake $0 
Seat 1: x_QUIXTAR_x folded before Flop (didn't bet)
Seat 2: Flying Smile (button) folded before Flop
Seat 3: Y-Yx777 (small blind) folded before Flop
Seat 4: maloyd (big blind) collected ($27)
Seat 5: Sir_Fuj1 folded before Flop (didn't bet)
Seat 6: floriiiiider folded before Flop (didn't bet)


PokerStars Game #102615855784:  Hold'em No Limit ($3/$6 USD) - 2013/08/11 14:02:02 ET
Table 'Cydonia IX 40-100 bb' 6-max Seat #3 is the button
Seat 1: x_QUIXTAR_x ($2010.08 in chips) 
Seat 2: Flying Smile ($600 in chips) 
Seat 3: Y-Yx777 ($1273.95 in chips) 
Seat 4: maloyd ($729.20 in chips) 
Seat 5: Sir_Fuj1 ($256.93 in chips) 
Seat 6: floriiiiider ($1262.88 in chips) 
maloyd: posts small blind $3
Sir_Fuj1: posts big blind $6
*** HOLE CARDS ***
floriiiiider: folds 
x_QUIXTAR_x: folds 
Flying Smile: folds 
Y-Yx777: folds 
maloyd: raises $10.80 to $16.80
Sir_Fuj1: folds 
Uncalled bet ($10.80) returned to maloyd
maloyd collected $12 from pot
*** SUMMARY ***
Total pot $12 | Rake $0 
Seat 1: x_QUIXTAR_x folded before Flop (didn't bet)
Seat 2: Flying Smile folded before Flop (didn't bet)
Seat 3: Y-Yx777 (button) folded before Flop (didn't bet)
Seat 4: maloyd (small blind) collected ($12)
Seat 5: Sir_Fuj1 (big blind) folded before Flop
Seat 6: floriiiiider folded before Flop (didn't bet)


PokerStars Game #102615882489:  Hold'em No Limit ($3/$6 USD) - 2013/08/11 14:02:36 ET
Table 'Cydonia IX 40-100 bb' 6-max Seat #4 is the button
Seat 1: x_QUIXTAR_x ($2010.08 in chips) 
Seat 2: Flying Smile ($600 in chips) 
Seat 3: Y-Yx777 ($1273.95 in chips) 
Seat 4: maloyd ($735.20 in chips) 
Seat 5: Sir_Fuj1 ($250.93 in chips) 
Seat 6: floriiiiider ($1262.88 in chips) 
Sir_Fuj1: posts small blind $3
floriiiiider: posts big blind $6
*** HOLE CARDS ***
x_QUIXTAR_x: folds 
Flying Smile: raises $12 to $18
Y-Yx777: folds 
maloyd: folds 
Sir_Fuj1: folds 
floriiiiider: folds 
Uncalled bet ($12) returned to Flying Smile
Flying Smile collected $15 from pot
*** SUMMARY ***
Total pot $15 | Rake $0 
Seat 1: x_QUIXTAR_x folded before Flop (didn't bet)
Seat 2: Flying Smile collected ($15)
Seat 3: Y-Yx777 folded before Flop (didn't bet)
Seat 4: maloyd (button) folded before Flop (didn't bet)
Seat 5: Sir_Fuj1 (small blind) folded before Flop
Seat 6: floriiiiider (big blind) folded before Flop


PokerStars Game #102615901540:  Hold'em No Limit ($3/$6 USD) - 2013/08/11 14:03:00 ET
Table 'Cydonia IX 40-100 bb' 6-max Seat #5 is the button
Seat 2: Flying Smile ($609 in chips) 
Seat 3: Y-Yx777 ($1273.95 in chips) 
Seat 4: maloyd ($735.20 in chips) 
Seat 5: Sir_Fuj1 ($247.93 in chips) 
Seat 6: floriiiiider ($1256.88 in chips) 
floriiiiider: posts small blind $3
x_QUIXTAR_x: is sitting out 
x_QUIXTAR_x leaves the table
Flying Smile: posts big blind $6
*** HOLE CARDS ***
Y-Yx777: folds 
maloyd: folds 
Sir_Fuj1: raises $9 to $15
floriiiiider: folds 
Flying Smile: folds 
Uncalled bet ($9) returned to Sir_Fuj1
Sir_Fuj1 collected $15 from pot
Sir_Fuj1: doesn't show hand 
*** SUMMARY ***
Total pot $15 | Rake $0 
Seat 2: Flying Smile (big blind) folded before Flop
Seat 3: Y-Yx777 folded before Flop (didn't bet)
Seat 4: maloyd folded before Flop (didn't bet)
Seat 5: Sir_Fuj1 (button) collected ($15)
Seat 6: floriiiiider (small blind) folded before Flop


PokerStars Game #102615916886:  Hold'em No Limit ($3/$6 USD) - 2013/08/11 14:03:20 ET
Table 'Cydonia IX 40-100 bb' 6-max Seat #6 is the button
Seat 2: Flying Smile ($603 in chips) 
Seat 3: Y-Yx777 ($1273.95 in chips) 
Seat 4: maloyd ($735.20 in chips) 
Seat 5: Sir_Fuj1 ($256.93 in chips) 
Seat 6: floriiiiider ($1253.88 in chips) 
Flying Smile: posts small blind $3
Y-Yx777: posts big blind $6
*** HOLE CARDS ***
maloyd: folds 
Sir_Fuj1: folds 
floriiiiider: raises $6 to $12
Flying Smile: raises $33 to $45
Y-Yx777: folds 
floriiiiider: raises $48 to $93
Flying Smile: raises $510 to $603 and is all-in
floriiiiider: folds 
Uncalled bet ($510) returned to Flying Smile
Flying Smile collected $192 from pot
*** SUMMARY ***
Total pot $192 | Rake $0 
Seat 2: Flying Smile (small blind) collected ($192)
Seat 3: Y-Yx777 (big blind) folded before Flop
Seat 4: maloyd folded before Flop (didn't bet)
Seat 5: Sir_Fuj1 folded before Flop (didn't bet)
Seat 6: floriiiiider (button) folded before Flop


PokerStars Game #102615963314:  Hold'em No Limit ($3/$6 USD) - 2013/08/11 14:04:13 ET
Table 'Cydonia IX 40-100 bb' 6-max Seat #2 is the button
Seat 2: Flying Smile ($702 in chips) 
Seat 3: Y-Yx777 ($1267.95 in chips) 
Seat 4: maloyd ($735.20 in chips) 
Seat 5: Sir_Fuj1 ($256.93 in chips) 
Seat 6: floriiiiider ($1160.88 in chips) 
Y-Yx777: posts small blind $3
maloyd: posts big blind $6
*** HOLE CARDS ***
Sir_Fuj1: folds 
floriiiiider: folds 
Flying Smile: raises $6 to $12
Y-Yx777: calls $9
maloyd: calls $6
*** FLOP *** [8d Qd 5d]
Y-Yx777: checks 
maloyd: checks 
Flying Smile: checks 
*** TURN *** [8d Qd 5d] [7c]
Y-Yx777: checks 
maloyd: bets $24
Flying Smile: folds 
Y-Yx777: folds 
Uncalled bet ($24) returned to maloyd
maloyd collected $34.38 from pot
*** SUMMARY ***
Total pot $36 | Rake $1.62 
Board [8d Qd 5d 7c]
Seat 2: Flying Smile (button) folded on the Turn
Seat 3: Y-Yx777 (small blind) folded on the Turn
Seat 4: maloyd (big blind) collected ($34.38)
Seat 5: Sir_Fuj1 folded before Flop (didn't bet)
Seat 6: floriiiiider folded before Flop (didn't bet)


PokerStars Game #102615376944:  Hold'em No Limit ($3/$6 USD) - 2013/08/11 13:50:05 ET
Table 'Cydonia IX 40-100 bb' 6-max Seat #5 is the button
Seat 1: x_QUIXTAR_x ($2061.08 in chips) 
Seat 2: Flying Smile ($618 in chips) 
Seat 3: Y-Yx777 ($1074.59 in chips) 
Seat 4: maloyd ($600 in chips) 
Seat 5: Sir_Fuj1 ($349.93 in chips) 
Seat 6: floriiiiider ($1403.58 in chips) 
floriiiiider: posts small blind $3
x_QUIXTAR_x: posts big blind $6
*** HOLE CARDS ***
Flying Smile: folds 
Y-Yx777: raises $6 to $12
maloyd: folds 
Sir_Fuj1: folds 
floriiiiider: folds 
x_QUIXTAR_x: calls $6
*** FLOP *** [Jc 2d Jh]
x_QUIXTAR_x: checks 
Y-Yx777: bets $12
x_QUIXTAR_x: folds 
Uncalled bet ($12) returned to Y-Yx777
Y-Yx777 collected $25.78 from pot
*** SUMMARY ***
Total pot $27 | Rake $1.22 
Board [Jc 2d Jh]
Seat 1: x_QUIXTAR_x (big blind) folded on the Flop
Seat 2: Flying Smile folded before Flop (didn't bet)
Seat 3: Y-Yx777 collected ($25.78)
Seat 4: maloyd folded before Flop (didn't bet)
Seat 5: Sir_Fuj1 (button) folded before Flop (didn't bet)
Seat 6: floriiiiider (small blind) folded before Flop


PokerStars Game #102615402185:  Hold'em No Limit ($3/$6 USD) - 2013/08/11 13:50:36 ET
Table 'Cydonia IX 40-100 bb' 6-max Seat #6 is the button
Seat 1: x_QUIXTAR_x ($2049.08 in chips) 
Seat 2: Flying Smile ($618 in chips) 
Seat 3: Y-Yx777 ($1088.37 in chips) 
Seat 4: maloyd ($600 in chips) 
Seat 5: Sir_Fuj1 ($349.93 in chips) 
Seat 6: floriiiiider ($1400.58 in chips) 
x_QUIXTAR_x: posts small blind $3
Flying Smile: posts big blind $6
*** HOLE CARDS ***
Y-Yx777: raises $6 to $12
maloyd: folds 
Sir_Fuj1: folds 
floriiiiider: folds 
x_QUIXTAR_x: folds 
Flying Smile: calls $6
*** FLOP *** [7d 2h 9d]
Flying Smile: checks 
Y-Yx777: checks 
*** TURN *** [7d 2h 9d] [Td]
Flying Smile: bets $27
Y-Yx777: calls $27
*** RIVER *** [7d 2h 9d Td] [4c]
Flying Smile: bets $78
Y-Yx777: folds 
Uncalled bet ($78) returned to Flying Smile
Flying Smile collected $78.20 from pot
*** SUMMARY ***
Total pot $81 | Rake $2.80 
Board [7d 2h 9d Td 4c]
Seat 1: x_QUIXTAR_x (small blind) folded before Flop
Seat 2: Flying Smile (big blind) collected ($78.20)
Seat 3: Y-Yx777 folded on the River
Seat 4: maloyd folded before Flop (didn't bet)
Seat 5: Sir_Fuj1 folded before Flop (didn't bet)
Seat 6: floriiiiider (button) folded before Flop (didn't bet)


PokerStars Game #102615441071:  Hold'em No Limit ($3/$6 USD) - 2013/08/11 13:51:23 ET
Table 'Cydonia IX 40-100 bb' 6-max Seat #1 is the button
Seat 1: x_QUIXTAR_x ($2046.08 in chips) 
Seat 2: Flying Smile ($657.20 in chips) 
Seat 3: Y-Yx777 ($1049.37 in chips) 
Seat 4: maloyd ($600 in chips) 
Seat 5: Sir_Fuj1 ($349.93 in chips) 
Seat 6: floriiiiider ($1400.58 in chips) 
Flying Smile: posts small blind $3
Y-Yx777: posts big blind $6
*** HOLE CARDS ***
maloyd: folds 
Sir_Fuj1: folds 
floriiiiider: folds 
x_QUIXTAR_x: folds 
Flying Smile: folds 
Uncalled bet ($3) returned to Y-Yx777
Y-Yx777 collected $6 from pot
*** SUMMARY ***
Total pot $6 | Rake $0 
Seat 1: x_QUIXTAR_x (button) folded before Flop (didn't bet)
Seat 2: Flying Smile (small blind) folded before Flop
Seat 3: Y-Yx777 (big blind) collected ($6)
Seat 4: maloyd folded before Flop (didn't bet)
Seat 5: Sir_Fuj1 folded before Flop (didn't bet)
Seat 6: floriiiiider folded before Flop (didn't bet)


PokerStars Game #102615455532:  Hold'em No Limit ($3/$6 USD) - 2013/08/11 13:51:40 ET
Table 'Cydonia IX 40-100 bb' 6-max Seat #2 is the button
Seat 1: x_QUIXTAR_x ($2046.08 in chips) 
Seat 2: Flying Smile ($654.20 in chips) 
Seat 3: Y-Yx777 ($1052.37 in chips) 
Seat 4: maloyd ($600 in chips) 
Seat 5: Sir_Fuj1 ($349.93 in chips) 
Seat 6: floriiiiider ($1400.58 in chips) 
Y-Yx777: posts small blind $3
maloyd: posts big blind $6
*** HOLE CARDS ***
Sir_Fuj1: folds 
floriiiiider: raises $12 to $18
x_QUIXTAR_x: folds 
Flying Smile: calls $18
Y-Yx777: calls $15
maloyd: folds 
*** FLOP *** [Qh Ac 8c]
Y-Yx777: checks 
floriiiiider: bets $42
Flying Smile: folds 
Y-Yx777: folds 
Uncalled bet ($42) returned to floriiiiider
floriiiiider collected $57.30 from pot
floriiiiider: doesn't show hand 
*** SUMMARY ***
Total pot $60 | Rake $2.70 
Board [Qh Ac 8c]
Seat 1: x_QUIXTAR_x folded before Flop (didn't bet)
Seat 2: Flying Smile (button) folded on the Flop
Seat 3: Y-Yx777 (small blind) folded on the Flop
Seat 4: maloyd (big blind) folded before Flop
Seat 5: Sir_Fuj1 folded before Flop (didn't bet)
Seat 6: floriiiiider collected ($57.30)


PokerStars Game #102615493442:  Hold'em No Limit ($3/$6 USD) - 2013/08/11 13:52:27 ET
Table 'Cydonia IX 40-100 bb' 6-max Seat #3 is the button
Seat 1: x_QUIXTAR_x ($2046.08 in chips) 
Seat 2: Flying Smile ($636.20 in chips) 
Seat 3: Y-Yx777 ($1034.37 in chips) 
Seat 4: maloyd ($600 in chips) 
Seat 5: Sir_Fuj1 ($349.93 in chips) 
Seat 6: floriiiiider ($1439.88 in chips) 
maloyd: posts small blind $3
Sir_Fuj1: posts big blind $6
*** HOLE CARDS ***
floriiiiider: folds 
x_QUIXTAR_x: raises $7.50 to $13.50
Flying Smile: folds 
Y-Yx777: folds 
maloyd: folds 
Sir_Fuj1: folds 
Uncalled bet ($7.50) returned to x_QUIXTAR_x
x_QUIXTAR_x collected $15 from pot
x_QUIXTAR_x: doesn't show hand 
*** SUMMARY ***
Total pot $15 | Rake $0 
Seat 1: x_QUIXTAR_x collected ($15)
Seat 2: Flying Smile folded before Flop (didn't bet)
Seat 3: Y-Yx777 (button) folded before Flop (didn't bet)
Seat 4: maloyd (small blind) folded before Flop
Seat 5: Sir_Fuj1 (big blind) folded before Flop
Seat 6: floriiiiider folded before Flop (didn't bet)


PokerStars Game #102615512594:  Hold'em No Limit ($3/$6 USD) - 2013/08/11 13:52:50 ET
Table 'Cydonia IX 40-100 bb' 6-max Seat #4 is the button
Seat 1: x_QUIXTAR_x ($2055.08 in chips) 
Seat 2: Flying Smile ($636.20 in chips) 
Seat 3: Y-Yx777 ($1034.37 in chips) 
Seat 4: maloyd ($600 in chips) 
Seat 5: Sir_Fuj1 ($343.93 in chips) 
Seat 6: floriiiiider ($1439.88 in chips) 
Sir_Fuj1: posts small blind $3
floriiiiider: posts big blind $6
*** HOLE CARDS ***
x_QUIXTAR_x: folds 
Flying Smile: folds 
Y-Yx777: folds 
maloyd: folds 
Sir_Fuj1: raises $9 to $15
floriiiiider: folds 
Uncalled bet ($9) returned to Sir_Fuj1
Sir_Fuj1 collected $12 from pot
Sir_Fuj1: doesn't show hand 
*** SUMMARY ***
Total pot $12 | Rake $0 
Seat 1: x_QUIXTAR_x folded before Flop (didn't bet)
Seat 2: Flying Smile folded before Flop (didn't bet)
Seat 3: Y-Yx777 folded before Flop (didn't bet)
Seat 4: maloyd (button) folded before Flop (didn't bet)
Seat 5: Sir_Fuj1 (small blind) collected ($12)
Seat 6: floriiiiider (big blind) folded before Flop


PokerStars Game #102615525491:  Hold'em No Limit ($3/$6 USD) - 2013/08/11 13:53:07 ET
Table 'Cydonia IX 40-100 bb' 6-max Seat #5 is the button
Seat 1: x_QUIXTAR_x ($2055.08 in chips) 
Seat 2: Flying Smile ($636.20 in chips) 
Seat 3: Y-Yx777 ($1034.37 in chips) 
Seat 4: maloyd ($600 in chips) 
Seat 5: Sir_Fuj1 ($349.93 in chips) 
Seat 6: floriiiiider ($1433.88 in chips) 
floriiiiider: posts small blind $3
x_QUIXTAR_x: posts big blind $6
*** HOLE CARDS ***
Flying Smile: folds 
Y-Yx777: raises $6 to $12
maloyd: folds 
Sir_Fuj1: folds 
floriiiiider: folds 
x_QUIXTAR_x: calls $6
*** FLOP *** [As Qs 6d]
x_QUIXTAR_x: checks 
Y-Yx777: bets $18
x_QUIXTAR_x: calls $18
*** TURN *** [As Qs 6d] [Jc]
x_QUIXTAR_x: bets $12
Y-Yx777: raises $30 to $42
x_QUIXTAR_x: folds 
Uncalled bet ($30) returned to Y-Yx777
Y-Yx777 collected $84.20 from pot
*** SUMMARY ***
Total pot $87 | Rake $2.80 
Board [As Qs 6d Jc]
Seat 1: x_QUIXTAR_x (big blind) folded on the Turn
Seat 2: Flying Smile folded before Flop (didn't bet)
Seat 3: Y-Yx777 collected ($84.20)
Seat 4: maloyd folded before Flop (didn't bet)
Seat 5: Sir_Fuj1 (button) folded before Flop (didn't bet)
Seat 6: floriiiiider (small blind) folded before Flop


PokerStars Game #102615594789:  Hold'em No Limit ($3/$6 USD) - 2013/08/11 13:54:32 ET
Table 'Cydonia IX 40-100 bb' 6-max Seat #6 is the button
Seat 1: x_QUIXTAR_x ($2013.08 in chips) 
Seat 2: Flying Smile ($636.20 in chips) 
Seat 3: Y-Yx777 ($1076.57 in chips) 
Seat 4: maloyd ($600 in chips) 
Seat 5: Sir_Fuj1 ($349.93 in chips) 
Seat 6: floriiiiider ($1430.88 in chips) 
x_QUIXTAR_x: posts small blind $3
Flying Smile: posts big blind $6
*** HOLE CARDS ***
Y-Yx777: folds 
maloyd: raises $7.80 to $13.80
Sir_Fuj1: folds 
floriiiiider: folds 
x_QUIXTAR_x: folds 
Flying Smile: folds 
Uncalled bet ($7.80) returned to maloyd
maloyd collected $15 from pot
*** SUMMARY ***
Total pot $15 | Rake $0 
Seat 1: x_QUIXTAR_x (small blind) folded before Flop
Seat 2: Flying Smile (big blind) folded before Flop
Seat 3: Y-Yx777 folded before Flop (didn't bet)
Seat 4: maloyd collected ($15)
Seat 5: Sir_Fuj1 folded before Flop (didn't bet)
Seat 6: floriiiiider (button) folded before Flop (didn't bet)


PokerStars Game #102617090138:  Hold'em No Limit ($3/$6 USD) - 2013/08/11 14:25:59 ET
Table 'Cydonia IX 40-100 bb' 6-max Seat #2 is the button
Seat 1: TTSIP ($600 in chips) 
Seat 2: Flying Smile ($728.96 in chips) 
Seat 3: Y-Yx777 ($1163.50 in chips) 
Seat 5: checkitout12 ($240 in chips) 
Seat 6: floriiiiider ($1200.70 in chips) 
Y-Yx777: posts small blind $3
checkitout12: posts big blind $6
*** HOLE CARDS ***
floriiiiider: folds 
TTSIP: raises $9 to $15
Flying Smile: folds 
Y-Yx777: calls $12
checkitout12: folds 
*** FLOP *** [Kd 5d 4d]
Y-Yx777: checks 
TTSIP: bets $24
Y-Yx777: calls $24
*** TURN *** [Kd 5d 4d] [Jc]
Y-Yx777: checks 
TTSIP: bets $66
Y-Yx777: calls $66
*** RIVER *** [Kd 5d 4d Jc] [4s]
Y-Yx777: checks 
TTSIP: bets $72
Y-Yx777: calls $72
*** SHOW DOWN ***
TTSIP: shows [Ts Kh] (two pair, Kings and Fours)
Y-Yx777: shows [9c Ks] (two pair, Kings and Fours)
Y-Yx777 collected $178.60 from pot
TTSIP collected $178.60 from pot
*** SUMMARY ***
Total pot $360 | Rake $2.80 
Board [Kd 5d 4d Jc 4s]
Seat 1: TTSIP showed [Ts Kh] and won ($178.60) with two pair, Kings and Fours
Seat 2: Flying Smile (button) folded before Flop (didn't bet)
Seat 3: Y-Yx777 (small blind) showed [9c Ks] and won ($178.60) with two pair, Kings and Fours
Seat 5: checkitout12 (big blind) folded before Flop
Seat 6: floriiiiider folded before Flop (didn't bet)


PokerStars Game #102617174369:  Hold'em No Limit ($3/$6 USD) - 2013/08/11 14:27:38 ET
Table 'Cydonia IX 40-100 bb' 6-max Seat #3 is the button
Seat 1: TTSIP ($601.60 in chips) 
Seat 2: Flying Smile ($728.96 in chips) 
Seat 3: Y-Yx777 ($1165.10 in chips) 
Seat 5: checkitout12 ($240 in chips) 
Seat 6: floriiiiider ($1200.70 in chips) 
checkitout12: posts small blind $3
floriiiiider: posts big blind $6
*** HOLE CARDS ***
TTSIP: raises $12 to $18
Flying Smile: folds 
Y-Yx777: folds 
checkitout12: folds 
floriiiiider: folds 
Uncalled bet ($12) returned to TTSIP
TTSIP collected $15 from pot
*** SUMMARY ***
Total pot $15 | Rake $0 
Seat 1: TTSIP collected ($15)
Seat 2: Flying Smile folded before Flop (didn't bet)
Seat 3: Y-Yx777 (button) folded before Flop (didn't bet)
Seat 5: checkitout12 (small blind) folded before Flop
Seat 6: floriiiiider (big blind) folded before Flop


PokerStars Game #102617185435:  Hold'em No Limit ($3/$6 USD) - 2013/08/11 14:27:51 ET
Table 'Cydonia IX 40-100 bb' 6-max Seat #5 is the button
Seat 1: TTSIP ($610.60 in chips) 
Seat 2: Flying Smile ($728.96 in chips) 
Seat 3: Y-Yx777 ($1165.10 in chips) 
Seat 5: checkitout12 ($240 in chips) 
Seat 6: floriiiiider ($1194.70 in chips) 
floriiiiider: posts small blind $3
TTSIP: posts big blind $6
*** HOLE CARDS ***
Flying Smile: folds 
Y-Yx777: raises $6 to $12
checkitout12: folds 
floriiiiider: folds 
TTSIP: calls $6
*** FLOP *** [Kd 3s 9d]
TTSIP: checks 
Y-Yx777: checks 
*** TURN *** [Kd 3s 9d] [5d]
TTSIP: checks 
Y-Yx777: bets $12
TTSIP: calls $12
*** RIVER *** [Kd 3s 9d 5d] [3d]
TTSIP: checks 
Y-Yx777: bets $30
TTSIP: calls $30
*** SHOW DOWN ***
Y-Yx777: shows [Td Qc] (a flush, King high)
TTSIP: mucks hand 
Y-Yx777 collected $108.20 from pot
*** SUMMARY ***
Total pot $111 | Rake $2.80 
Board [Kd 3s 9d 5d 3d]
Seat 1: TTSIP (big blind) mucked
Seat 2: Flying Smile folded before Flop (didn't bet)
Seat 3: Y-Yx777 showed [Td Qc] and won ($108.20) with a flush, King high
Seat 5: checkitout12 (button) folded before Flop (didn't bet)
Seat 6: floriiiiider (small blind) folded before Flop


PokerStars Game #102617228112:  Hold'em No Limit ($3/$6 USD) - 2013/08/11 14:28:42 ET
Table 'Cydonia IX 40-100 bb' 6-max Seat #6 is the button
Seat 1: TTSIP ($600 in chips) 
Seat 2: Flying Smile ($728.96 in chips) 
Seat 3: Y-Yx777 ($1219.30 in chips) 
Seat 5: checkitout12 ($240 in chips) 
Seat 6: floriiiiider ($1191.70 in chips) 
TTSIP: posts small blind $3
Flying Smile: posts big blind $6
*** HOLE CARDS ***
Y-Yx777: raises $6 to $12
checkitout12: folds 
floriiiiider: folds 
TTSIP: folds 
Flying Smile: folds 
Uncalled bet ($6) returned to Y-Yx777
Y-Yx777 collected $15 from pot
*** SUMMARY ***
Total pot $15 | Rake $0 
Seat 1: TTSIP (small blind) folded before Flop
Seat 2: Flying Smile (big blind) folded before Flop
Seat 3: Y-Yx777 collected ($15)
Seat 5: checkitout12 folded before Flop (didn't bet)
Seat 6: floriiiiider (button) folded before Flop (didn't bet)


PokerStars Game #102617251215:  Hold'em No Limit ($3/$6 USD) - 2013/08/11 14:29:09 ET
Table 'Cydonia IX 40-100 bb' 6-max Seat #1 is the button
Seat 1: TTSIP ($600 in chips) 
Seat 2: Flying Smile ($722.96 in chips) 
Seat 3: Y-Yx777 ($1228.30 in chips) 
Seat 5: checkitout12 ($240 in chips) 
Seat 6: floriiiiider ($1191.70 in chips) 
Flying Smile: posts small blind $3
Y-Yx777: posts big blind $6
*** HOLE CARDS ***
checkitout12: folds 
floriiiiider: folds 
TTSIP: raises $6 to $12
Flying Smile: folds 
Y-Yx777: calls $6
*** FLOP *** [9d 6d Kc]
Y-Yx777: checks 
TTSIP: checks 
*** TURN *** [9d 6d Kc] [Jh]
Y-Yx777: bets $18
TTSIP: calls $18
*** RIVER *** [9d 6d Kc Jh] [2d]
Y-Yx777: bets $36
TTSIP: calls $36
*** SHOW DOWN ***
Y-Yx777: shows [Kh Jc] (two pair, Kings and Jacks)
TTSIP: mucks hand 
Y-Yx777 collected $132.20 from pot
*** SUMMARY ***
Total pot $135 | Rake $2.80 
Board [9d 6d Kc Jh 2d]
Seat 1: TTSIP (button) mucked
Seat 2: Flying Smile (small blind) folded before Flop
Seat 3: Y-Yx777 (big blind) showed [Kh Jc] and won ($132.20) with two pair, Kings and Jacks
Seat 5: checkitout12 folded before Flop (didn't bet)
Seat 6: floriiiiider folded before Flop (didn't bet)


PokerStars Game #102616796293:  Hold'em No Limit ($3/$6 USD) - 2013/08/11 14:20:18 ET
Table 'Cydonia IX 40-100 bb' 6-max Seat #4 is the button
Seat 1: TTSIP ($894.40 in chips) 
Seat 2: Flying Smile ($758.96 in chips) 
Seat 3: Y-Yx777 ($1160.35 in chips) 
Seat 4: maloyd ($1009.53 in chips) 
Seat 5: Sir_Fuj1 ($237.62 in chips) 
Seat 6: floriiiiider ($888.50 in chips) 
Sir_Fuj1: posts small blind $3
floriiiiider: posts big blind $6
*** HOLE CARDS ***
TTSIP: folds 
Flying Smile: folds 
Y-Yx777: folds 
maloyd: folds 
Sir_Fuj1: folds 
Uncalled bet ($3) returned to floriiiiider
floriiiiider collected $6 from pot
floriiiiider: doesn't show hand 
*** SUMMARY ***
Total pot $6 | Rake $0 
Seat 1: TTSIP folded before Flop (didn't bet)
Seat 2: Flying Smile folded before Flop (didn't bet)
Seat 3: Y-Yx777 folded before Flop (didn't bet)
Seat 4: maloyd (button) folded before Flop (didn't bet)
Seat 5: Sir_Fuj1 (small blind) folded before Flop
Seat 6: floriiiiider (big blind) collected ($6)


PokerStars Game #102616827194:  Hold'em No Limit ($3/$6 USD) - 2013/08/11 14:20:53 ET
Table 'Cydonia IX 40-100 bb' 6-max Seat #5 is the button
Seat 1: TTSIP ($894.40 in chips) 
Seat 2: Flying Smile ($758.96 in chips) 
Seat 3: Y-Yx777 ($1160.35 in chips) 
Seat 4: maloyd ($1009.53 in chips) 
Seat 5: Sir_Fuj1 ($234.62 in chips) 
Seat 6: floriiiiider ($891.50 in chips) 
floriiiiider: posts small blind $3
TTSIP: posts big blind $6
*** HOLE CARDS ***
Flying Smile: folds 
Y-Yx777: folds 
maloyd: folds 
Sir_Fuj1: raises $9 to $15
floriiiiider: calls $12
TTSIP: raises $45 to $60
Sir_Fuj1: folds 
floriiiiider: calls $45
*** FLOP *** [Tc 7s 7d]
floriiiiider: checks 
TTSIP: bets $78
floriiiiider: calls $78
*** TURN *** [Tc 7s 7d] [Jc]
floriiiiider: checks 
TTSIP: bets $168
floriiiiider: raises $585.50 to $753.50 and is all-in
TTSIP: folds 
Uncalled bet ($585.50) returned to floriiiiider
floriiiiider collected $624.20 from pot
floriiiiider: doesn't show hand 
*** SUMMARY ***
Total pot $627 | Rake $2.80 
Board [Tc 7s 7d Jc]
Seat 1: TTSIP (big blind) folded on the Turn
Seat 2: Flying Smile folded before Flop (didn't bet)
Seat 3: Y-Yx777 folded before Flop (didn't bet)
Seat 4: maloyd folded before Flop (didn't bet)
Seat 5: Sir_Fuj1 (button) folded before Flop
Seat 6: floriiiiider (small blind) collected ($624.20)


PokerStars Game #102616915349:  Hold'em No Limit ($3/$6 USD) - 2013/08/11 14:22:35 ET
Table 'Cydonia IX 40-100 bb' 6-max Seat #6 is the button
Seat 1: TTSIP ($600 in chips) 
Seat 2: Flying Smile ($758.96 in chips) 
Seat 3: Y-Yx777 ($1160.35 in chips) 
Seat 4: maloyd ($1009.53 in chips) 
Seat 5: Sir_Fuj1 ($219.62 in chips) 
Seat 6: floriiiiider ($1209.70 in chips) 
TTSIP: posts small blind $3
Flying Smile: posts big blind $6
*** HOLE CARDS ***
Y-Yx777: raises $6 to $12
maloyd: folds 
Sir_Fuj1: folds 
floriiiiider: folds 
TTSIP: folds 
Flying Smile: folds 
Uncalled bet ($6) returned to Y-Yx777
Y-Yx777 collected $15 from pot
*** SUMMARY ***
Total pot $15 | Rake $0 
Seat 1: TTSIP (small blind) folded before Flop
Seat 2: Flying Smile (big blind) folded before Flop
Seat 3: Y-Yx777 collected ($15)
Seat 4: maloyd folded before Flop (didn't bet)
Seat 5: Sir_Fuj1 folded before Flop (didn't bet)
Seat 6: floriiiiider (button) folded before Flop (didn't bet)


PokerStars Game #102616933150:  Hold'em No Limit ($3/$6 USD) - 2013/08/11 14:22:56 ET
Table 'Cydonia IX 40-100 bb' 6-max Seat #1 is the button
Seat 1: TTSIP ($600 in chips) 
Seat 2: Flying Smile ($752.96 in chips) 
Seat 3: Y-Yx777 ($1169.35 in chips) 
Seat 4: maloyd ($1009.53 in chips) 
Seat 5: Sir_Fuj1 ($219.62 in chips) 
Seat 6: floriiiiider ($1209.70 in chips) 
Flying Smile: posts small blind $3
Y-Yx777: posts big blind $6
*** HOLE CARDS ***
maloyd: folds 
Sir_Fuj1: raises $12 to $18
floriiiiider: folds 
TTSIP: folds 
Flying Smile: folds 
Y-Yx777: calls $12
*** FLOP *** [Tc Th 6h]
Y-Yx777: checks 
Sir_Fuj1: bets $18
Y-Yx777: calls $18
*** TURN *** [Tc Th 6h] [Qh]
Y-Yx777: checks 
Sir_Fuj1: checks 
*** RIVER *** [Tc Th 6h Qh] [Jd]
Y-Yx777: bets $42
Sir_Fuj1: calls $42
*** SHOW DOWN ***
Y-Yx777: shows [7d As] (a pair of Tens)
Sir_Fuj1: shows [Ad Qs] (two pair, Queens and Tens)
Sir_Fuj1 collected $156.20 from pot
*** SUMMARY ***
Total pot $159 | Rake $2.80 
Board [Tc Th 6h Qh Jd]
Seat 1: TTSIP (button) folded before Flop (didn't bet)
Seat 2: Flying Smile (small blind) folded before Flop
Seat 3: Y-Yx777 (big blind) showed [7d As] and lost with a pair of Tens
Seat 4: maloyd folded before Flop (didn't bet)
Seat 5: Sir_Fuj1 showed [Ad Qs] and won ($156.20) with two pair, Queens and Tens
Seat 6: floriiiiider folded before Flop (didn't bet)


PokerStars Game #102616964691:  Hold'em No Limit ($3/$6 USD) - 2013/08/11 14:23:33 ET
Table 'Cydonia IX 40-100 bb' 6-max Seat #2 is the button
Seat 1: TTSIP ($600 in chips) 
Seat 2: Flying Smile ($749.96 in chips) 
Seat 3: Y-Yx777 ($1091.35 in chips) 
Seat 6: floriiiiider ($1209.70 in chips) 
Y-Yx777: posts small blind $3
maloyd: is sitting out 
Sir_Fuj1: is sitting out 
floriiiiider: posts big blind $6
*** HOLE CARDS ***
TTSIP: folds 
Sir_Fuj1 leaves the table
Flying Smile: raises $6 to $12
Y-Yx777: calls $9
floriiiiider: folds 
*** FLOP *** [Ks Kh 8s]
Y-Yx777: bets $12
Flying Smile: folds 
Uncalled bet ($12) returned to Y-Yx777
Y-Yx777 collected $28.65 from pot
*** SUMMARY ***
Total pot $30 | Rake $1.35 
Board [Ks Kh 8s]
Seat 1: TTSIP folded before Flop (didn't bet)
Seat 2: Flying Smile (button) folded on the Flop
Seat 3: Y-Yx777 (small blind) collected ($28.65)
Seat 6: floriiiiider (big blind) folded before Flop


PokerStars Game #102616988780:  Hold'em No Limit ($3/$6 USD) - 2013/08/11 14:24:00 ET
Table 'Cydonia IX 40-100 bb' 6-max Seat #3 is the button
Seat 1: TTSIP ($600 in chips) 
Seat 2: Flying Smile ($737.96 in chips) 
Seat 3: Y-Yx777 ($1108 in chips) 
Seat 6: floriiiiider ($1203.70 in chips) 
floriiiiider: posts small blind $3
TTSIP: posts big blind $6
*** HOLE CARDS ***
Flying Smile: folds 
Y-Yx777: raises $6 to $12
checkitout12 joins the table at seat #5 
floriiiiider: folds 
TTSIP: folds 
Uncalled bet ($6) returned to Y-Yx777
Y-Yx777 collected $15 from pot
*** SUMMARY ***
Total pot $15 | Rake $0 
Seat 1: TTSIP (big blind) folded before Flop
Seat 2: Flying Smile folded before Flop (didn't bet)
Seat 3: Y-Yx777 (button) collected ($15)
Seat 6: floriiiiider (small blind) folded before Flop


PokerStars Game #102617003489:  Hold'em No Limit ($3/$6 USD) - 2013/08/11 14:24:18 ET
Table 'Cydonia IX 40-100 bb' 6-max Seat #6 is the button
Seat 1: TTSIP ($600 in chips) 
Seat 2: Flying Smile ($737.96 in chips) 
Seat 3: Y-Yx777 ($1117 in chips) 
Seat 6: floriiiiider ($1200.70 in chips) 
TTSIP: posts small blind $3
Flying Smile: posts big blind $6
checkitout12: sits out 
*** HOLE CARDS ***
Y-Yx777: raises $6 to $12
floriiiiider: folds 
TTSIP: folds 
Flying Smile: folds 
Uncalled bet ($6) returned to Y-Yx777
Y-Yx777 collected $15 from pot
*** SUMMARY ***
Total pot $15 | Rake $0 
Seat 1: TTSIP (small blind) folded before Flop
Seat 2: Flying Smile (big blind) folded before Flop
Seat 3: Y-Yx777 collected ($15)
Seat 6: floriiiiider (button) folded before Flop (didn't bet)


PokerStars Game #102617018768:  Hold'em No Limit ($3/$6 USD) - 2013/08/11 14:24:36 ET
Table 'Cydonia IX 40-100 bb' 6-max Seat #1 is the button
Seat 1: TTSIP ($600 in chips) 
Seat 2: Flying Smile ($731.96 in chips) 
Seat 3: Y-Yx777 ($1126 in chips) 
Seat 6: floriiiiider ($1200.70 in chips) 
Flying Smile: posts small blind $3
Y-Yx777: posts big blind $6
checkitout12: sits out 
*** HOLE CARDS ***
floriiiiider: folds 
TTSIP: raises $6 to $12
Flying Smile: folds 
Y-Yx777: raises $24 to $36
TTSIP: calls $24
*** FLOP *** [Qd Ah Tc]
Y-Yx777: checks 
TTSIP: checks 
*** TURN *** [Qd Ah Tc] [3s]
Y-Yx777: bets $42
TTSIP: folds 
Uncalled bet ($42) returned to Y-Yx777
Y-Yx777 collected $73.50 from pot
*** SUMMARY ***
Total pot $75 | Rake $1.50 
Board [Qd Ah Tc 3s]
Seat 1: TTSIP (button) folded on the Turn
Seat 2: Flying Smile (small blind) folded before Flop
Seat 3: Y-Yx777 (big blind) collected ($73.50)
Seat 6: floriiiiider folded before Flop (didn't bet)


PokerStars Game #102616534719:  Hold'em No Limit ($3/$6 USD) - 2013/08/11 14:15:16 ET
Table 'Cydonia IX 40-100 bb' 6-max Seat #4 is the button
Seat 1: TTSIP ($723.20 in chips) 
Seat 2: Flying Smile ($703.38 in chips) 
Seat 3: Y-Yx777 ($1196.35 in chips) 
Seat 4: maloyd ($624.27 in chips) 
Seat 5: Sir_Fuj1 ($397.06 in chips) 
Seat 6: floriiiiider ($1076.88 in chips) 
Sir_Fuj1: posts small blind $3
floriiiiider: posts big blind $6
*** HOLE CARDS ***
TTSIP: folds 
Flying Smile: folds 
Y-Yx777: folds 
maloyd: raises $6 to $12
Sir_Fuj1: raises $24 to $36
floriiiiider: folds 
maloyd: calls $24
*** FLOP *** [Ah 6s 3h]
Sir_Fuj1: bets $39
maloyd: calls $39
*** TURN *** [Ah 6s 3h] [Td]
Sir_Fuj1: bets $114
maloyd: calls $114
*** RIVER *** [Ah 6s 3h Td] [7h]
Sir_Fuj1: checks 
maloyd: bets $435.27 and is all-in
Sir_Fuj1: calls $208.06 and is all-in
Uncalled bet ($227.21) returned to maloyd
*** SHOW DOWN ***
maloyd: shows [Kh Jh] (a flush, Ace high)
Sir_Fuj1: shows [Jd Ac] (a pair of Aces)
maloyd collected $797.32 from pot
*** SUMMARY ***
Total pot $800.12 | Rake $2.80 
Board [Ah 6s 3h Td 7h]
Seat 1: TTSIP folded before Flop (didn't bet)
Seat 2: Flying Smile folded before Flop (didn't bet)
Seat 3: Y-Yx777 folded before Flop (didn't bet)
Seat 4: maloyd (button) showed [Kh Jh] and won ($797.32) with a flush, Ace high
Seat 5: Sir_Fuj1 (small blind) showed [Jd Ac] and lost with a pair of Aces
Seat 6: floriiiiider (big blind) folded before Flop


PokerStars Game #102616598047:  Hold'em No Limit ($3/$6 USD) - 2013/08/11 14:16:29 ET
Table 'Cydonia IX 40-100 bb' 6-max Seat #5 is the button
Seat 1: TTSIP ($723.20 in chips) 
Seat 2: Flying Smile ($703.38 in chips) 
Seat 3: Y-Yx777 ($1196.35 in chips) 
Seat 4: maloyd ($1024.53 in chips) 
Seat 5: Sir_Fuj1 ($240 in chips) 
Seat 6: floriiiiider ($1070.88 in chips) 
floriiiiider: posts small blind $3
TTSIP: posts big blind $6
*** HOLE CARDS ***
Flying Smile: folds 
Y-Yx777: folds 
maloyd: folds 
Sir_Fuj1: folds 
floriiiiider: folds 
Uncalled bet ($3) returned to TTSIP
TTSIP collected $6 from pot
*** SUMMARY ***
Total pot $6 | Rake $0 
Seat 1: TTSIP (big blind) collected ($6)
Seat 2: Flying Smile folded before Flop (didn't bet)
Seat 3: Y-Yx777 folded before Flop (didn't bet)
Seat 4: maloyd folded before Flop (didn't bet)
Seat 5: Sir_Fuj1 (button) folded before Flop (didn't bet)
Seat 6: floriiiiider (small blind) folded before Flop


PokerStars Game #102616608836:  Hold'em No Limit ($3/$6 USD) - 2013/08/11 14:16:41 ET
Table 'Cydonia IX 40-100 bb' 6-max Seat #6 is the button
Seat 1: TTSIP ($726.20 in chips) 
Seat 2: Flying Smile ($703.38 in chips) 
Seat 3: Y-Yx777 ($1196.35 in chips) 
Seat 4: maloyd ($1024.53 in chips) 
Seat 5: Sir_Fuj1 ($240 in chips) 
Seat 6: floriiiiider ($1067.88 in chips) 
TTSIP: posts small blind $3
Flying Smile: posts big blind $6
*** HOLE CARDS ***
Y-Yx777: folds 
maloyd: folds 
Sir_Fuj1: raises $9 to $15
floriiiiider: calls $15
TTSIP: folds 
Flying Smile: folds 
*** FLOP *** [Ts Qd 3c]
Sir_Fuj1: checks 
floriiiiider: checks 
*** TURN *** [Ts Qd 3c] [2h]
Sir_Fuj1: checks 
floriiiiider: checks 
*** RIVER *** [Ts Qd 3c 2h] [7d]
Sir_Fuj1: checks 
floriiiiider: checks 
*** SHOW DOWN ***
Sir_Fuj1: shows [9d 9c] (a pair of Nines)
floriiiiider: shows [9s 9h] (a pair of Nines)
Sir_Fuj1 collected $18.62 from pot
floriiiiider collected $18.62 from pot
*** SUMMARY ***
Total pot $39 | Rake $1.76 
Board [Ts Qd 3c 2h 7d]
Seat 1: TTSIP (small blind) folded before Flop
Seat 2: Flying Smile (big blind) folded before Flop
Seat 3: Y-Yx777 folded before Flop (didn't bet)
Seat 4: maloyd folded before Flop (didn't bet)
Seat 5: Sir_Fuj1 showed [9d 9c] and won ($18.62) with a pair of Nines
Seat 6: floriiiiider (button) showed [9s 9h] and won ($18.62) with a pair of Nines


PokerStars Game #102616658305:  Hold'em No Limit ($3/$6 USD) - 2013/08/11 14:17:38 ET
Table 'Cydonia IX 40-100 bb' 6-max Seat #1 is the button
Seat 1: TTSIP ($723.20 in chips) 
Seat 2: Flying Smile ($697.38 in chips) 
Seat 3: Y-Yx777 ($1196.35 in chips) 
Seat 4: maloyd ($1024.53 in chips) 
Seat 5: Sir_Fuj1 ($243.62 in chips) 
Seat 6: floriiiiider ($1071.50 in chips) 
Flying Smile: posts small blind $3
Y-Yx777: posts big blind $6
*** HOLE CARDS ***
maloyd: folds 
Sir_Fuj1: folds 
floriiiiider: raises $9 to $15
TTSIP: raises $30 to $45
Flying Smile: folds 
Y-Yx777: folds 
floriiiiider: raises $57 to $102
TTSIP: calls $57
*** FLOP *** [7h Ac Jh]
floriiiiider: bets $81
TTSIP: calls $81
*** TURN *** [7h Ac Jh] [3c]
floriiiiider: checks 
TTSIP: bets $156
floriiiiider: folds 
Uncalled bet ($156) returned to TTSIP
TTSIP collected $372.20 from pot
*** SUMMARY ***
Total pot $375 | Rake $2.80 
Board [7h Ac Jh 3c]
Seat 1: TTSIP (button) collected ($372.20)
Seat 2: Flying Smile (small blind) folded before Flop
Seat 3: Y-Yx777 (big blind) folded before Flop
Seat 4: maloyd folded before Flop (didn't bet)
Seat 5: Sir_Fuj1 folded before Flop (didn't bet)
Seat 6: floriiiiider folded on the Turn


PokerStars Game #102616718595:  Hold'em No Limit ($3/$6 USD) - 2013/08/11 14:18:48 ET
Table 'Cydonia IX 40-100 bb' 6-max Seat #2 is the button
Seat 1: TTSIP ($912.40 in chips) 
Seat 2: Flying Smile ($694.38 in chips) 
Seat 3: Y-Yx777 ($1190.35 in chips) 
Seat 4: maloyd ($1024.53 in chips) 
Seat 5: Sir_Fuj1 ($243.62 in chips) 
Seat 6: floriiiiider ($888.50 in chips) 
Y-Yx777: posts small blind $3
maloyd: posts big blind $6
*** HOLE CARDS ***
Sir_Fuj1: folds 
floriiiiider: folds 
TTSIP: folds 
Flying Smile: raises $6 to $12
Y-Yx777: calls $9
maloyd: calls $6
*** FLOP *** [Tc 6s 4d]
Y-Yx777: checks 
maloyd: checks 
Flying Smile: bets $24
Y-Yx777: folds 
maloyd: folds 
Uncalled bet ($24) returned to Flying Smile
Flying Smile collected $34.38 from pot
*** SUMMARY ***
Total pot $36 | Rake $1.62 
Board [Tc 6s 4d]
Seat 1: TTSIP folded before Flop (didn't bet)
Seat 2: Flying Smile (button) collected ($34.38)
Seat 3: Y-Yx777 (small blind) folded on the Flop
Seat 4: maloyd (big blind) folded on the Flop
Seat 5: Sir_Fuj1 folded before Flop (didn't bet)
Seat 6: floriiiiider folded before Flop (didn't bet)


PokerStars Game #102616751095:  Hold'em No Limit ($3/$6 USD) - 2013/08/11 14:19:26 ET
Table 'Cydonia IX 40-100 bb' 6-max Seat #3 is the button
Seat 1: TTSIP ($912.40 in chips) 
Seat 2: Flying Smile ($716.76 in chips) 
Seat 3: Y-Yx777 ($1178.35 in chips) 
Seat 4: maloyd ($1012.53 in chips) 
Seat 5: Sir_Fuj1 ($243.62 in chips) 
Seat 6: floriiiiider ($888.50 in chips) 
maloyd: posts small blind $3
Sir_Fuj1: posts big blind $6
*** HOLE CARDS ***
floriiiiider: folds 
TTSIP: raises $12 to $18
Flying Smile: calls $18
Y-Yx777: calls $18
maloyd: folds 
Sir_Fuj1: folds 
*** FLOP *** [As 6d 8c]
TTSIP: checks 
Flying Smile: bets $51
Y-Yx777: folds 
TTSIP: folds 
Uncalled bet ($51) returned to Flying Smile
Flying Smile collected $60.20 from pot
*** SUMMARY ***
Total pot $63 | Rake $2.80 
Board [As 6d 8c]
Seat 1: TTSIP folded on the Flop
Seat 2: Flying Smile collected ($60.20)
Seat 3: Y-Yx777 (button) folded on the Flop
Seat 4: maloyd (small blind) folded before Flop
Seat 5: Sir_Fuj1 (big blind) folded before Flop
Seat 6: floriiiiider folded before Flop (didn't bet)


PokerStars Game #102616284393:  Hold'em No Limit ($3/$6 USD) - 2013/08/11 14:10:25 ET
Table 'Cydonia IX 40-100 bb' 6-max Seat #3 is the button
Seat 1: TTSIP ($738.20 in chips) 
Seat 2: Flying Smile ($690 in chips) 
Seat 3: Y-Yx777 ($1114.95 in chips) 
Seat 4: maloyd ($606.27 in chips) 
Seat 5: Sir_Fuj1 ($496.06 in chips) 
Seat 6: floriiiiider ($1082.88 in chips) 
maloyd: posts small blind $3
Sir_Fuj1: posts big blind $6
*** HOLE CARDS ***
floriiiiider: raises $12 to $18
TTSIP: folds 
Flying Smile: folds 
Y-Yx777: folds 
maloyd: folds 
Sir_Fuj1: folds 
Uncalled bet ($12) returned to floriiiiider
floriiiiider collected $15 from pot
floriiiiider: doesn't show hand 
*** SUMMARY ***
Total pot $15 | Rake $0 
Seat 1: TTSIP folded before Flop (didn't bet)
Seat 2: Flying Smile folded before Flop (didn't bet)
Seat 3: Y-Yx777 (button) folded before Flop (didn't bet)
Seat 4: maloyd (small blind) folded before Flop
Seat 5: Sir_Fuj1 (big blind) folded before Flop
Seat 6: floriiiiider collected ($15)


PokerStars Game #102616298271:  Hold'em No Limit ($3/$6 USD) - 2013/08/11 14:10:41 ET
Table 'Cydonia IX 40-100 bb' 6-max Seat #4 is the button
Seat 1: TTSIP ($738.20 in chips) 
Seat 2: Flying Smile ($690 in chips) 
Seat 3: Y-Yx777 ($1114.95 in chips) 
Seat 4: maloyd ($603.27 in chips) 
Seat 5: Sir_Fuj1 ($490.06 in chips) 
Seat 6: floriiiiider ($1091.88 in chips) 
Sir_Fuj1: posts small blind $3
floriiiiider: posts big blind $6
*** HOLE CARDS ***
TTSIP: folds 
Flying Smile: folds 
Y-Yx777: folds 
maloyd: raises $6 to $12
Sir_Fuj1: folds 
floriiiiider: raises $33 to $45
maloyd: raises $54 to $99
floriiiiider: folds 
Uncalled bet ($54) returned to maloyd
maloyd collected $93 from pot
*** SUMMARY ***
Total pot $93 | Rake $0 
Seat 1: TTSIP folded before Flop (didn't bet)
Seat 2: Flying Smile folded before Flop (didn't bet)
Seat 3: Y-Yx777 folded before Flop (didn't bet)
Seat 4: maloyd (button) collected ($93)
Seat 5: Sir_Fuj1 (small blind) folded before Flop
Seat 6: floriiiiider (big blind) folded before Flop


PokerStars Game #102616322793:  Hold'em No Limit ($3/$6 USD) - 2013/08/11 14:11:09 ET
Table 'Cydonia IX 40-100 bb' 6-max Seat #5 is the button
Seat 1: TTSIP ($738.20 in chips) 
Seat 2: Flying Smile ($690 in chips) 
Seat 3: Y-Yx777 ($1114.95 in chips) 
Seat 4: maloyd ($651.27 in chips) 
Seat 5: Sir_Fuj1 ($487.06 in chips) 
Seat 6: floriiiiider ($1046.88 in chips) 
floriiiiider: posts small blind $3
TTSIP: posts big blind $6
*** HOLE CARDS ***
Flying Smile: folds 
Y-Yx777: raises $6 to $12
maloyd: calls $12
Sir_Fuj1: folds 
floriiiiider: raises $42 to $54
TTSIP: folds 
Y-Yx777: folds 
maloyd: folds 
Uncalled bet ($42) returned to floriiiiider
floriiiiider collected $42 from pot
floriiiiider: doesn't show hand 
*** SUMMARY ***
Total pot $42 | Rake $0 
Seat 1: TTSIP (big blind) folded before Flop
Seat 2: Flying Smile folded before Flop (didn't bet)
Seat 3: Y-Yx777 folded before Flop
Seat 4: maloyd folded before Flop
Seat 5: Sir_Fuj1 (button) folded before Flop (didn't bet)
Seat 6: floriiiiider (small blind) collected ($42)


PokerStars Game #102616347767:  Hold'em No Limit ($3/$6 USD) - 2013/08/11 14:11:38 ET
Table 'Cydonia IX 40-100 bb' 6-max Seat #6 is the button
Seat 1: TTSIP ($732.20 in chips) 
Seat 2: Flying Smile ($690 in chips) 
Seat 3: Y-Yx777 ($1102.95 in chips) 
Seat 4: maloyd ($639.27 in chips) 
Seat 5: Sir_Fuj1 ($487.06 in chips) 
Seat 6: floriiiiider ($1076.88 in chips) 
TTSIP: posts small blind $3
Flying Smile: posts big blind $6
*** HOLE CARDS ***
Y-Yx777: folds 
maloyd: folds 
Sir_Fuj1: raises $9 to $15
floriiiiider: folds 
TTSIP: raises $27 to $42
Flying Smile: folds 
Sir_Fuj1: folds 
Uncalled bet ($27) returned to TTSIP
TTSIP collected $36 from pot
*** SUMMARY ***
Total pot $36 | Rake $0 
Seat 1: TTSIP (small blind) collected ($36)
Seat 2: Flying Smile (big blind) folded before Flop
Seat 3: Y-Yx777 folded before Flop (didn't bet)
Seat 4: maloyd folded before Flop (didn't bet)
Seat 5: Sir_Fuj1 folded before Flop
Seat 6: floriiiiider (button) folded before Flop (didn't bet)


PokerStars Game #102616366925:  Hold'em No Limit ($3/$6 USD) - 2013/08/11 14:12:01 ET
Table 'Cydonia IX 40-100 bb' 6-max Seat #1 is the button
Seat 1: TTSIP ($753.20 in chips) 
Seat 2: Flying Smile ($684 in chips) 
Seat 3: Y-Yx777 ($1102.95 in chips) 
Seat 4: maloyd ($639.27 in chips) 
Seat 5: Sir_Fuj1 ($472.06 in chips) 
Seat 6: floriiiiider ($1076.88 in chips) 
Flying Smile: posts small blind $3
Y-Yx777: posts big blind $6
*** HOLE CARDS ***
maloyd: folds 
Sir_Fuj1: folds 
floriiiiider: folds 
TTSIP: raises $6 to $12
Flying Smile: folds 
Y-Yx777: calls $6
*** FLOP *** [2s 4d Jh]
Y-Yx777: checks 
TTSIP: bets $18
Y-Yx777: raises $24 to $42
TTSIP: folds 
Uncalled bet ($24) returned to Y-Yx777
Y-Yx777 collected $60.20 from pot
*** SUMMARY ***
Total pot $63 | Rake $2.80 
Board [2s 4d Jh]
Seat 1: TTSIP (button) folded on the Flop
Seat 2: Flying Smile (small blind) folded before Flop
Seat 3: Y-Yx777 (big blind) collected ($60.20)
Seat 4: maloyd folded before Flop (didn't bet)
Seat 5: Sir_Fuj1 folded before Flop (didn't bet)
Seat 6: floriiiiider folded before Flop (didn't bet)


PokerStars Game #102616422829:  Hold'em No Limit ($3/$6 USD) - 2013/08/11 14:13:06 ET
Table 'Cydonia IX 40-100 bb' 6-max Seat #2 is the button
Seat 1: TTSIP ($723.20 in chips) 
Seat 2: Flying Smile ($681 in chips) 
Seat 3: Y-Yx777 ($1133.15 in chips) 
Seat 4: maloyd ($639.27 in chips) 
Seat 5: Sir_Fuj1 ($472.06 in chips) 
Seat 6: floriiiiider ($1076.88 in chips) 
Y-Yx777: posts small blind $3
maloyd: posts big blind $6
*** HOLE CARDS ***
Sir_Fuj1: folds 
floriiiiider: folds 
TTSIP: folds 
Flying Smile: raises $6 to $12
Y-Yx777: calls $9
maloyd: calls $6
*** FLOP *** [Ts 9d Jh]
Y-Yx777: checks 
maloyd: checks 
Flying Smile: bets $18
Y-Yx777: folds 
maloyd: folds 
Uncalled bet ($18) returned to Flying Smile
Flying Smile collected $34.38 from pot
*** SUMMARY ***
Total pot $36 | Rake $1.62 
Board [Ts 9d Jh]
Seat 1: TTSIP folded before Flop (didn't bet)
Seat 2: Flying Smile (button) collected ($34.38)
Seat 3: Y-Yx777 (small blind) folded on the Flop
Seat 4: maloyd (big blind) folded on the Flop
Seat 5: Sir_Fuj1 folded before Flop (didn't bet)
Seat 6: floriiiiider folded before Flop (didn't bet)


PokerStars Game #102616489969:  Hold'em No Limit ($3/$6 USD) - 2013/08/11 14:14:25 ET
Table 'Cydonia IX 40-100 bb' 6-max Seat #3 is the button
Seat 1: TTSIP ($723.20 in chips) 
Seat 2: Flying Smile ($703.38 in chips) 
Seat 3: Y-Yx777 ($1121.15 in chips) 
Seat 4: maloyd ($627.27 in chips) 
Seat 5: Sir_Fuj1 ($472.06 in chips) 
Seat 6: floriiiiider ($1076.88 in chips) 
maloyd: posts small blind $3
Sir_Fuj1: posts big blind $6
*** HOLE CARDS ***
floriiiiider: folds 
TTSIP: folds 
Flying Smile: folds 
Y-Yx777: raises $6 to $12
maloyd: folds 
Sir_Fuj1: calls $6
*** FLOP *** [Kh Ah Js]
Sir_Fuj1: checks 
Y-Yx777: checks 
*** TURN *** [Kh Ah Js] [8s]
Sir_Fuj1: bets $18
Y-Yx777: calls $18
*** RIVER *** [Kh Ah Js 8s] [5s]
Sir_Fuj1: bets $45
Y-Yx777: calls $45
*** SHOW DOWN ***
Sir_Fuj1: shows [Ac 8h] (two pair, Aces and Eights)
Y-Yx777: shows [7s 9s] (a flush, Jack high)
Y-Yx777 collected $150.20 from pot
*** SUMMARY ***
Total pot $153 | Rake $2.80 
Board [Kh Ah Js 8s 5s]
Seat 1: TTSIP folded before Flop (didn't bet)
Seat 2: Flying Smile folded before Flop (didn't bet)
Seat 3: Y-Yx777 (button) showed [7s 9s] and won ($150.20) with a flush, Jack high
Seat 4: maloyd (small blind) folded before Flop
Seat 5: Sir_Fuj1 (big blind) showed [Ac 8h] and lost with two pair, Aces and Eights
Seat 6: floriiiiider folded before Flop (didn't bet)


PokerStars Game #102617574351:  Hold'em No Limit ($3/$6 USD) - 2013/08/11 14:35:08 ET
Table 'Cydonia IX 40-100 bb' 6-max Seat #3 is the button
Seat 1: TTSIP ($600 in chips) 
Seat 2: Flying Smile ($729.66 in chips) 
Seat 3: Y-Yx777 ($1326.92 in chips) 
Seat 4: maloyd ($1003.53 in chips) 
Seat 5: checkitout12 ($720.20 in chips) 
Seat 6: floriiiiider ($1516.78 in chips) 
maloyd: posts small blind $3
checkitout12: posts big blind $6
*** HOLE CARDS ***
floriiiiider: folds 
TTSIP: folds 
Flying Smile: folds 
Y-Yx777: raises $6 to $12
maloyd: folds 
checkitout12: folds 
Uncalled bet ($6) returned to Y-Yx777
Y-Yx777 collected $15 from pot
*** SUMMARY ***
Total pot $15 | Rake $0 
Seat 1: TTSIP folded before Flop (didn't bet)
Seat 2: Flying Smile folded before Flop (didn't bet)
Seat 3: Y-Yx777 (button) collected ($15)
Seat 4: maloyd (small blind) folded before Flop
Seat 5: checkitout12 (big blind) folded before Flop
Seat 6: floriiiiider folded before Flop (didn't bet)


PokerStars Game #102617607530:  Hold'em No Limit ($3/$6 USD) - 2013/08/11 14:35:45 ET
Table 'Cydonia IX 40-100 bb' 6-max Seat #4 is the button
Seat 1: TTSIP ($600 in chips) 
Seat 2: Flying Smile ($729.66 in chips) 
Seat 3: Y-Yx777 ($1335.92 in chips) 
Seat 4: maloyd ($1000.53 in chips) 
Seat 5: checkitout12 ($714.20 in chips) 
Seat 6: floriiiiider ($1516.78 in chips) 
checkitout12: posts small blind $3
floriiiiider: posts big blind $6
*** HOLE CARDS ***
TTSIP: folds 
Flying Smile: folds 
Y-Yx777: folds 
maloyd: raises $6 to $12
checkitout12: folds 
floriiiiider: raises $33 to $45
maloyd: folds 
Uncalled bet ($33) returned to floriiiiider
floriiiiider collected $27 from pot
floriiiiider: doesn't show hand 
*** SUMMARY ***
Total pot $27 | Rake $0 
Seat 1: TTSIP folded before Flop (didn't bet)
Seat 2: Flying Smile folded before Flop (didn't bet)
Seat 3: Y-Yx777 folded before Flop (didn't bet)
Seat 4: maloyd (button) folded before Flop
Seat 5: checkitout12 (small blind) folded before Flop
Seat 6: floriiiiider (big blind) collected ($27)


PokerStars Game #102617634398:  Hold'em No Limit ($3/$6 USD) - 2013/08/11 14:36:15 ET
Table 'Cydonia IX 40-100 bb' 6-max Seat #5 is the button
Seat 1: TTSIP ($600 in chips) 
Seat 2: Flying Smile ($729.66 in chips) 
Seat 3: Y-Yx777 ($1335.92 in chips) 
Seat 4: maloyd ($988.53 in chips) 
Seat 5: checkitout12 ($711.20 in chips) 
Seat 6: floriiiiider ($1531.78 in chips) 
floriiiiider: posts small blind $3
TTSIP: posts big blind $6
*** HOLE CARDS ***
Flying Smile: folds 
Y-Yx777: folds 
maloyd: folds 
checkitout12: raises $6.18 to $12.18
Y-Yx777 leaves the table
floriiiiider: folds 
TTSIP: folds 
Uncalled bet ($6.18) returned to checkitout12
Hristo008 joins the table at seat #3 
checkitout12 collected $15 from pot
checkitout12: doesn't show hand 
*** SUMMARY ***
Total pot $15 | Rake $0 
Seat 1: TTSIP (big blind) folded before Flop
Seat 2: Flying Smile folded before Flop (didn't bet)
Seat 3: Y-Yx777 folded before Flop (didn't bet)
Seat 4: maloyd folded before Flop (didn't bet)
Seat 5: checkitout12 (button) collected ($15)
Seat 6: floriiiiider (small blind) folded before Flop


PokerStars Game #102617644944:  Hold'em No Limit ($3/$6 USD) - 2013/08/11 14:36:26 ET
Table 'Cydonia IX 40-100 bb' 6-max Seat #6 is the button
Seat 1: TTSIP ($600 in chips) 
Seat 2: Flying Smile ($729.66 in chips) 
Seat 4: maloyd ($988.53 in chips) 
Seat 5: checkitout12 ($720.20 in chips) 
Seat 6: floriiiiider ($1528.78 in chips) 
TTSIP: posts small blind $3
Flying Smile: posts big blind $6
Hristo008: sits out 
*** HOLE CARDS ***
maloyd: folds 
checkitout12: folds 
Hristo008 leaves the table
floriiiiider: folds 
TTSIP: raises $12 to $18
Flying Smile: raises $36 to $54
TTSIP: folds 
Uncalled bet ($36) returned to Flying Smile
Flying Smile collected $36 from pot
*** SUMMARY ***
Total pot $36 | Rake $0 
Seat 1: TTSIP (small blind) folded before Flop
Seat 2: Flying Smile (big blind) collected ($36)
Seat 4: maloyd folded before Flop (didn't bet)
Seat 5: checkitout12 folded before Flop (didn't bet)
Seat 6: floriiiiider (button) folded before Flop (didn't bet)


PokerStars Game #102617666230:  Hold'em No Limit ($3/$6 USD) - 2013/08/11 14:36:50 ET
Table 'Cydonia IX 40-100 bb' 6-max Seat #1 is the button
Seat 1: TTSIP ($600 in chips) 
Seat 2: Flying Smile ($747.66 in chips) 
Seat 4: maloyd ($988.53 in chips) 
Seat 5: checkitout12 ($720.20 in chips) 
Seat 6: floriiiiider ($1528.78 in chips) 
Flying Smile: posts small blind $3
maloyd: posts big blind $6
*** HOLE CARDS ***
checkitout12: folds 
floriiiiider: raises $9 to $15
TTSIP: folds 
Flying Smile: folds 
BKA12 joins the table at seat #3 
BKA12 leaves the table
maloyd: folds 
Uncalled bet ($9) returned to floriiiiider
floriiiiider collected $15 from pot
floriiiiider: doesn't show hand 
*** SUMMARY ***
Total pot $15 | Rake $0 
Seat 1: TTSIP (button) folded before Flop (didn't bet)
Seat 2: Flying Smile (small blind) folded before Flop
Seat 4: maloyd (big blind) folded before Flop
Seat 5: checkitout12 folded before Flop (didn't bet)
Seat 6: floriiiiider collected ($15)


PokerStars Game #102617690093:  Hold'em No Limit ($3/$6 USD) - 2013/08/11 14:37:16 ET
Table 'Cydonia IX 40-100 bb' 6-max Seat #2 is the button
Seat 1: TTSIP ($600 in chips) 
Seat 2: Flying Smile ($744.66 in chips) 
Seat 4: maloyd ($982.53 in chips) 
Seat 5: checkitout12 ($720.20 in chips) 
Seat 6: floriiiiider ($1537.78 in chips) 
maloyd: posts small blind $3
checkitout12: posts big blind $6
*** HOLE CARDS ***
floriiiiider: folds 
TTSIP: raises $9 to $15
Flying Smile: folds 
maloyd: folds 
checkitout12: calls $9
*** FLOP *** [3c 8s 8d]
checkitout12: checks 
TTSIP: checks 
*** TURN *** [3c 8s 8d] [7d]
checkitout12: checks 
TTSIP: checks 
*** RIVER *** [3c 8s 8d 7d] [2h]
checkitout12: checks 
TTSIP: checks 
*** SHOW DOWN ***
checkitout12: shows [9h Kh] (a pair of Eights)
TTSIP: shows [Qd Ah] (a pair of Eights - Ace kicker)
TTSIP collected $31.52 from pot
*** SUMMARY ***
Total pot $33 | Rake $1.48 
Board [3c 8s 8d 7d 2h]
Seat 1: TTSIP showed [Qd Ah] and won ($31.52) with a pair of Eights
Seat 2: Flying Smile (button) folded before Flop (didn't bet)
Seat 4: maloyd (small blind) folded before Flop
Seat 5: checkitout12 (big blind) showed [9h Kh] and lost with a pair of Eights
Seat 6: floriiiiider folded before Flop (didn't bet)


PokerStars Game #102617770797:  Hold'em No Limit ($3/$6 USD) - 2013/08/11 14:38:46 ET
Table 'Cydonia IX 40-100 bb' 6-max Seat #5 is the button
Seat 4: maloyd ($979.53 in chips) 
Seat 5: checkitout12 ($705.20 in chips) 
checkitout12: posts small blind $3
floriiiiider: is sitting out 
TTSIP: is sitting out 
TTSIP leaves the table
Flying Smile: is sitting out 
maloyd: posts big blind $6
*** HOLE CARDS ***
dRobespierre joins the table at seat #1 
floriiiiider leaves the table
dRobespierre leaves the table
checkitout12: raises $6.18 to $12.18
Flying Smile leaves the table
maloyd: calls $6.18
*** FLOP *** [Ts As 5s]
maloyd: checks 
Naebushkin joins the table at seat #6 
checkitout12: checks 
*** TURN *** [Ts As 5s] [Ac]
Naebushkin leaves the table
maloyd: checks 
checkitout12: bets $16.70
maloyd: folds 
Uncalled bet ($16.70) returned to checkitout12
checkitout12 collected $23.86 from pot
checkitout12: doesn't show hand 
*** SUMMARY ***
Total pot $24.36 | Rake $0.50 
Board [Ts As 5s Ac]
Seat 4: maloyd (big blind) folded on the Turn
Seat 5: checkitout12 (button) (small blind) collected ($23.86)


PokerStars Game #102617817667:  Hold'em No Limit ($3/$6 USD) - 2013/08/11 14:39:38 ET
Table 'Cydonia IX 40-100 bb' 6-max Seat #4 is the button
Seat 4: maloyd ($967.35 in chips) 
Seat 5: checkitout12 ($716.88 in chips) 
maloyd: posts small blind $3
checkitout12: posts big blind $6
*** HOLE CARDS ***
maloyd: raises $6 to $12
checkitout12: calls $6
*** FLOP *** [3s Js 5s]
checkitout12: checks 
maloyd: bets $18
checkitout12: folds 
Uncalled bet ($18) returned to maloyd
WhatA298 joins the table at seat #2 
maloyd collected $23.50 from pot
*** SUMMARY ***
Total pot $24 | Rake $0.50 
Board [3s Js 5s]
Seat 4: maloyd (button) (small blind) collected ($23.50)
Seat 5: checkitout12 (big blind) folded on the Flop


PokerStars Game #102617299546:  Hold'em No Limit ($3/$6 USD) - 2013/08/11 14:30:05 ET
Table 'Cydonia IX 40-100 bb' 6-max Seat #2 is the button
Seat 1: TTSIP ($600 in chips) 
Seat 2: Flying Smile ($719.96 in chips) 
Seat 3: Y-Yx777 ($1294.50 in chips) 
Seat 5: checkitout12 ($240 in chips) 
Seat 6: floriiiiider ($1191.70 in chips) 
Y-Yx777: posts small blind $3
checkitout12: posts big blind $6
*** HOLE CARDS ***
floriiiiider: raises $12 to $18
TTSIP: folds 
Flying Smile: folds 
Y-Yx777: calls $15
checkitout12: raises $30.64 to $48.64
floriiiiider: calls $30.64
Y-Yx777: calls $30.64
*** FLOP *** [9d 2h 4d]
Y-Yx777: checks 
checkitout12: bets $57.24
floriiiiider: calls $57.24
Y-Yx777: calls $57.24
*** TURN *** [9d 2h 4d] [Td]
Y-Yx777: checks 
checkitout12: bets $134.12 and is all-in
floriiiiider: calls $134.12
Y-Yx777: folds 
*** RIVER *** [9d 2h 4d Td] [Qh]
*** SHOW DOWN ***
checkitout12: shows [9c 8c] (a pair of Nines)
floriiiiider: shows [7d 6d] (a flush, Ten high)
floriiiiider collected $583.08 from pot
*** SUMMARY ***
Total pot $585.88 | Rake $2.80 
Board [9d 2h 4d Td Qh]
Seat 1: TTSIP folded before Flop (didn't bet)
Seat 2: Flying Smile (button) folded before Flop (didn't bet)
Seat 3: Y-Yx777 (small blind) folded on the Turn
Seat 5: checkitout12 (big blind) showed [9c 8c] and lost with a pair of Nines
Seat 6: floriiiiider showed [7d 6d] and won ($583.08) with a flush, Ten high


PokerStars Game #102617365287:  Hold'em No Limit ($3/$6 USD) - 2013/08/11 14:31:19 ET
Table 'Cydonia IX 40-100 bb' 6-max Seat #3 is the button
Seat 1: TTSIP ($600 in chips) 
Seat 2: Flying Smile ($719.96 in chips) 
Seat 3: Y-Yx777 ($1188.62 in chips) 
Seat 5: checkitout12 ($240 in chips) 
Seat 6: floriiiiider ($1534.78 in chips) 
checkitout12: posts small blind $3
floriiiiider: posts big blind $6
*** HOLE CARDS ***
TTSIP: folds 
Flying Smile: folds 
Y-Yx777: raises $6 to $12
checkitout12: folds 
floriiiiider: folds 
Uncalled bet ($6) returned to Y-Yx777
Y-Yx777 collected $15 from pot
*** SUMMARY ***
Total pot $15 | Rake $0 
Seat 1: TTSIP folded before Flop (didn't bet)
Seat 2: Flying Smile folded before Flop (didn't bet)
Seat 3: Y-Yx777 (button) collected ($15)
Seat 5: checkitout12 (small blind) folded before Flop
Seat 6: floriiiiider (big blind) folded before Flop


PokerStars Game #102617376252:  Hold'em No Limit ($3/$6 USD) - 2013/08/11 14:31:31 ET
Table 'Cydonia IX 40-100 bb' 6-max Seat #5 is the button
Seat 1: TTSIP ($600 in chips) 
Seat 2: Flying Smile ($719.96 in chips) 
Seat 3: Y-Yx777 ($1197.62 in chips) 
Seat 5: checkitout12 ($240 in chips) 
Seat 6: floriiiiider ($1528.78 in chips) 
floriiiiider: posts small blind $3
TTSIP: posts big blind $6
*** HOLE CARDS ***
Flying Smile: folds 
Y-Yx777: raises $6 to $12
checkitout12: folds 
floriiiiider: calls $9
TTSIP: folds 
*** FLOP *** [Ks 9c Th]
floriiiiider: checks 
Y-Yx777: bets $12
floriiiiider: folds 
Uncalled bet ($12) returned to Y-Yx777
Y-Yx777 collected $28.65 from pot
*** SUMMARY ***
Total pot $30 | Rake $1.35 
Board [Ks 9c Th]
Seat 1: TTSIP (big blind) folded before Flop
Seat 2: Flying Smile folded before Flop (didn't bet)
Seat 3: Y-Yx777 collected ($28.65)
Seat 5: checkitout12 (button) folded before Flop (didn't bet)
Seat 6: floriiiiider (small blind) folded on the Flop


PokerStars Game #102617403482:  Hold'em No Limit ($3/$6 USD) - 2013/08/11 14:32:01 ET
Table 'Cydonia IX 40-100 bb' 6-max Seat #6 is the button
Seat 1: TTSIP ($600 in chips) 
Seat 2: Flying Smile ($719.96 in chips) 
Seat 3: Y-Yx777 ($1214.27 in chips) 
Seat 5: checkitout12 ($240 in chips) 
Seat 6: floriiiiider ($1516.78 in chips) 
TTSIP: posts small blind $3
Flying Smile: posts big blind $6
*** HOLE CARDS ***
Y-Yx777: raises $6 to $12
checkitout12: folds 
floriiiiider: folds 
TTSIP: folds 
Flying Smile: calls $6
*** FLOP *** [5s Jh Jd]
Flying Smile: checks 
Y-Yx777: bets $12
Flying Smile: calls $12
*** TURN *** [5s Jh Jd] [7h]
Flying Smile: checks 
Y-Yx777: checks 
*** RIVER *** [5s Jh Jd 7h] [5c]
Flying Smile: bets $39
Y-Yx777: folds 
Uncalled bet ($39) returned to Flying Smile
Flying Smile collected $48.70 from pot
*** SUMMARY ***
Total pot $51 | Rake $2.30 
Board [5s Jh Jd 7h 5c]
Seat 1: TTSIP (small blind) folded before Flop
Seat 2: Flying Smile (big blind) collected ($48.70)
Seat 3: Y-Yx777 folded on the River
Seat 5: checkitout12 folded before Flop (didn't bet)
Seat 6: floriiiiider (button) folded before Flop (didn't bet)


PokerStars Game #102617459887:  Hold'em No Limit ($3/$6 USD) - 2013/08/11 14:33:03 ET
Table 'Cydonia IX 40-100 bb' 6-max Seat #1 is the button
Seat 1: TTSIP ($600 in chips) 
Seat 2: Flying Smile ($744.66 in chips) 
Seat 3: Y-Yx777 ($1190.27 in chips) 
Seat 5: checkitout12 ($240 in chips) 
Seat 6: floriiiiider ($1516.78 in chips) 
Flying Smile: posts small blind $3
Y-Yx777: posts big blind $6
*** HOLE CARDS ***
checkitout12: raises $6.18 to $12.18
floriiiiider: folds 
TTSIP: raises $17.82 to $30
Flying Smile: folds 
Y-Yx777: calls $24
checkitout12: calls $17.82
*** FLOP *** [9c 3d 4c]
Y-Yx777: checks 
checkitout12: checks 
TTSIP: bets $60
Y-Yx777: calls $60
checkitout12: raises $150 to $210 and is all-in
TTSIP: calls $150
Y-Yx777: calls $150
*** TURN *** [9c 3d 4c] [Th]
Y-Yx777: checks 
TTSIP: bets $360 and is all-in
Y-Yx777: calls $360
*** RIVER *** [9c 3d 4c Th] [Ac]
*** SHOW DOWN ***
Y-Yx777: shows [4h 4s] (three of a kind, Fours)
TTSIP: mucks hand 
Y-Yx777 collected $720 from side pot
checkitout12: shows [Jc Tc] (a flush, Ace high)
checkitout12 collected $720.20 from main pot
*** SUMMARY ***
Total pot $1443 Main pot $720.20. Side pot $720. | Rake $2.80 
Board [9c 3d 4c Th Ac]
Seat 1: TTSIP (button) mucked
Seat 2: Flying Smile (small blind) folded before Flop
Seat 3: Y-Yx777 (big blind) showed [4h 4s] and won ($720) with three of a kind, Fours
Seat 5: checkitout12 showed [Jc Tc] and won ($720.20) with a flush, Ace high
Seat 6: floriiiiider folded before Flop (didn't bet)


PokerStars Game #102617543567:  Hold'em No Limit ($3/$6 USD) - 2013/08/11 14:34:35 ET
Table 'Cydonia IX 40-100 bb' 6-max Seat #2 is the button
Seat 1: TTSIP ($600 in chips) 
Seat 2: Flying Smile ($741.66 in chips) 
Seat 3: Y-Yx777 ($1310.27 in chips) 
Seat 4: maloyd ($1009.53 in chips) 
Seat 5: checkitout12 ($720.20 in chips) 
Seat 6: floriiiiider ($1516.78 in chips) 
Y-Yx777: posts small blind $3
maloyd: posts big blind $6
*** HOLE CARDS ***
checkitout12: folds 
floriiiiider: folds 
TTSIP: folds 
Flying Smile: raises $6 to $12
Y-Yx777: calls $9
maloyd: folds 
*** FLOP *** [Qs Jc Kd]
Y-Yx777: checks 
Flying Smile: checks 
*** TURN *** [Qs Jc Kd] [5s]
Y-Yx777: bets $12
Flying Smile: folds 
Uncalled bet ($12) returned to Y-Yx777
Y-Yx777 collected $28.65 from pot
*** SUMMARY ***
Total pot $30 | Rake $1.35 
Board [Qs Jc Kd 5s]
Seat 1: TTSIP folded before Flop (didn't bet)
Seat 2: Flying Smile (button) folded on the Turn
Seat 3: Y-Yx777 (small blind) collected ($28.65)
Seat 4: maloyd (big blind) folded before Flop
Seat 5: checkitout12 folded before Flop (didn't bet)
Seat 6: floriiiiider folded before Flop (didn't bet)
