

PokerStars Game #102615166181:  Hold'em No Limit ($3/$6 USD) - 2013/08/11 13:45:51 ET
Table 'Tanete V 40-100 bb' 6-max Seat #1 is the button
Seat 1: JMBigJoe ($651.20 in chips) 
Seat 3: Chappolini ($615 in chips) 
Seat 4: ilir3 ($900.82 in chips) 
Seat 5: jp0319 ($600 in chips) 
Seat 6: borntotilt ($618 in chips) 
floriiiiider will be allowed to play after the button
Chappolini: posts small blind $3
ilir3: posts big blind $6
*** HOLE CARDS ***
jp0319: folds 
borntotilt has timed out
borntotilt: folds 
JMBigJoe: raises $6 to $12
Chappolini: folds 
ilir3: folds 
Uncalled bet ($6) returned to JMBigJoe
JMBigJoe collected $15 from pot
*** SUMMARY ***
Total pot $15 | Rake $0 
Seat 1: JMBigJoe (button) collected ($15)
Seat 3: Chappolini (small blind) folded before Flop
Seat 4: ilir3 (big blind) folded before Flop
Seat 5: jp0319 folded before Flop (didn't bet)
Seat 6: borntotilt folded before Flop (didn't bet)


PokerStars Game #102615216238:  Hold'em No Limit ($3/$6 USD) - 2013/08/11 13:46:51 ET
Table 'Tanete V 40-100 bb' 6-max Seat #3 is the button
Seat 1: JMBigJoe ($660.20 in chips) 
Seat 3: Chappolini ($612 in chips) 
Seat 4: ilir3 ($894.82 in chips) 
Seat 5: jp0319 ($600 in chips) 
ilir3: posts small blind $3
jp0319: posts big blind $6
floriiiiider: sits out 
*** HOLE CARDS ***
JMBigJoe: raises $12 to $18
Chappolini: folds 
ilir3: folds 
jp0319: folds 
Uncalled bet ($12) returned to JMBigJoe
JMBigJoe collected $15 from pot
*** SUMMARY ***
Total pot $15 | Rake $0 
Seat 1: JMBigJoe collected ($15)
Seat 3: Chappolini (button) folded before Flop (didn't bet)
Seat 4: ilir3 (small blind) folded before Flop
Seat 5: jp0319 (big blind) folded before Flop


PokerStars Game #102615227897:  Hold'em No Limit ($3/$6 USD) - 2013/08/11 13:47:05 ET
Table 'Tanete V 40-100 bb' 6-max Seat #4 is the button
Seat 1: JMBigJoe ($669.20 in chips) 
Seat 3: Chappolini ($612 in chips) 
Seat 4: ilir3 ($891.82 in chips) 
Seat 5: jp0319 ($600 in chips) 
Seat 6: borntotilt ($618 in chips) 
jp0319: posts small blind $3
borntotilt: posts big blind $6
floriiiiider: sits out 
*** HOLE CARDS ***
JMBigJoe: raises $12 to $18
Chappolini: raises $36 to $54
ilir3: folds 
jp0319: folds 
floriiiiider leaves the table
borntotilt: folds 
BKA12 joins the table at seat #2 
JMBigJoe: folds 
Uncalled bet ($36) returned to Chappolini
Chappolini collected $45 from pot
Chappolini: doesn't show hand 
*** SUMMARY ***
Total pot $45 | Rake $0 
Seat 1: JMBigJoe folded before Flop
Seat 3: Chappolini collected ($45)
Seat 4: ilir3 (button) folded before Flop (didn't bet)
Seat 5: jp0319 (small blind) folded before Flop
Seat 6: borntotilt (big blind) folded before Flop


PokerStars Game #102615290690:  Hold'em No Limit ($3/$6 USD) - 2013/08/11 13:48:20 ET
Table 'Tanete V 40-100 bb' 6-max Seat #5 is the button
Seat 1: JMBigJoe ($651.20 in chips) 
Seat 3: Chappolini ($639 in chips) 
Seat 4: ilir3 ($891.82 in chips) 
Seat 5: jp0319 ($600 in chips) 
Seat 6: borntotilt ($612 in chips) 
borntotilt: posts small blind $3
JMBigJoe: posts big blind $6
BKA12: sits out 
*** HOLE CARDS ***
Chappolini: raises $12 to $18
ilir3: folds 
jp0319: folds 
borntotilt: folds 
JMBigJoe: folds 
Uncalled bet ($12) returned to Chappolini
Chappolini collected $15 from pot
Chappolini: doesn't show hand 
*** SUMMARY ***
Total pot $15 | Rake $0 
Seat 1: JMBigJoe (big blind) folded before Flop
Seat 3: Chappolini collected ($15)
Seat 4: ilir3 folded before Flop (didn't bet)
Seat 5: jp0319 (button) folded before Flop (didn't bet)
Seat 6: borntotilt (small blind) folded before Flop


PokerStars Game #102615314442:  Hold'em No Limit ($3/$6 USD) - 2013/08/11 13:48:49 ET
Table 'Tanete V 40-100 bb' 6-max Seat #6 is the button
Seat 1: JMBigJoe ($645.20 in chips) 
Seat 2: BKA12 ($600 in chips) 
Seat 3: Chappolini ($648 in chips) 
Seat 4: ilir3 ($891.82 in chips) 
Seat 5: jp0319 ($600 in chips) 
Seat 6: borntotilt ($609 in chips) 
JMBigJoe: posts small blind $3
BKA12: posts big blind $6
*** HOLE CARDS ***
Chappolini: folds 
ilir3: folds 
jp0319: folds 
borntotilt: folds 
JMBigJoe: raises $12 to $18
BKA12: calls $12
*** FLOP *** [9c Qc Jd]
JMBigJoe: checks 
BKA12: checks 
*** TURN *** [9c Qc Jd] [Qd]
JMBigJoe: checks 
BKA12: checks 
*** RIVER *** [9c Qc Jd Qd] [2s]
JMBigJoe: bets $24
BKA12: calls $24
*** SHOW DOWN ***
JMBigJoe: shows [Tc Qh] (three of a kind, Queens)
BKA12: mucks hand 
JMBigJoe collected $81.20 from pot
*** SUMMARY ***
Total pot $84 | Rake $2.80 
Board [9c Qc Jd Qd 2s]
Seat 1: JMBigJoe (small blind) showed [Tc Qh] and won ($81.20) with three of a kind, Queens
Seat 2: BKA12 (big blind) mucked
Seat 3: Chappolini folded before Flop (didn't bet)
Seat 4: ilir3 folded before Flop (didn't bet)
Seat 5: jp0319 folded before Flop (didn't bet)
Seat 6: borntotilt (button) folded before Flop (didn't bet)


PokerStars Game #102614890333:  Hold'em No Limit ($3/$6 USD) - 2013/08/11 13:40:18 ET
Table 'Tanete V 40-100 bb' 6-max Seat #4 is the button
Seat 1: JMBigJoe ($612 in chips) 
Seat 2: leo 32824 ($591 in chips) 
Seat 3: Chappolini ($600 in chips) 
Seat 4: ilir3 ($655.50 in chips) 
Seat 5: jp0319 ($613.78 in chips) 
Seat 6: borntotilt ($627 in chips) 
jp0319: posts small blind $3
borntotilt: posts big blind $6
*** HOLE CARDS ***
JMBigJoe: folds 
leo 32824 is disconnected 
leo 32824 has timed out while disconnected
leo 32824: folds 
Chappolini: folds 
ilir3: raises $6 to $12
jp0319: raises $36 to $48
borntotilt: folds 
ilir3: calls $36
*** FLOP *** [6d Tc 6c]
jp0319: bets $66.46
ilir3: calls $66.46
*** TURN *** [6d Tc 6c] [Qc]
jp0319: bets $127.66
ilir3: raises $413.38 to $541.04 and is all-in
jp0319: folds 
Uncalled bet ($413.38) returned to ilir3
ilir3 collected $487.44 from pot
ilir3: doesn't show hand 
*** SUMMARY ***
Total pot $490.24 | Rake $2.80 
Board [6d Tc 6c Qc]
Seat 1: JMBigJoe folded before Flop (didn't bet)
Seat 2: leo 32824 folded before Flop (didn't bet)
Seat 3: Chappolini folded before Flop (didn't bet)
Seat 4: ilir3 (button) collected ($487.44)
Seat 5: jp0319 (small blind) folded on the Turn
Seat 6: borntotilt (big blind) folded before Flop


PokerStars Game #102614975939:  Hold'em No Limit ($3/$6 USD) - 2013/08/11 13:42:01 ET
Table 'Tanete V 40-100 bb' 6-max Seat #5 is the button
Seat 1: JMBigJoe ($612 in chips) 
Seat 3: Chappolini ($600 in chips) 
Seat 4: ilir3 ($900.82 in chips) 
Seat 5: jp0319 ($600 in chips) 
Seat 6: borntotilt ($621 in chips) 
borntotilt: posts small blind $3
JMBigJoe: posts big blind $6
*** HOLE CARDS ***
Chappolini: raises $12 to $18
ilir3: folds 
jp0319: folds 
borntotilt: folds 
JMBigJoe: calls $12
*** FLOP *** [4d 6h 2s]
JMBigJoe: checks 
Chappolini: bets $24
leo 32824 leaves the table
JMBigJoe: calls $24
*** TURN *** [4d 6h 2s] [2h]
JMBigJoe: checks 
Chappolini: checks 
*** RIVER *** [4d 6h 2s 2h] [Qc]
JMBigJoe: bets $160
Chappolini: folds 
Uncalled bet ($160) returned to JMBigJoe
JMBigJoe collected $84.20 from pot
*** SUMMARY ***
Total pot $87 | Rake $2.80 
Board [4d 6h 2s 2h Qc]
Seat 1: JMBigJoe (big blind) collected ($84.20)
Seat 3: Chappolini folded on the River
Seat 4: ilir3 folded before Flop (didn't bet)
Seat 5: jp0319 (button) folded before Flop (didn't bet)
Seat 6: borntotilt (small blind) folded before Flop


PokerStars Game #102615113701:  Hold'em No Limit ($3/$6 USD) - 2013/08/11 13:44:48 ET
Table 'Tanete V 40-100 bb' 6-max Seat #6 is the button
Seat 1: JMBigJoe ($654.20 in chips) 
Seat 3: Chappolini ($600 in chips) 
Seat 4: ilir3 ($900.82 in chips) 
Seat 5: jp0319 ($600 in chips) 
Seat 6: borntotilt ($618 in chips) 
JMBigJoe: posts small blind $3
Chappolini: posts big blind $6
*** HOLE CARDS ***
ilir3: folds 
jp0319: raises $6 to $12
borntotilt: folds 
JMBigJoe: folds 
Chappolini: raises $36 to $48
floriiiiider joins the table at seat #2 
jp0319: folds 
Uncalled bet ($36) returned to Chappolini
Chappolini collected $27 from pot
Chappolini: doesn't show hand 
*** SUMMARY ***
Total pot $27 | Rake $0 
Seat 1: JMBigJoe (small blind) folded before Flop
Seat 3: Chappolini (big blind) collected ($27)
Seat 4: ilir3 folded before Flop (didn't bet)
Seat 5: jp0319 folded before Flop
Seat 6: borntotilt (button) folded before Flop (didn't bet)


PokerStars Game #102614693228:  Hold'em No Limit ($3/$6 USD) - 2013/08/11 13:36:20 ET
Table 'Tanete V 40-100 bb' 6-max Seat #4 is the button
Seat 1: JMBigJoe ($600 in chips) 
Seat 3: Chappolini ($600 in chips) 
Seat 4: ilir3 ($676.50 in chips) 
Seat 5: jp0319 ($613.78 in chips) 
Seat 6: borntotilt ($600 in chips) 
jp0319: posts small blind $3
borntotilt: posts big blind $6
leo 32824: sits out 
*** HOLE CARDS ***
JMBigJoe: folds 
Chappolini: folds 
ilir3: folds 
jp0319: folds 
Uncalled bet ($3) returned to borntotilt
borntotilt collected $6 from pot
borntotilt: doesn't show hand 
*** SUMMARY ***
Total pot $6 | Rake $0 
Seat 1: JMBigJoe folded before Flop (didn't bet)
Seat 3: Chappolini folded before Flop (didn't bet)
Seat 4: ilir3 (button) folded before Flop (didn't bet)
Seat 5: jp0319 (small blind) folded before Flop
Seat 6: borntotilt (big blind) collected ($6)


PokerStars Game #102614711829:  Hold'em No Limit ($3/$6 USD) - 2013/08/11 13:36:42 ET
Table 'Tanete V 40-100 bb' 6-max Seat #5 is the button
Seat 1: JMBigJoe ($600 in chips) 
Seat 3: Chappolini ($600 in chips) 
Seat 4: ilir3 ($676.50 in chips) 
Seat 5: jp0319 ($610.78 in chips) 
Seat 6: borntotilt ($603 in chips) 
borntotilt: posts small blind $3
JMBigJoe: posts big blind $6
leo 32824: sits out 
*** HOLE CARDS ***
Chappolini: folds 
ilir3: raises $6 to $12
jp0319: folds 
borntotilt: folds 
JMBigJoe: raises $33 to $45
ilir3: folds 
Uncalled bet ($33) returned to JMBigJoe
JMBigJoe collected $27 from pot
*** SUMMARY ***
Total pot $27 | Rake $0 
Seat 1: JMBigJoe (big blind) collected ($27)
Seat 3: Chappolini folded before Flop (didn't bet)
Seat 4: ilir3 folded before Flop
Seat 5: jp0319 (button) folded before Flop (didn't bet)
Seat 6: borntotilt (small blind) folded before Flop


PokerStars Game #102614756743:  Hold'em No Limit ($3/$6 USD) - 2013/08/11 13:37:36 ET
Table 'Tanete V 40-100 bb' 6-max Seat #6 is the button
Seat 1: JMBigJoe ($615 in chips) 
Seat 2: leo 32824 ($600 in chips) 
Seat 3: Chappolini ($600 in chips) 
Seat 4: ilir3 ($664.50 in chips) 
Seat 5: jp0319 ($610.78 in chips) 
Seat 6: borntotilt ($600 in chips) 
JMBigJoe: posts small blind $3
leo 32824: posts big blind $6
*** HOLE CARDS ***
Chappolini: folds 
ilir3: folds 
jp0319: folds 
borntotilt: raises $6 to $12
JMBigJoe: folds 
leo 32824: folds 
Uncalled bet ($6) returned to borntotilt
borntotilt collected $15 from pot
borntotilt: doesn't show hand 
*** SUMMARY ***
Total pot $15 | Rake $0 
Seat 1: JMBigJoe (small blind) folded before Flop
Seat 2: leo 32824 (big blind) folded before Flop
Seat 3: Chappolini folded before Flop (didn't bet)
Seat 4: ilir3 folded before Flop (didn't bet)
Seat 5: jp0319 folded before Flop (didn't bet)
Seat 6: borntotilt (button) collected ($15)


PokerStars Game #102614799607:  Hold'em No Limit ($3/$6 USD) - 2013/08/11 13:38:27 ET
Table 'Tanete V 40-100 bb' 6-max Seat #1 is the button
Seat 1: JMBigJoe ($612 in chips) 
Seat 2: leo 32824 ($594 in chips) 
Seat 3: Chappolini ($600 in chips) 
Seat 4: ilir3 ($664.50 in chips) 
Seat 5: jp0319 ($610.78 in chips) 
Seat 6: borntotilt ($609 in chips) 
leo 32824: posts small blind $3
Chappolini: posts big blind $6
*** HOLE CARDS ***
ilir3: folds 
jp0319: raises $9 to $15
borntotilt: folds 
JMBigJoe: folds 
leo 32824: folds 
Chappolini: folds 
Uncalled bet ($9) returned to jp0319
jp0319 collected $15 from pot
jp0319: doesn't show hand 
*** SUMMARY ***
Total pot $15 | Rake $0 
Seat 1: JMBigJoe (button) folded before Flop (didn't bet)
Seat 2: leo 32824 (small blind) folded before Flop
Seat 3: Chappolini (big blind) folded before Flop
Seat 4: ilir3 folded before Flop (didn't bet)
Seat 5: jp0319 collected ($15)
Seat 6: borntotilt folded before Flop (didn't bet)


PokerStars Game #102614817763:  Hold'em No Limit ($3/$6 USD) - 2013/08/11 13:38:49 ET
Table 'Tanete V 40-100 bb' 6-max Seat #2 is the button
Seat 1: JMBigJoe ($612 in chips) 
Seat 2: leo 32824 ($591 in chips) 
Seat 3: Chappolini ($600 in chips) 
Seat 4: ilir3 ($664.50 in chips) 
Seat 5: jp0319 ($619.78 in chips) 
Seat 6: borntotilt ($609 in chips) 
Chappolini: posts small blind $3
ilir3: posts big blind $6
*** HOLE CARDS ***
jp0319: folds 
borntotilt: raises $12 to $18
JMBigJoe: folds 
leo 32824: folds 
Chappolini: folds 
ilir3: folds 
Uncalled bet ($12) returned to borntotilt
borntotilt collected $15 from pot
borntotilt: doesn't show hand 
*** SUMMARY ***
Total pot $15 | Rake $0 
Seat 1: JMBigJoe folded before Flop (didn't bet)
Seat 2: leo 32824 (button) folded before Flop (didn't bet)
Seat 3: Chappolini (small blind) folded before Flop
Seat 4: ilir3 (big blind) folded before Flop
Seat 5: jp0319 folded before Flop (didn't bet)
Seat 6: borntotilt collected ($15)


PokerStars Game #102614847905:  Hold'em No Limit ($3/$6 USD) - 2013/08/11 13:39:26 ET
Table 'Tanete V 40-100 bb' 6-max Seat #3 is the button
Seat 1: JMBigJoe ($612 in chips) 
Seat 2: leo 32824 ($591 in chips) 
Seat 3: Chappolini ($600 in chips) 
Seat 4: ilir3 ($658.50 in chips) 
Seat 5: jp0319 ($619.78 in chips) 
Seat 6: borntotilt ($618 in chips) 
ilir3: posts small blind $3
jp0319: posts big blind $6
*** HOLE CARDS ***
borntotilt: raises $12 to $18
JMBigJoe: folds 
leo 32824: folds 
Chappolini: folds 
ilir3: folds 
jp0319: folds 
Uncalled bet ($12) returned to borntotilt
borntotilt collected $15 from pot
borntotilt: doesn't show hand 
*** SUMMARY ***
Total pot $15 | Rake $0 
Seat 1: JMBigJoe folded before Flop (didn't bet)
Seat 2: leo 32824 folded before Flop (didn't bet)
Seat 3: Chappolini (button) folded before Flop (didn't bet)
Seat 4: ilir3 (small blind) folded before Flop
Seat 5: jp0319 (big blind) folded before Flop
Seat 6: borntotilt collected ($15)


PokerStars Game #102614469418:  Hold'em No Limit ($3/$6 USD) - 2013/08/11 13:31:53 ET
Table 'Tanete V 40-100 bb' 6-max Seat #4 is the button
Seat 1: JMBigJoe ($600 in chips) 
Seat 4: ilir3 ($606 in chips) 
Seat 5: jp0319 ($600 in chips) 
jp0319: posts small blind $3
JMBigJoe: posts big blind $6
*** HOLE CARDS ***
ilir3: raises $6 to $12
jp0319: folds 
JMBigJoe: calls $6
*** FLOP *** [Ks Td Jc]
JMBigJoe: checks 
ilir3: bets $12
JMBigJoe: calls $12
*** TURN *** [Ks Td Jc] [7h]
JMBigJoe: checks 
ilir3: checks 
*** RIVER *** [Ks Td Jc 7h] [3d]
borntotilt joins the table at seat #6 
Chappolini joins the table at seat #3 
JMBigJoe: bets $24
ilir3: calls $24
*** SHOW DOWN ***
JMBigJoe: shows [6h Qh] (high card King)
ilir3: shows [5h Kh] (a pair of Kings)
ilir3 collected $97.50 from pot
*** SUMMARY ***
Total pot $99 | Rake $1.50 
Board [Ks Td Jc 7h 3d]
Seat 1: JMBigJoe (big blind) showed [6h Qh] and lost with high card King
Seat 4: ilir3 (button) showed [5h Kh] and won ($97.50) with a pair of Kings
Seat 5: jp0319 (small blind) folded before Flop


PokerStars Game #102614542414:  Hold'em No Limit ($3/$6 USD) - 2013/08/11 13:33:19 ET
Table 'Tanete V 40-100 bb' 6-max Seat #5 is the button
Seat 1: JMBigJoe ($600 in chips) 
Seat 3: Chappolini ($600 in chips) 
Seat 4: ilir3 ($655.50 in chips) 
Seat 5: jp0319 ($600 in chips) 
borntotilt will be allowed to play after the button
JMBigJoe: posts small blind $3
Chappolini: posts big blind $6
*** HOLE CARDS ***
leo 32824 joins the table at seat #2 
ilir3: raises $6 to $12
jp0319: folds 
JMBigJoe: folds 
Chappolini: folds 
Uncalled bet ($6) returned to ilir3
ilir3 collected $15 from pot
*** SUMMARY ***
Total pot $15 | Rake $0 
Seat 1: JMBigJoe (small blind) folded before Flop
Seat 3: Chappolini (big blind) folded before Flop
Seat 4: ilir3 collected ($15)
Seat 5: jp0319 (button) folded before Flop (didn't bet)


PokerStars Game #102614558260:  Hold'em No Limit ($3/$6 USD) - 2013/08/11 13:33:38 ET
Table 'Tanete V 40-100 bb' 6-max Seat #1 is the button
Seat 1: JMBigJoe ($600 in chips) 
Seat 3: Chappolini ($600 in chips) 
Seat 4: ilir3 ($664.50 in chips) 
Seat 5: jp0319 ($600 in chips) 
leo 32824 will be allowed to play after the button
Chappolini: posts small blind $3
ilir3: posts big blind $6
borntotilt: sits out 
*** HOLE CARDS ***
jp0319: raises $6 to $12
JMBigJoe: folds 
Chappolini: folds 
ilir3: raises $36 to $48
jp0319: folds 
Uncalled bet ($36) returned to ilir3
ilir3 collected $27 from pot
*** SUMMARY ***
Total pot $27 | Rake $0 
Seat 1: JMBigJoe (button) folded before Flop (didn't bet)
Seat 3: Chappolini (small blind) folded before Flop
Seat 4: ilir3 (big blind) collected ($27)
Seat 5: jp0319 folded before Flop


PokerStars Game #102614597967:  Hold'em No Limit ($3/$6 USD) - 2013/08/11 13:34:25 ET
Table 'Tanete V 40-100 bb' 6-max Seat #3 is the button
Seat 1: JMBigJoe ($600 in chips) 
Seat 3: Chappolini ($600 in chips) 
Seat 4: ilir3 ($679.50 in chips) 
Seat 5: jp0319 ($600 in chips) 
ilir3: posts small blind $3
jp0319: posts big blind $6
borntotilt: sits out 
leo 32824: sits out 
*** HOLE CARDS ***
JMBigJoe: folds 
Chappolini: raises $6 to $12
ilir3: folds 
jp0319: calls $6
*** FLOP *** [Td 3d Kh]
jp0319: checks 
Chappolini: checks 
*** TURN *** [Td 3d Kh] [Tc]
jp0319: checks 
Chappolini: checks 
*** RIVER *** [Td 3d Kh Tc] [Jc]
jp0319: checks 
Chappolini: checks 
*** SHOW DOWN ***
jp0319: shows [6c 6s] (two pair, Tens and Sixes)
Chappolini: mucks hand 
jp0319 collected $25.78 from pot
*** SUMMARY ***
Total pot $27 | Rake $1.22 
Board [Td 3d Kh Tc Jc]
Seat 1: JMBigJoe folded before Flop (didn't bet)
Seat 3: Chappolini (button) mucked
Seat 4: ilir3 (small blind) folded before Flop
Seat 5: jp0319 (big blind) showed [6c 6s] and won ($25.78) with two pair, Tens and Sixes


PokerStars Game #102614457290:  Hold'em No Limit ($3/$6 USD) - 2013/08/11 13:31:39 ET
Table 'Tanete V 40-100 bb' 6-max Seat #4 is the button
Seat 4: ilir3 ($600 in chips) 
Seat 5: jp0319 ($600 in chips) 
ilir3: posts small blind $3
jp0319: posts big blind $6
*** HOLE CARDS ***
ilir3: raises $12 to $18
JMBigJoe joins the table at seat #1 
jp0319: folds 
Uncalled bet ($12) returned to ilir3
ilir3 collected $12 from pot
*** SUMMARY ***
Total pot $12 | Rake $0 
Seat 4: ilir3 (button) (small blind) collected ($12)
Seat 5: jp0319 (big blind) folded before Flop


PokerStars Game #102615621984:  Hold'em No Limit ($3/$6 USD) - 2013/08/11 13:55:05 ET
Table 'Tanete V 40-100 bb' 6-max Seat #5 is the button
Seat 1: JMBigJoe ($684.40 in chips) 
Seat 2: BKA12 ($609 in chips) 
Seat 3: Chappolini ($756.20 in chips) 
Seat 4: ilir3 ($780.28 in chips) 
Seat 5: jp0319 ($600 in chips) 
Seat 6: borntotilt ($612 in chips) 
borntotilt: posts small blind $3
JMBigJoe: posts big blind $6
*** HOLE CARDS ***
BKA12: folds 
Chappolini: raises $12 to $18
ilir3: folds 
jp0319: folds 
borntotilt: raises $42 to $60
JMBigJoe: raises $51 to $111
Chappolini: folds 
borntotilt: calls $51
*** FLOP *** [9d Ad 8c]
borntotilt: checks 
JMBigJoe: bets $81
borntotilt: calls $81
*** TURN *** [9d Ad 8c] [5d]
borntotilt: checks 
JMBigJoe: bets $132
borntotilt: calls $132
*** RIVER *** [9d Ad 8c 5d] [7d]
borntotilt: checks 
JMBigJoe: checks 
*** SHOW DOWN ***
borntotilt: shows [Ks Kd] (a flush, Ace high)
JMBigJoe: mucks hand 
borntotilt collected $663.20 from pot
*** SUMMARY ***
Total pot $666 | Rake $2.80 
Board [9d Ad 8c 5d 7d]
Seat 1: JMBigJoe (big blind) mucked
Seat 2: BKA12 folded before Flop (didn't bet)
Seat 3: Chappolini folded before Flop
Seat 4: ilir3 folded before Flop (didn't bet)
Seat 5: jp0319 (button) folded before Flop (didn't bet)
Seat 6: borntotilt (small blind) showed [Ks Kd] and won ($663.20) with a flush, Ace high


PokerStars Game #102615713682:  Hold'em No Limit ($3/$6 USD) - 2013/08/11 13:58:00 ET
Table 'Tanete V 40-100 bb' 6-max Seat #6 is the button
Seat 1: JMBigJoe ($600 in chips) 
Seat 2: BKA12 ($609 in chips) 
Seat 3: Chappolini ($738.20 in chips) 
Seat 4: ilir3 ($780.28 in chips) 
Seat 5: jp0319 ($600 in chips) 
Seat 6: borntotilt ($951.20 in chips) 
JMBigJoe: posts small blind $3
BKA12: posts big blind $6
*** HOLE CARDS ***
Chappolini: folds 
ilir3: folds 
jp0319: raises $6 to $12
borntotilt: folds 
JMBigJoe: folds 
BKA12: folds 
Uncalled bet ($6) returned to jp0319
jp0319 collected $15 from pot
jp0319: doesn't show hand 
*** SUMMARY ***
Total pot $15 | Rake $0 
Seat 1: JMBigJoe (small blind) folded before Flop
Seat 2: BKA12 (big blind) folded before Flop
Seat 3: Chappolini folded before Flop (didn't bet)
Seat 4: ilir3 folded before Flop (didn't bet)
Seat 5: jp0319 collected ($15)
Seat 6: borntotilt (button) folded before Flop (didn't bet)


PokerStars Game #102615739076:  Hold'em No Limit ($3/$6 USD) - 2013/08/11 13:58:50 ET
Table 'Tanete V 40-100 bb' 6-max Seat #1 is the button
Seat 1: JMBigJoe ($600 in chips) 
Seat 2: BKA12 ($603 in chips) 
Seat 3: Chappolini ($738.20 in chips) 
Seat 4: ilir3 ($780.28 in chips) 
Seat 5: jp0319 ($609 in chips) 
Seat 6: borntotilt ($951.20 in chips) 
BKA12: posts small blind $3
Chappolini: posts big blind $6
*** HOLE CARDS ***
ilir3: raises $9 to $15
jp0319: folds 
borntotilt: folds 
JMBigJoe: calls $15
BKA12: raises $48 to $63
Chappolini: folds 
ilir3: folds 
JMBigJoe: folds 
Uncalled bet ($48) returned to BKA12
ilir3 leaves the table
BKA12 collected $51 from pot
BKA12: doesn't show hand 
*** SUMMARY ***
Total pot $51 | Rake $0 
Seat 1: JMBigJoe (button) folded before Flop
Seat 2: BKA12 (small blind) collected ($51)
Seat 3: Chappolini (big blind) folded before Flop
Seat 4: ilir3 folded before Flop
Seat 5: jp0319 folded before Flop (didn't bet)
Seat 6: borntotilt folded before Flop (didn't bet)


PokerStars Game #102615772011:  Hold'em No Limit ($3/$6 USD) - 2013/08/11 13:59:52 ET
Table 'Tanete V 40-100 bb' 6-max Seat #2 is the button
Seat 1: JMBigJoe ($600 in chips) 
Seat 2: BKA12 ($639 in chips) 
Seat 3: Chappolini ($732.20 in chips) 
Seat 5: jp0319 ($609 in chips) 
Seat 6: borntotilt ($951.20 in chips) 
Chappolini: posts small blind $3
jp0319: posts big blind $6
*** HOLE CARDS ***
maloyd joins the table at seat #4 
borntotilt: folds 
JMBigJoe: folds 
BKA12: raises $6 to $12
Chappolini: folds 
jp0319: folds 
Uncalled bet ($6) returned to BKA12
BKA12 collected $15 from pot
BKA12: doesn't show hand 
*** SUMMARY ***
Total pot $15 | Rake $0 
Seat 1: JMBigJoe folded before Flop (didn't bet)
Seat 2: BKA12 (button) collected ($15)
Seat 3: Chappolini (small blind) folded before Flop
Seat 5: jp0319 (big blind) folded before Flop
Seat 6: borntotilt folded before Flop (didn't bet)


PokerStars Game #102615787730:  Hold'em No Limit ($3/$6 USD) - 2013/08/11 14:00:19 ET
Table 'Tanete V 40-100 bb' 6-max Seat #3 is the button
Seat 1: JMBigJoe ($600 in chips) 
Seat 2: BKA12 ($648 in chips) 
Seat 3: Chappolini ($729.20 in chips) 
Seat 5: jp0319 ($603 in chips) 
Seat 6: borntotilt ($951.20 in chips) 
maloyd will be allowed to play after the button
jp0319: posts small blind $3
borntotilt: posts big blind $6
*** HOLE CARDS ***
JMBigJoe: folds 
BKA12: folds 
Chappolini: raises $6 to $12
jp0319: folds 
borntotilt: calls $6
*** FLOP *** [Kd Qc Qs]
borntotilt: checks 
Chappolini: checks 
*** TURN *** [Kd Qc Qs] [Ks]
borntotilt: checks 
Chappolini: checks 
*** RIVER *** [Kd Qc Qs Ks] [3c]
borntotilt: checks 
Chappolini: checks 
*** SHOW DOWN ***
borntotilt: shows [8d 9h] (two pair, Kings and Queens)
Chappolini: shows [Th 3h] (two pair, Kings and Queens - Ten kicker)
Chappolini collected $25.78 from pot
*** SUMMARY ***
Total pot $27 | Rake $1.22 
Board [Kd Qc Qs Ks 3c]
Seat 1: JMBigJoe folded before Flop (didn't bet)
Seat 2: BKA12 folded before Flop (didn't bet)
Seat 3: Chappolini (button) showed [Th 3h] and won ($25.78) with two pair, Kings and Queens
Seat 5: jp0319 (small blind) folded before Flop
Seat 6: borntotilt (big blind) showed [8d 9h] and lost with two pair, Kings and Queens


PokerStars Game #102615828832:  Hold'em No Limit ($3/$6 USD) - 2013/08/11 14:01:25 ET
Table 'Tanete V 40-100 bb' 6-max Seat #5 is the button
Seat 1: JMBigJoe ($600 in chips) 
Seat 2: BKA12 ($648 in chips) 
Seat 3: Chappolini ($742.98 in chips) 
Seat 5: jp0319 ($600 in chips) 
Seat 6: borntotilt ($939.20 in chips) 
borntotilt: posts small blind $3
JMBigJoe: posts big blind $6
maloyd: sits out 
*** HOLE CARDS ***
BKA12: folds 
Chappolini: folds 
BKA12 leaves the table
jp0319: folds 
borntotilt: folds 
Uncalled bet ($3) returned to JMBigJoe
JMBigJoe collected $6 from pot
*** SUMMARY ***
Total pot $6 | Rake $0 
Seat 1: JMBigJoe (big blind) collected ($6)
Seat 2: BKA12 folded before Flop (didn't bet)
Seat 3: Chappolini folded before Flop (didn't bet)
Seat 5: jp0319 (button) folded before Flop (didn't bet)
Seat 6: borntotilt (small blind) folded before Flop


PokerStars Game #102615839781:  Hold'em No Limit ($3/$6 USD) - 2013/08/11 14:01:41 ET
Table 'Tanete V 40-100 bb' 6-max Seat #6 is the button
Seat 1: JMBigJoe ($603 in chips) 
Seat 4: maloyd ($600 in chips) 
Seat 5: jp0319 ($600 in chips) 
Seat 6: borntotilt ($936.20 in chips) 
JMBigJoe: posts small blind $3
Chappolini: is sitting out 
maloyd: posts big blind $6
*** HOLE CARDS ***
Chappolini leaves the table
jp0319: folds 
borntotilt: folds 
JMBigJoe: raises $12 to $18
maloyd: folds 
Uncalled bet ($12) returned to JMBigJoe
JMBigJoe collected $12 from pot
*** SUMMARY ***
Total pot $12 | Rake $0 
Seat 1: JMBigJoe (small blind) collected ($12)
Seat 4: maloyd (big blind) folded before Flop
Seat 5: jp0319 folded before Flop (didn't bet)
Seat 6: borntotilt (button) folded before Flop (didn't bet)


PokerStars Game #102615870495:  Hold'em No Limit ($3/$6 USD) - 2013/08/11 14:02:21 ET
Table 'Tanete V 40-100 bb' 6-max Seat #1 is the button
Seat 1: JMBigJoe ($609 in chips) 
Seat 4: maloyd ($600 in chips) 
Seat 6: borntotilt ($936.20 in chips) 
maloyd: posts small blind $3
jp0319: is sitting out 
borntotilt: posts big blind $6
*** HOLE CARDS ***
JMBigJoe: raises $6 to $12
barrao joins the table at seat #3 
maloyd: folds 
borntotilt: calls $6
*** FLOP *** [4d 9s Kh]
borntotilt: checks 
JMBigJoe: bets $12.89
Hristo008 joins the table at seat #2 
borntotilt: folds 
Uncalled bet ($12.89) returned to JMBigJoe
JMBigJoe collected $25.78 from pot
jp0319 leaves the table
*** SUMMARY ***
Total pot $27 | Rake $1.22 
Board [4d 9s Kh]
Seat 1: JMBigJoe (button) collected ($25.78)
Seat 4: maloyd (small blind) folded before Flop
Seat 6: borntotilt (big blind) folded on the Flop


PokerStars Game #102615895012:  Hold'em No Limit ($3/$6 USD) - 2013/08/11 14:02:52 ET
Table 'Tanete V 40-100 bb' 6-max Seat #4 is the button
Seat 2: Hristo008 ($240 in chips) 
Seat 4: maloyd ($600 in chips) 
Seat 6: borntotilt ($924.20 in chips) 
borntotilt: posts small blind $3
JMBigJoe: is sitting out 
Hristo008: posts big blind $6
barrao: sits out 
*** HOLE CARDS ***
maloyd: folds 
borntotilt: folds 
Uncalled bet ($3) returned to Hristo008
Hristo008 collected $6 from pot
Hristo008 leaves the table
*** SUMMARY ***
Total pot $6 | Rake $0 
Seat 2: Hristo008 (big blind) collected ($6)
Seat 4: maloyd (button) folded before Flop (didn't bet)
Seat 6: borntotilt (small blind) folded before Flop


PokerStars Game #102615911659:  Hold'em No Limit ($3/$6 USD) - 2013/08/11 14:03:13 ET
Table 'Tanete V 40-100 bb' 6-max Seat #4 is the button
Seat 3: barrao ($240 in chips) 
Seat 4: maloyd ($600 in chips) 
Seat 6: borntotilt ($924.20 in chips) 
borntotilt: posts small blind $3
barrao: posts big blind $6
*** HOLE CARDS ***
maloyd: folds 
borntotilt: folds 
Uncalled bet ($3) returned to barrao
barrao collected $6 from pot
barrao: doesn't show hand 
*** SUMMARY ***
Total pot $6 | Rake $0 
Seat 3: barrao (big blind) collected ($6)
Seat 4: maloyd (button) folded before Flop (didn't bet)
Seat 6: borntotilt (small blind) folded before Flop


PokerStars Game #102615906086:  Hold'em No Limit ($3/$6 USD) - 2013/08/11 14:03:06 ET
Table 'Tanete V 40-100 bb' 6-max Seat #4 is the button
Seat 4: maloyd ($600 in chips) 
Seat 6: borntotilt ($921.20 in chips) 
barrao will be allowed to play after the button
maloyd: posts small blind $3
borntotilt: posts big blind $6
*** HOLE CARDS ***
JMBigJoe leaves the table
maloyd: folds 
Uncalled bet ($3) returned to borntotilt
borntotilt collected $6 from pot
borntotilt: doesn't show hand 
*** SUMMARY ***
Total pot $6 | Rake $0 
Seat 4: maloyd (button) (small blind) folded before Flop
Seat 6: borntotilt (big blind) collected ($6)


PokerStars Game #102615414007:  Hold'em No Limit ($3/$6 USD) - 2013/08/11 13:50:50 ET
Table 'Tanete V 40-100 bb' 6-max Seat #1 is the button
Seat 1: JMBigJoe ($684.40 in chips) 
Seat 2: BKA12 ($600 in chips) 
Seat 3: Chappolini ($648 in chips) 
Seat 4: ilir3 ($891.82 in chips) 
Seat 5: jp0319 ($600 in chips) 
Seat 6: borntotilt ($609 in chips) 
BKA12: posts small blind $3
Chappolini: posts big blind $6
*** HOLE CARDS ***
ilir3: folds 
jp0319: folds 
borntotilt: raises $12 to $18
JMBigJoe: folds 
BKA12: folds 
Chappolini: folds 
Uncalled bet ($12) returned to borntotilt
borntotilt collected $15 from pot
borntotilt: doesn't show hand 
*** SUMMARY ***
Total pot $15 | Rake $0 
Seat 1: JMBigJoe (button) folded before Flop (didn't bet)
Seat 2: BKA12 (small blind) folded before Flop
Seat 3: Chappolini (big blind) folded before Flop
Seat 4: ilir3 folded before Flop (didn't bet)
Seat 5: jp0319 folded before Flop (didn't bet)
Seat 6: borntotilt collected ($15)


PokerStars Game #102615452968:  Hold'em No Limit ($3/$6 USD) - 2013/08/11 13:51:37 ET
Table 'Tanete V 40-100 bb' 6-max Seat #2 is the button
Seat 1: JMBigJoe ($684.40 in chips) 
Seat 2: BKA12 ($600 in chips) 
Seat 3: Chappolini ($642 in chips) 
Seat 4: ilir3 ($891.82 in chips) 
Seat 5: jp0319 ($600 in chips) 
Seat 6: borntotilt ($618 in chips) 
Chappolini: posts small blind $3
ilir3: posts big blind $6
*** HOLE CARDS ***
jp0319: folds 
borntotilt: folds 
JMBigJoe: folds 
BKA12: folds 
Chappolini: raises $12 to $18
ilir3: calls $12
*** FLOP *** [Jd 2h Ac]
Chappolini: checks 
ilir3: checks 
*** TURN *** [Jd 2h Ac] [6s]
Chappolini: checks 
ilir3: bets $22
Chappolini: calls $22
*** RIVER *** [Jd 2h Ac 6s] [4s]
Chappolini: checks 
ilir3: bets $77
Chappolini: calls $77
*** SHOW DOWN ***
ilir3: shows [3c Tc] (high card Ace)
Chappolini: shows [Jh 8s] (a pair of Jacks)
Chappolini collected $231.20 from pot
*** SUMMARY ***
Total pot $234 | Rake $2.80 
Board [Jd 2h Ac 6s 4s]
Seat 1: JMBigJoe folded before Flop (didn't bet)
Seat 2: BKA12 (button) folded before Flop (didn't bet)
Seat 3: Chappolini (small blind) showed [Jh 8s] and won ($231.20) with a pair of Jacks
Seat 4: ilir3 (big blind) showed [3c Tc] and lost with high card Ace
Seat 5: jp0319 folded before Flop (didn't bet)
Seat 6: borntotilt folded before Flop (didn't bet)


PokerStars Game #102615532864:  Hold'em No Limit ($3/$6 USD) - 2013/08/11 13:53:16 ET
Table 'Tanete V 40-100 bb' 6-max Seat #3 is the button
Seat 1: JMBigJoe ($684.40 in chips) 
Seat 2: BKA12 ($600 in chips) 
Seat 3: Chappolini ($756.20 in chips) 
Seat 4: ilir3 ($774.82 in chips) 
Seat 5: jp0319 ($600 in chips) 
Seat 6: borntotilt ($618 in chips) 
ilir3: posts small blind $3
jp0319: posts big blind $6
*** HOLE CARDS ***
borntotilt: folds 
JMBigJoe: folds 
BKA12: folds 
Chappolini: folds 
ilir3: calls $3
jp0319: checks 
*** FLOP *** [Qc 6d Qs]
ilir3: checks 
jp0319: checks 
*** TURN *** [Qc 6d Qs] [8d]
ilir3: checks 
jp0319: checks 
*** RIVER *** [Qc 6d Qs 8d] [Ac]
ilir3: bets $6
jp0319: folds 
Uncalled bet ($6) returned to ilir3
ilir3 collected $11.46 from pot
*** SUMMARY ***
Total pot $12 | Rake $0.54 
Board [Qc 6d Qs 8d Ac]
Seat 1: JMBigJoe folded before Flop (didn't bet)
Seat 2: BKA12 folded before Flop (didn't bet)
Seat 3: Chappolini (button) folded before Flop (didn't bet)
Seat 4: ilir3 (small blind) collected ($11.46)
Seat 5: jp0319 (big blind) folded on the River
Seat 6: borntotilt folded before Flop (didn't bet)


PokerStars Game #102615592864:  Hold'em No Limit ($3/$6 USD) - 2013/08/11 13:54:29 ET
Table 'Tanete V 40-100 bb' 6-max Seat #4 is the button
Seat 1: JMBigJoe ($684.40 in chips) 
Seat 2: BKA12 ($600 in chips) 
Seat 3: Chappolini ($756.20 in chips) 
Seat 4: ilir3 ($780.28 in chips) 
Seat 5: jp0319 ($600 in chips) 
Seat 6: borntotilt ($618 in chips) 
jp0319: posts small blind $3
borntotilt: posts big blind $6
*** HOLE CARDS ***
JMBigJoe: folds 
BKA12: raises $12 to $18
Chappolini: folds 
ilir3: folds 
jp0319: folds 
borntotilt: folds 
Uncalled bet ($12) returned to BKA12
BKA12 collected $15 from pot
BKA12: doesn't show hand 
*** SUMMARY ***
Total pot $15 | Rake $0 
Seat 1: JMBigJoe folded before Flop (didn't bet)
Seat 2: BKA12 collected ($15)
Seat 3: Chappolini folded before Flop (didn't bet)
Seat 4: ilir3 (button) folded before Flop (didn't bet)
Seat 5: jp0319 (small blind) folded before Flop
Seat 6: borntotilt (big blind) folded before Flop


PokerStars Game #102617050917:  Hold'em No Limit ($3/$6 USD) - 2013/08/11 14:25:13 ET
Table 'Tanete V 40-100 bb' 6-max Seat #3 is the button
Seat 3: borntotilt ($1173.20 in chips) 
Seat 6: teunuss ($707.50 in chips) 
borntotilt: posts small blind $3
teunuss: posts big blind $6
*** HOLE CARDS ***
borntotilt: folds 
Uncalled bet ($3) returned to teunuss
teunuss collected $6 from pot
teunuss: doesn't show hand 
*** SUMMARY ***
Total pot $6 | Rake $0 
Seat 3: borntotilt (button) (small blind) folded before Flop
Seat 6: teunuss (big blind) collected ($6)


PokerStars Game #102617057662:  Hold'em No Limit ($3/$6 USD) - 2013/08/11 14:25:21 ET
Table 'Tanete V 40-100 bb' 6-max Seat #6 is the button
Seat 3: borntotilt ($1170.20 in chips) 
Seat 6: teunuss ($710.50 in chips) 
teunuss: posts small blind $3
borntotilt: posts big blind $6
*** HOLE CARDS ***
teunuss: raises $6 to $12
borntotilt: folds 
Uncalled bet ($6) returned to teunuss
teunuss collected $12 from pot
teunuss: doesn't show hand 
*** SUMMARY ***
Total pot $12 | Rake $0 
Seat 3: borntotilt (big blind) folded before Flop
Seat 6: teunuss (button) (small blind) collected ($12)


PokerStars Game #102617083486:  Hold'em No Limit ($3/$6 USD) - 2013/08/11 14:25:51 ET
Table 'Tanete V 40-100 bb' 6-max Seat #3 is the button
Seat 3: borntotilt ($1164.20 in chips) 
Seat 6: teunuss ($716.50 in chips) 
borntotilt: posts small blind $3
teunuss: posts big blind $6
*** HOLE CARDS ***
borntotilt: raises $6 to $12
teunuss: calls $6
*** FLOP *** [2h Jh 8s]
teunuss: checks 
borntotilt: bets $18
teunuss: folds 
Uncalled bet ($18) returned to borntotilt
borntotilt collected $23.50 from pot
borntotilt: doesn't show hand 
*** SUMMARY ***
Total pot $24 | Rake $0.50 
Board [2h Jh 8s]
Seat 3: borntotilt (button) (small blind) collected ($23.50)
Seat 6: teunuss (big blind) folded on the Flop


PokerStars Game #102617096746:  Hold'em No Limit ($3/$6 USD) - 2013/08/11 14:26:07 ET
Table 'Tanete V 40-100 bb' 6-max Seat #6 is the button
Seat 3: borntotilt ($1175.70 in chips) 
Seat 6: teunuss ($704.50 in chips) 
teunuss: posts small blind $3
borntotilt: posts big blind $6
*** HOLE CARDS ***
teunuss: raises $6 to $12
borntotilt: calls $6
*** FLOP *** [9c 7s Js]
borntotilt: checks 
teunuss: bets $18
borntotilt: folds 
Uncalled bet ($18) returned to teunuss
teunuss collected $23.50 from pot
teunuss: doesn't show hand 
*** SUMMARY ***
Total pot $24 | Rake $0.50 
Board [9c 7s Js]
Seat 3: borntotilt (big blind) folded on the Flop
Seat 6: teunuss (button) (small blind) collected ($23.50)


PokerStars Game #102617126853:  Hold'em No Limit ($3/$6 USD) - 2013/08/11 14:26:42 ET
Table 'Tanete V 40-100 bb' 6-max Seat #3 is the button
Seat 3: borntotilt ($1163.70 in chips) 
Seat 6: teunuss ($716 in chips) 
borntotilt: posts small blind $3
teunuss: posts big blind $6
*** HOLE CARDS ***
borntotilt: folds 
Uncalled bet ($3) returned to teunuss
teunuss collected $6 from pot
teunuss: doesn't show hand 
*** SUMMARY ***
Total pot $6 | Rake $0 
Seat 3: borntotilt (button) (small blind) folded before Flop
Seat 6: teunuss (big blind) collected ($6)


PokerStars Game #102617131938:  Hold'em No Limit ($3/$6 USD) - 2013/08/11 14:26:48 ET
Table 'Tanete V 40-100 bb' 6-max Seat #6 is the button
Seat 3: borntotilt ($1160.70 in chips) 
Seat 6: teunuss ($719 in chips) 
teunuss: posts small blind $3
borntotilt: posts big blind $6
*** HOLE CARDS ***
teunuss: raises $6 to $12
borntotilt: raises $36 to $48
teunuss: folds 
Uncalled bet ($36) returned to borntotilt
borntotilt collected $24 from pot
borntotilt: doesn't show hand 
*** SUMMARY ***
Total pot $24 | Rake $0 
Seat 3: borntotilt (big blind) collected ($24)
Seat 6: teunuss (button) (small blind) folded before Flop


PokerStars Game #102617142927:  Hold'em No Limit ($3/$6 USD) - 2013/08/11 14:27:01 ET
Table 'Tanete V 40-100 bb' 6-max Seat #3 is the button
Seat 3: borntotilt ($1172.70 in chips) 
Seat 6: teunuss ($707 in chips) 
borntotilt: posts small blind $3
teunuss: posts big blind $6
*** HOLE CARDS ***
borntotilt: raises $6 to $12
teunuss: calls $6
*** FLOP *** [2s As 3s]
teunuss: checks 
borntotilt: bets $18
teunuss: calls $18
*** TURN *** [2s As 3s] [2c]
teunuss: checks 
borntotilt: checks 
*** RIVER *** [2s As 3s 2c] [Kd]
teunuss: checks 
borntotilt: checks 
*** SHOW DOWN ***
teunuss: shows [5h 5s] (two pair, Fives and Deuces)
borntotilt: mucks hand 
teunuss collected $59.50 from pot
*** SUMMARY ***
Total pot $60 | Rake $0.50 
Board [2s As 3s 2c Kd]
Seat 3: borntotilt (button) (small blind) mucked
Seat 6: teunuss (big blind) showed [5h 5s] and won ($59.50) with two pair, Fives and Deuces


PokerStars Game #102617192689:  Hold'em No Limit ($3/$6 USD) - 2013/08/11 14:28:00 ET
Table 'Tanete V 40-100 bb' 6-max Seat #6 is the button
Seat 3: borntotilt ($1142.70 in chips) 
Seat 6: teunuss ($736.50 in chips) 
teunuss: posts small blind $3
borntotilt: posts big blind $6
*** HOLE CARDS ***
teunuss: raises $6 to $12
borntotilt: folds 
Uncalled bet ($6) returned to teunuss
teunuss collected $12 from pot
teunuss: doesn't show hand 
*** SUMMARY ***
Total pot $12 | Rake $0 
Seat 3: borntotilt (big blind) folded before Flop
Seat 6: teunuss (button) (small blind) collected ($12)


PokerStars Game #102617198833:  Hold'em No Limit ($3/$6 USD) - 2013/08/11 14:28:07 ET
Table 'Tanete V 40-100 bb' 6-max Seat #3 is the button
Seat 3: borntotilt ($1136.70 in chips) 
Seat 6: teunuss ($742.50 in chips) 
borntotilt: posts small blind $3
teunuss: posts big blind $6
*** HOLE CARDS ***
borntotilt: raises $6 to $12
teunuss: calls $6
*** FLOP *** [7d 4d 9s]
teunuss: checks 
borntotilt: bets $18
teunuss: folds 
Uncalled bet ($18) returned to borntotilt
borntotilt collected $23.50 from pot
borntotilt: doesn't show hand 
*** SUMMARY ***
Total pot $24 | Rake $0.50 
Board [7d 4d 9s]
Seat 3: borntotilt (button) (small blind) collected ($23.50)
Seat 6: teunuss (big blind) folded on the Flop


PokerStars Game #102617212422:  Hold'em No Limit ($3/$6 USD) - 2013/08/11 14:28:23 ET
Table 'Tanete V 40-100 bb' 6-max Seat #6 is the button
Seat 3: borntotilt ($1148.20 in chips) 
Seat 6: teunuss ($730.50 in chips) 
teunuss: posts small blind $3
borntotilt: posts big blind $6
*** HOLE CARDS ***
teunuss: raises $6 to $12
borntotilt: calls $6
*** FLOP *** [6h 3h Tc]
borntotilt: checks 
teunuss: bets $15
borntotilt: calls $15
*** TURN *** [6h 3h Tc] [Ks]
borntotilt: checks 
teunuss: bets $39
borntotilt: raises $99 to $138
teunuss: calls $99
*** RIVER *** [6h 3h Tc Ks] [7h]
borntotilt: bets $276
teunuss: folds 
Uncalled bet ($276) returned to borntotilt
borntotilt collected $329.50 from pot
borntotilt: doesn't show hand 
*** SUMMARY ***
Total pot $330 | Rake $0.50 
Board [6h 3h Tc Ks 7h]
Seat 3: borntotilt (big blind) collected ($329.50)
Seat 6: teunuss (button) (small blind) folded on the River


PokerStars Game #102616798209:  Hold'em No Limit ($3/$6 USD) - 2013/08/11 14:20:20 ET
Table 'Tanete V 40-100 bb' 6-max Seat #3 is the button
Seat 3: borntotilt ($1283.70 in chips) 
Seat 6: teunuss ($600 in chips) 
borntotilt: posts small blind $3
teunuss: posts big blind $6
*** HOLE CARDS ***
borntotilt: raises $6 to $12
teunuss: calls $6
*** FLOP *** [Kh Kd 2s]
teunuss: checks 
borntotilt: checks 
*** TURN *** [Kh Kd 2s] [2h]
teunuss: checks 
borntotilt: checks 
*** RIVER *** [Kh Kd 2s 2h] [9c]
teunuss: checks 
borntotilt: checks 
*** SHOW DOWN ***
teunuss: shows [7h Jd] (two pair, Kings and Deuces)
borntotilt: mucks hand 
teunuss collected $23.50 from pot
*** SUMMARY ***
Total pot $24 | Rake $0.50 
Board [Kh Kd 2s 2h 9c]
Seat 3: borntotilt (button) (small blind) mucked
Seat 6: teunuss (big blind) showed [7h Jd] and won ($23.50) with two pair, Kings and Deuces


PokerStars Game #102616822495:  Hold'em No Limit ($3/$6 USD) - 2013/08/11 14:20:48 ET
Table 'Tanete V 40-100 bb' 6-max Seat #6 is the button
Seat 3: borntotilt ($1271.70 in chips) 
Seat 6: teunuss ($611.50 in chips) 
teunuss: posts small blind $3
borntotilt: posts big blind $6
*** HOLE CARDS ***
teunuss: raises $6 to $12
borntotilt: calls $6
*** FLOP *** [6s 6h Qh]
borntotilt: checks 
teunuss: checks 
*** TURN *** [6s 6h Qh] [5h]
borntotilt: checks 
teunuss: bets $15
borntotilt: folds 
Uncalled bet ($15) returned to teunuss
teunuss collected $23.50 from pot
teunuss: doesn't show hand 
*** SUMMARY ***
Total pot $24 | Rake $0.50 
Board [6s 6h Qh 5h]
Seat 3: borntotilt (big blind) folded on the Turn
Seat 6: teunuss (button) (small blind) collected ($23.50)


PokerStars Game #102616863216:  Hold'em No Limit ($3/$6 USD) - 2013/08/11 14:21:35 ET
Table 'Tanete V 40-100 bb' 6-max Seat #3 is the button
Seat 3: borntotilt ($1259.70 in chips) 
Seat 6: teunuss ($623 in chips) 
borntotilt: posts small blind $3
teunuss: posts big blind $6
*** HOLE CARDS ***
borntotilt: raises $6 to $12
teunuss: calls $6
*** FLOP *** [9c Th Jc]
teunuss: checks 
borntotilt: checks 
*** TURN *** [9c Th Jc] [7h]
teunuss: bets $18
borntotilt: folds 
Uncalled bet ($18) returned to teunuss
teunuss collected $23.50 from pot
teunuss: doesn't show hand 
*** SUMMARY ***
Total pot $24 | Rake $0.50 
Board [9c Th Jc 7h]
Seat 3: borntotilt (button) (small blind) folded on the Turn
Seat 6: teunuss (big blind) collected ($23.50)


PokerStars Game #102616879522:  Hold'em No Limit ($3/$6 USD) - 2013/08/11 14:21:54 ET
Table 'Tanete V 40-100 bb' 6-max Seat #6 is the button
Seat 3: borntotilt ($1247.70 in chips) 
Seat 6: teunuss ($634.50 in chips) 
teunuss: posts small blind $3
borntotilt: posts big blind $6
*** HOLE CARDS ***
teunuss: raises $6 to $12
borntotilt: raises $36 to $48
teunuss: calls $36
*** FLOP *** [5d 3d 9c]
borntotilt: bets $56
teunuss: calls $56
*** TURN *** [5d 3d 9c] [3s]
borntotilt: checks 
teunuss: bets $120
borntotilt: folds 
Uncalled bet ($120) returned to teunuss
teunuss collected $207.50 from pot
teunuss: doesn't show hand 
*** SUMMARY ***
Total pot $208 | Rake $0.50 
Board [5d 3d 9c 3s]
Seat 3: borntotilt (big blind) folded on the Turn
Seat 6: teunuss (button) (small blind) collected ($207.50)


PokerStars Game #102616916072:  Hold'em No Limit ($3/$6 USD) - 2013/08/11 14:22:36 ET
Table 'Tanete V 40-100 bb' 6-max Seat #3 is the button
Seat 3: borntotilt ($1143.70 in chips) 
Seat 6: teunuss ($738 in chips) 
borntotilt: posts small blind $3
teunuss: posts big blind $6
*** HOLE CARDS ***
borntotilt: raises $6 to $12
teunuss: raises $33 to $45
borntotilt: folds 
Uncalled bet ($33) returned to teunuss
teunuss collected $24 from pot
teunuss: doesn't show hand 
*** SUMMARY ***
Total pot $24 | Rake $0 
Seat 3: borntotilt (button) (small blind) folded before Flop
Seat 6: teunuss (big blind) collected ($24)


PokerStars Game #102616936641:  Hold'em No Limit ($3/$6 USD) - 2013/08/11 14:23:00 ET
Table 'Tanete V 40-100 bb' 6-max Seat #6 is the button
Seat 3: borntotilt ($1131.70 in chips) 
Seat 6: teunuss ($750 in chips) 
teunuss: posts small blind $3
borntotilt: posts big blind $6
*** HOLE CARDS ***
teunuss: raises $6 to $12
borntotilt: raises $36 to $48
teunuss: folds 
Uncalled bet ($36) returned to borntotilt
borntotilt collected $24 from pot
borntotilt: doesn't show hand 
*** SUMMARY ***
Total pot $24 | Rake $0 
Seat 3: borntotilt (big blind) collected ($24)
Seat 6: teunuss (button) (small blind) folded before Flop


PokerStars Game #102616949319:  Hold'em No Limit ($3/$6 USD) - 2013/08/11 14:23:15 ET
Table 'Tanete V 40-100 bb' 6-max Seat #3 is the button
Seat 3: borntotilt ($1143.70 in chips) 
Seat 6: teunuss ($738 in chips) 
borntotilt: posts small blind $3
teunuss: posts big blind $6
*** HOLE CARDS ***
borntotilt: raises $6 to $12
teunuss: raises $33 to $45
borntotilt: calls $33
*** FLOP *** [Ad Jh 6h]
teunuss: bets $51
borntotilt: folds 
Uncalled bet ($51) returned to teunuss
teunuss collected $89.50 from pot
teunuss: doesn't show hand 
*** SUMMARY ***
Total pot $90 | Rake $0.50 
Board [Ad Jh 6h]
Seat 3: borntotilt (button) (small blind) folded on the Flop
Seat 6: teunuss (big blind) collected ($89.50)


PokerStars Game #102616985175:  Hold'em No Limit ($3/$6 USD) - 2013/08/11 14:23:56 ET
Table 'Tanete V 40-100 bb' 6-max Seat #6 is the button
Seat 3: borntotilt ($1098.70 in chips) 
Seat 6: teunuss ($782.50 in chips) 
teunuss: posts small blind $3
borntotilt: posts big blind $6
*** HOLE CARDS ***
teunuss: folds 
Uncalled bet ($3) returned to borntotilt
borntotilt collected $6 from pot
borntotilt: doesn't show hand 
*** SUMMARY ***
Total pot $6 | Rake $0 
Seat 3: borntotilt (big blind) collected ($6)
Seat 6: teunuss (button) (small blind) folded before Flop


PokerStars Game #102616989546:  Hold'em No Limit ($3/$6 USD) - 2013/08/11 14:24:01 ET
Table 'Tanete V 40-100 bb' 6-max Seat #3 is the button
Seat 3: borntotilt ($1101.70 in chips) 
Seat 6: teunuss ($779.50 in chips) 
borntotilt: posts small blind $3
teunuss: posts big blind $6
*** HOLE CARDS ***
borntotilt: raises $6 to $12
teunuss: folds 
Uncalled bet ($6) returned to borntotilt
borntotilt collected $12 from pot
borntotilt: doesn't show hand 
*** SUMMARY ***
Total pot $12 | Rake $0 
Seat 3: borntotilt (button) (small blind) collected ($12)
Seat 6: teunuss (big blind) folded before Flop


PokerStars Game #102616995033:  Hold'em No Limit ($3/$6 USD) - 2013/08/11 14:24:08 ET
Table 'Tanete V 40-100 bb' 6-max Seat #6 is the button
Seat 3: borntotilt ($1107.70 in chips) 
Seat 6: teunuss ($773.50 in chips) 
teunuss: posts small blind $3
borntotilt: posts big blind $6
*** HOLE CARDS ***
teunuss: raises $6 to $12
borntotilt: calls $6
*** FLOP *** [5s 8c 6c]
borntotilt: checks 
teunuss: bets $15
borntotilt: raises $39 to $54
teunuss: calls $39
*** TURN *** [5s 8c 6c] [Jd]
borntotilt: checks 
teunuss: checks 
*** RIVER *** [5s 8c 6c Jd] [Tc]
borntotilt: checks 
teunuss: checks 
*** SHOW DOWN ***
borntotilt: shows [2d Ac] (high card Ace)
teunuss: mucks hand 
borntotilt collected $131.50 from pot
*** SUMMARY ***
Total pot $132 | Rake $0.50 
Board [5s 8c 6c Jd Tc]
Seat 3: borntotilt (big blind) showed [2d Ac] and won ($131.50) with high card Ace
Seat 6: teunuss (button) (small blind) mucked


PokerStars Game #102616594964:  Hold'em No Limit ($3/$6 USD) - 2013/08/11 14:16:25 ET
Table 'Tanete V 40-100 bb' 6-max Seat #3 is the button
Seat 3: borntotilt ($921.20 in chips) 
Seat 6: teunuss ($600 in chips) 
borntotilt: posts small blind $3
teunuss: posts big blind $6
*** HOLE CARDS ***
borntotilt: raises $6 to $12
teunuss: folds 
Uncalled bet ($6) returned to borntotilt
borntotilt collected $12 from pot
borntotilt: doesn't show hand 
*** SUMMARY ***
Total pot $12 | Rake $0 
Seat 3: borntotilt (button) (small blind) collected ($12)
Seat 6: teunuss (big blind) folded before Flop


PokerStars Game #102616606648:  Hold'em No Limit ($3/$6 USD) - 2013/08/11 14:16:39 ET
Table 'Tanete V 40-100 bb' 6-max Seat #6 is the button
Seat 3: borntotilt ($927.20 in chips) 
Seat 6: teunuss ($600 in chips) 
teunuss: posts small blind $3
borntotilt: posts big blind $6
*** HOLE CARDS ***
teunuss: folds 
Uncalled bet ($3) returned to borntotilt
borntotilt collected $6 from pot
borntotilt: doesn't show hand 
*** SUMMARY ***
Total pot $6 | Rake $0 
Seat 3: borntotilt (big blind) collected ($6)
Seat 6: teunuss (button) (small blind) folded before Flop


PokerStars Game #102616611933:  Hold'em No Limit ($3/$6 USD) - 2013/08/11 14:16:45 ET
Table 'Tanete V 40-100 bb' 6-max Seat #3 is the button
Seat 3: borntotilt ($930.20 in chips) 
Seat 6: teunuss ($600 in chips) 
borntotilt: posts small blind $3
teunuss: posts big blind $6
*** HOLE CARDS ***
borntotilt: raises $6 to $12
teunuss: calls $6
*** FLOP *** [2s 5s Td]
teunuss: checks 
borntotilt: bets $18
teunuss: calls $18
*** TURN *** [2s 5s Td] [2c]
teunuss: checks 
borntotilt: bets $48
teunuss: calls $48
*** RIVER *** [2s 5s Td 2c] [Qs]
teunuss: checks 
borntotilt: bets $142
teunuss: calls $142
*** SHOW DOWN ***
borntotilt: shows [Qd Ts] (two pair, Queens and Tens)
teunuss: mucks hand 
borntotilt collected $439.50 from pot
*** SUMMARY ***
Total pot $440 | Rake $0.50 
Board [2s 5s Td 2c Qs]
Seat 3: borntotilt (button) (small blind) showed [Qd Ts] and won ($439.50) with two pair, Queens and Tens
Seat 6: teunuss (big blind) mucked


PokerStars Game #102616684146:  Hold'em No Limit ($3/$6 USD) - 2013/08/11 14:18:08 ET
Table 'Tanete V 40-100 bb' 6-max Seat #6 is the button
Seat 3: borntotilt ($1149.70 in chips) 
Seat 6: teunuss ($600 in chips) 
teunuss: posts small blind $3
borntotilt: posts big blind $6
*** HOLE CARDS ***
teunuss: folds 
Uncalled bet ($3) returned to borntotilt
borntotilt collected $6 from pot
borntotilt: doesn't show hand 
*** SUMMARY ***
Total pot $6 | Rake $0 
Seat 3: borntotilt (big blind) collected ($6)
Seat 6: teunuss (button) (small blind) folded before Flop


PokerStars Game #102616689481:  Hold'em No Limit ($3/$6 USD) - 2013/08/11 14:18:14 ET
Table 'Tanete V 40-100 bb' 6-max Seat #3 is the button
Seat 3: borntotilt ($1152.70 in chips) 
Seat 6: teunuss ($600 in chips) 
borntotilt: posts small blind $3
teunuss: posts big blind $6
*** HOLE CARDS ***
borntotilt: raises $6 to $12
teunuss: folds 
Uncalled bet ($6) returned to borntotilt
borntotilt collected $12 from pot
borntotilt: doesn't show hand 
*** SUMMARY ***
Total pot $12 | Rake $0 
Seat 3: borntotilt (button) (small blind) collected ($12)
Seat 6: teunuss (big blind) folded before Flop


PokerStars Game #102616717336:  Hold'em No Limit ($3/$6 USD) - 2013/08/11 14:18:47 ET
Table 'Tanete V 40-100 bb' 6-max Seat #6 is the button
Seat 3: borntotilt ($1158.70 in chips) 
Seat 6: teunuss ($600 in chips) 
teunuss: posts small blind $3
borntotilt: posts big blind $6
*** HOLE CARDS ***
teunuss: raises $6 to $12
borntotilt: raises $36 to $48
teunuss: folds 
Uncalled bet ($36) returned to borntotilt
borntotilt collected $24 from pot
borntotilt: doesn't show hand 
*** SUMMARY ***
Total pot $24 | Rake $0 
Seat 3: borntotilt (big blind) collected ($24)
Seat 6: teunuss (button) (small blind) folded before Flop


PokerStars Game #102616729356:  Hold'em No Limit ($3/$6 USD) - 2013/08/11 14:19:01 ET
Table 'Tanete V 40-100 bb' 6-max Seat #3 is the button
Seat 3: borntotilt ($1170.70 in chips) 
Seat 6: teunuss ($600 in chips) 
borntotilt: posts small blind $3
teunuss: posts big blind $6
*** HOLE CARDS ***
borntotilt: raises $6 to $12
teunuss: calls $6
*** FLOP *** [3c 2d As]
teunuss: checks 
borntotilt: checks 
*** TURN *** [3c 2d As] [Jd]
teunuss: checks 
borntotilt: bets $18
teunuss: folds 
Uncalled bet ($18) returned to borntotilt
borntotilt collected $23.50 from pot
borntotilt: doesn't show hand 
*** SUMMARY ***
Total pot $24 | Rake $0.50 
Board [3c 2d As Jd]
Seat 3: borntotilt (button) (small blind) collected ($23.50)
Seat 6: teunuss (big blind) folded on the Turn


PokerStars Game #102616747279:  Hold'em No Limit ($3/$6 USD) - 2013/08/11 14:19:21 ET
Table 'Tanete V 40-100 bb' 6-max Seat #6 is the button
Seat 3: borntotilt ($1182.20 in chips) 
Seat 6: teunuss ($600 in chips) 
teunuss: posts small blind $3
borntotilt: posts big blind $6
*** HOLE CARDS ***
teunuss: raises $6 to $12
borntotilt: raises $36 to $48
teunuss: calls $36
*** FLOP *** [Kh 2d Kc]
borntotilt: bets $54
teunuss: calls $54
*** TURN *** [Kh 2d Kc] [Td]
borntotilt: bets $116
teunuss: folds 
Uncalled bet ($116) returned to borntotilt
borntotilt collected $203.50 from pot
borntotilt: doesn't show hand 
*** SUMMARY ***
Total pot $204 | Rake $0.50 
Board [Kh 2d Kc Td]
Seat 3: borntotilt (big blind) collected ($203.50)
Seat 6: teunuss (button) (small blind) folded on the Turn


PokerStars Game #102618115427:  Hold'em No Limit ($3/$6 USD) - 2013/08/11 14:45:09 ET
Table 'Tanete V 40-100 bb' 6-max Seat #6 is the button
Seat 3: borntotilt ($664.20 in chips) 
Seat 6: teunuss ($1046.50 in chips) 
teunuss: posts small blind $3
Subv: is sitting out 
Subv leaves the table
borntotilt: posts big blind $6
*** HOLE CARDS ***
teunuss: raises $6 to $12
borntotilt: calls $6
*** FLOP *** [4h 4d 8c]
borntotilt: checks 
teunuss: checks 
*** TURN *** [4h 4d 8c] [3s]
borntotilt: bets $18
teunuss: folds 
Uncalled bet ($18) returned to borntotilt
borntotilt collected $23.50 from pot
borntotilt: doesn't show hand 
*** SUMMARY ***
Total pot $24 | Rake $0.50 
Board [4h 4d 8c 3s]
Seat 3: borntotilt (big blind) collected ($23.50)
Seat 6: teunuss (button) (small blind) folded on the Turn


PokerStars Game #102618134813:  Hold'em No Limit ($3/$6 USD) - 2013/08/11 14:45:31 ET
Table 'Tanete V 40-100 bb' 6-max Seat #3 is the button
Seat 3: borntotilt ($675.70 in chips) 
Seat 6: teunuss ($1034.50 in chips) 
borntotilt: posts small blind $3
teunuss: posts big blind $6
*** HOLE CARDS ***
borntotilt: folds 
Uncalled bet ($3) returned to teunuss
teunuss collected $6 from pot
teunuss: doesn't show hand 
*** SUMMARY ***
Total pot $6 | Rake $0 
Seat 3: borntotilt (button) (small blind) folded before Flop
Seat 6: teunuss (big blind) collected ($6)


PokerStars Game #102618144313:  Hold'em No Limit ($3/$6 USD) - 2013/08/11 14:45:41 ET
Table 'Tanete V 40-100 bb' 6-max Seat #6 is the button
Seat 3: borntotilt ($672.70 in chips) 
Seat 6: teunuss ($1037.50 in chips) 
teunuss: posts small blind $3
borntotilt: posts big blind $6
*** HOLE CARDS ***
teunuss: folds 
Uncalled bet ($3) returned to borntotilt
borntotilt collected $6 from pot
borntotilt: doesn't show hand 
*** SUMMARY ***
Total pot $6 | Rake $0 
Seat 3: borntotilt (big blind) collected ($6)
Seat 6: teunuss (button) (small blind) folded before Flop


PokerStars Game #102618150790:  Hold'em No Limit ($3/$6 USD) - 2013/08/11 14:45:48 ET
Table 'Tanete V 40-100 bb' 6-max Seat #3 is the button
Seat 3: borntotilt ($675.70 in chips) 
Seat 6: teunuss ($1034.50 in chips) 
borntotilt: posts small blind $3
teunuss: posts big blind $6
*** HOLE CARDS ***
borntotilt: raises $6 to $12
teunuss: folds 
Uncalled bet ($6) returned to borntotilt
borntotilt collected $12 from pot
borntotilt: doesn't show hand 
*** SUMMARY ***
Total pot $12 | Rake $0 
Seat 3: borntotilt (button) (small blind) collected ($12)
Seat 6: teunuss (big blind) folded before Flop


PokerStars Game #102618157721:  Hold'em No Limit ($3/$6 USD) - 2013/08/11 14:45:56 ET
Table 'Tanete V 40-100 bb' 6-max Seat #6 is the button
Seat 3: borntotilt ($681.70 in chips) 
Seat 6: teunuss ($1028.50 in chips) 
teunuss: posts small blind $3
borntotilt: posts big blind $6
*** HOLE CARDS ***
teunuss: raises $6 to $12
borntotilt: raises $36 to $48
teunuss: folds 
Uncalled bet ($36) returned to borntotilt
borntotilt collected $24 from pot
borntotilt: doesn't show hand 
*** SUMMARY ***
Total pot $24 | Rake $0 
Seat 3: borntotilt (big blind) collected ($24)
Seat 6: teunuss (button) (small blind) folded before Flop


PokerStars Game #102618168172:  Hold'em No Limit ($3/$6 USD) - 2013/08/11 14:46:07 ET
Table 'Tanete V 40-100 bb' 6-max Seat #3 is the button
Seat 3: borntotilt ($693.70 in chips) 
Seat 6: teunuss ($1016.50 in chips) 
borntotilt: posts small blind $3
teunuss: posts big blind $6
*** HOLE CARDS ***
borntotilt: raises $6 to $12
teunuss: folds 
Uncalled bet ($6) returned to borntotilt
borntotilt collected $12 from pot
borntotilt: doesn't show hand 
*** SUMMARY ***
Total pot $12 | Rake $0 
Seat 3: borntotilt (button) (small blind) collected ($12)
Seat 6: teunuss (big blind) folded before Flop


PokerStars Game #102618181014:  Hold'em No Limit ($3/$6 USD) - 2013/08/11 14:46:22 ET
Table 'Tanete V 40-100 bb' 6-max Seat #6 is the button
Seat 3: borntotilt ($699.70 in chips) 
Seat 6: teunuss ($1010.50 in chips) 
teunuss: posts small blind $3
borntotilt: posts big blind $6
*** HOLE CARDS ***
teunuss: folds 
Uncalled bet ($3) returned to borntotilt
borntotilt collected $6 from pot
borntotilt: doesn't show hand 
*** SUMMARY ***
Total pot $6 | Rake $0 
Seat 3: borntotilt (big blind) collected ($6)
Seat 6: teunuss (button) (small blind) folded before Flop


PokerStars Game #102618185626:  Hold'em No Limit ($3/$6 USD) - 2013/08/11 14:46:27 ET
Table 'Tanete V 40-100 bb' 6-max Seat #3 is the button
Seat 3: borntotilt ($702.70 in chips) 
Seat 6: teunuss ($1007.50 in chips) 
borntotilt: posts small blind $3
teunuss: posts big blind $6
*** HOLE CARDS ***
borntotilt: raises $6 to $12
teunuss: calls $6
*** FLOP *** [7d Ts 2d]
teunuss: checks 
borntotilt: bets $18
teunuss: calls $18
*** TURN *** [7d Ts 2d] [Jc]
teunuss: checks 
borntotilt: bets $48
teunuss: calls $48
*** RIVER *** [7d Ts 2d Jc] [2c]
teunuss: checks 
borntotilt: bets $142
teunuss: calls $142
*** SHOW DOWN ***
borntotilt: shows [6s 8s] (a pair of Deuces)
teunuss: shows [Qc Jh] (two pair, Jacks and Deuces)
teunuss collected $439.50 from pot
*** SUMMARY ***
Total pot $440 | Rake $0.50 
Board [7d Ts 2d Jc 2c]
Seat 3: borntotilt (button) (small blind) showed [6s 8s] and lost with a pair of Deuces
Seat 6: teunuss (big blind) showed [Qc Jh] and won ($439.50) with two pair, Jacks and Deuces


PokerStars Game #102618235557:  Hold'em No Limit ($3/$6 USD) - 2013/08/11 14:47:22 ET
Table 'Tanete V 40-100 bb' 6-max Seat #6 is the button
Seat 3: borntotilt ($600 in chips) 
Seat 6: teunuss ($1227 in chips) 
teunuss: posts small blind $3
borntotilt: posts big blind $6
*** HOLE CARDS ***
teunuss: folds 
Uncalled bet ($3) returned to borntotilt
borntotilt collected $6 from pot
borntotilt: doesn't show hand 
*** SUMMARY ***
Total pot $6 | Rake $0 
Seat 3: borntotilt (big blind) collected ($6)
Seat 6: teunuss (button) (small blind) folded before Flop


PokerStars Game #102618239090:  Hold'em No Limit ($3/$6 USD) - 2013/08/11 14:47:26 ET
Table 'Tanete V 40-100 bb' 6-max Seat #3 is the button
Seat 3: borntotilt ($603 in chips) 
Seat 6: teunuss ($1224 in chips) 
borntotilt: posts small blind $3
teunuss: posts big blind $6
*** HOLE CARDS ***
borntotilt: raises $6 to $12
teunuss: calls $6
*** FLOP *** [3d Qc 2s]
teunuss: checks 
borntotilt: checks 
*** TURN *** [3d Qc 2s] [Th]
teunuss: bets $18
borntotilt: calls $18
*** RIVER *** [3d Qc 2s Th] [6c]
teunuss: checks 
borntotilt: checks 
*** SHOW DOWN ***
teunuss: shows [7d Td] (a pair of Tens)
borntotilt: mucks hand 
teunuss collected $59.50 from pot
*** SUMMARY ***
Total pot $60 | Rake $0.50 
Board [3d Qc 2s Th 6c]
Seat 3: borntotilt (button) (small blind) mucked
Seat 6: teunuss (big blind) showed [7d Td] and won ($59.50) with a pair of Tens


PokerStars Game #102618276514:  Hold'em No Limit ($3/$6 USD) - 2013/08/11 14:48:08 ET
Table 'Tanete V 40-100 bb' 6-max Seat #6 is the button
Seat 3: borntotilt ($600 in chips) 
Seat 6: teunuss ($1253.50 in chips) 
teunuss: posts small blind $3
borntotilt: posts big blind $6
*** HOLE CARDS ***
teunuss: folds 
Uncalled bet ($3) returned to borntotilt
borntotilt collected $6 from pot
borntotilt: doesn't show hand 
*** SUMMARY ***
Total pot $6 | Rake $0 
Seat 3: borntotilt (big blind) collected ($6)
Seat 6: teunuss (button) (small blind) folded before Flop


PokerStars Game #102618280138:  Hold'em No Limit ($3/$6 USD) - 2013/08/11 14:48:12 ET
Table 'Tanete V 40-100 bb' 6-max Seat #3 is the button
Seat 3: borntotilt ($603 in chips) 
Seat 6: teunuss ($1250.50 in chips) 
borntotilt: posts small blind $3
teunuss: posts big blind $6
*** HOLE CARDS ***
borntotilt: raises $6 to $12
teunuss: calls $6
*** FLOP *** [3h 4d 9h]
teunuss: checks 
borntotilt: checks 
*** TURN *** [3h 4d 9h] [2s]
teunuss: bets $18
borntotilt: calls $18
*** RIVER *** [3h 4d 9h 2s] [4h]
teunuss: checks 
borntotilt: checks 
*** SHOW DOWN ***
teunuss: shows [3c Ac] (two pair, Fours and Threes)
borntotilt: mucks hand 
teunuss collected $59.50 from pot
*** SUMMARY ***
Total pot $60 | Rake $0.50 
Board [3h 4d 9h 2s 4h]
Seat 3: borntotilt (button) (small blind) mucked
Seat 6: teunuss (big blind) showed [3c Ac] and won ($59.50) with two pair, Fours and Threes


PokerStars Game #102618316371:  Hold'em No Limit ($3/$6 USD) - 2013/08/11 14:48:53 ET
Table 'Tanete V 40-100 bb' 6-max Seat #6 is the button
Seat 3: borntotilt ($600 in chips) 
Seat 6: teunuss ($1280 in chips) 
teunuss: posts small blind $3
borntotilt: posts big blind $6
*** HOLE CARDS ***
teunuss: folds 
Uncalled bet ($3) returned to borntotilt
borntotilt collected $6 from pot
borntotilt: doesn't show hand 
*** SUMMARY ***
Total pot $6 | Rake $0 
Seat 3: borntotilt (big blind) collected ($6)
Seat 6: teunuss (button) (small blind) folded before Flop


PokerStars Game #102618319894:  Hold'em No Limit ($3/$6 USD) - 2013/08/11 14:48:57 ET
Table 'Tanete V 40-100 bb' 6-max Seat #3 is the button
Seat 3: borntotilt ($603 in chips) 
Seat 6: teunuss ($1277 in chips) 
borntotilt: posts small blind $3
teunuss: posts big blind $6
*** HOLE CARDS ***
borntotilt: raises $6 to $12
teunuss: raises $33 to $45
borntotilt: folds 
Uncalled bet ($33) returned to teunuss
teunuss collected $24 from pot
teunuss: doesn't show hand 
*** SUMMARY ***
Total pot $24 | Rake $0 
Seat 3: borntotilt (button) (small blind) folded before Flop
Seat 6: teunuss (big blind) collected ($24)


PokerStars Game #102618332272:  Hold'em No Limit ($3/$6 USD) - 2013/08/11 14:49:11 ET
Table 'Tanete V 40-100 bb' 6-max Seat #6 is the button
Seat 3: borntotilt ($600 in chips) 
Seat 6: teunuss ($1289 in chips) 
teunuss: posts small blind $3
borntotilt: posts big blind $6
*** HOLE CARDS ***
teunuss: raises $6 to $12
borntotilt: calls $6
*** FLOP *** [3h 2d 4h]
borntotilt: checks 
teunuss: bets $15
borntotilt: calls $15
*** TURN *** [3h 2d 4h] [Kh]
borntotilt: checks 
teunuss: bets $39
borntotilt: calls $39
*** RIVER *** [3h 2d 4h Kh] [Kd]
borntotilt: checks 
teunuss: checks 
*** SHOW DOWN ***
borntotilt: shows [Ks 6c] (three of a kind, Kings)
teunuss: mucks hand 
borntotilt collected $131.50 from pot
*** SUMMARY ***
Total pot $132 | Rake $0.50 
Board [3h 2d 4h Kh Kd]
Seat 3: borntotilt (big blind) showed [Ks 6c] and won ($131.50) with three of a kind, Kings
Seat 6: teunuss (button) (small blind) mucked


PokerStars Game #102617923772:  Hold'em No Limit ($3/$6 USD) - 2013/08/11 14:41:36 ET
Table 'Tanete V 40-100 bb' 6-max Seat #3 is the button
Seat 2: Subv ($600 in chips) 
Seat 3: borntotilt ($1000.20 in chips) 
Seat 6: teunuss ($1046.50 in chips) 
teunuss: posts small blind $3
Subv: posts big blind $6
*** HOLE CARDS ***
WhatA298 leaves the table
borntotilt: raises $6 to $12
teunuss: folds 
WhatA298 joins the table at seat #5 
Subv: calls $6
*** FLOP *** [3c 6s Td]
Subv: checks 
borntotilt: bets $18
WhatA298 leaves the table
Subv: calls $18
*** TURN *** [3c 6s Td] [7s]
Subv: checks 
borntotilt: bets $54
Subv: calls $54
*** RIVER *** [3c 6s Td 7s] [2h]
Subv: checks 
borntotilt: checks 
*** SHOW DOWN ***
Subv: shows [9c Th] (a pair of Tens)
borntotilt: mucks hand 
Subv collected $169.50 from pot
*** SUMMARY ***
Total pot $171 | Rake $1.50 
Board [3c 6s Td 7s 2h]
Seat 2: Subv (big blind) showed [9c Th] and won ($169.50) with a pair of Tens
Seat 3: borntotilt (button) mucked
Seat 6: teunuss (small blind) folded before Flop


PokerStars Game #102617982040:  Hold'em No Limit ($3/$6 USD) - 2013/08/11 14:42:41 ET
Table 'Tanete V 40-100 bb' 6-max Seat #6 is the button
Seat 2: Subv ($685.50 in chips) 
Seat 3: borntotilt ($916.20 in chips) 
Seat 6: teunuss ($1043.50 in chips) 
Subv: posts small blind $3
borntotilt: posts big blind $6
*** HOLE CARDS ***
teunuss: raises $6 to $12
Subv: folds 
borntotilt: folds 
Uncalled bet ($6) returned to teunuss
teunuss collected $15 from pot
teunuss: doesn't show hand 
*** SUMMARY ***
Total pot $15 | Rake $0 
Seat 2: Subv (small blind) folded before Flop
Seat 3: borntotilt (big blind) folded before Flop
Seat 6: teunuss (button) collected ($15)


PokerStars Game #102618007133:  Hold'em No Limit ($3/$6 USD) - 2013/08/11 14:43:09 ET
Table 'Tanete V 40-100 bb' 6-max Seat #2 is the button
Seat 2: Subv ($682.50 in chips) 
Seat 3: borntotilt ($910.20 in chips) 
Seat 6: teunuss ($1052.50 in chips) 
borntotilt: posts small blind $3
teunuss: posts big blind $6
*** HOLE CARDS ***
Subv: raises $6.30 to $12.30
borntotilt: raises $35.70 to $48
teunuss: folds 
Subv: raises $66 to $114
borntotilt: calls $66
*** FLOP *** [4s Kd 3h]
borntotilt: checks 
Subv: bets $45
borntotilt: calls $45
*** TURN *** [4s Kd 3h] [4d]
borntotilt: checks 
Subv: bets $87
borntotilt: calls $87
*** RIVER *** [4s Kd 3h 4d] [Ad]
borntotilt: checks 
Subv: checks 
*** SHOW DOWN ***
borntotilt: shows [8c 8h] (two pair, Eights and Fours)
Subv: shows [Qd Qh] (two pair, Queens and Fours)
Subv collected $496.50 from pot
*** SUMMARY ***
Total pot $498 | Rake $1.50 
Board [4s Kd 3h 4d Ad]
Seat 2: Subv (button) showed [Qd Qh] and won ($496.50) with two pair, Queens and Fours
Seat 3: borntotilt (small blind) showed [8c 8h] and lost with two pair, Eights and Fours
Seat 6: teunuss (big blind) folded before Flop


PokerStars Game #102617871413:  Hold'em No Limit ($3/$6 USD) - 2013/08/11 14:40:38 ET
Table 'Tanete V 40-100 bb' 6-max Seat #6 is the button
Seat 3: borntotilt ($1217.20 in chips) 
Seat 6: teunuss ($830 in chips) 
teunuss: posts small blind $3
borntotilt: posts big blind $6
*** HOLE CARDS ***
teunuss: folds 
Uncalled bet ($3) returned to borntotilt
borntotilt collected $6 from pot
borntotilt: doesn't show hand 
*** SUMMARY ***
Total pot $6 | Rake $0 
Seat 3: borntotilt (big blind) collected ($6)
Seat 6: teunuss (button) (small blind) folded before Flop


PokerStars Game #102617875728:  Hold'em No Limit ($3/$6 USD) - 2013/08/11 14:40:43 ET
Table 'Tanete V 40-100 bb' 6-max Seat #3 is the button
Seat 3: borntotilt ($1220.20 in chips) 
Seat 6: teunuss ($827 in chips) 
borntotilt: posts small blind $3
teunuss: posts big blind $6
*** HOLE CARDS ***
borntotilt: raises $6 to $12
teunuss: calls $6
*** FLOP *** [7s 2c 3s]
teunuss: checks 
borntotilt: bets $18
teunuss: calls $18
*** TURN *** [7s 2c 3s] [4s]
teunuss: checks 
borntotilt: bets $48
teunuss: calls $48
*** RIVER *** [7s 2c 3s 4s] [Kd]
teunuss: checks 
WhatA298 joins the table at seat #1 
Subv joins the table at seat #2 
borntotilt: bets $142
teunuss: calls $142
*** SHOW DOWN ***
borntotilt: shows [6d Kc] (a pair of Kings)
teunuss: shows [Ks 7c] (two pair, Kings and Sevens)
teunuss collected $439.50 from pot
*** SUMMARY ***
Total pot $440 | Rake $0.50 
Board [7s 2c 3s 4s Kd]
Seat 3: borntotilt (button) (small blind) showed [6d Kc] and lost with a pair of Kings
Seat 6: teunuss (big blind) showed [Ks 7c] and won ($439.50) with two pair, Kings and Sevens


PokerStars Game #102617572629:  Hold'em No Limit ($3/$6 USD) - 2013/08/11 14:35:07 ET
Table 'Tanete V 40-100 bb' 6-max Seat #6 is the button
Seat 3: borntotilt ($1382.70 in chips) 
Seat 6: teunuss ($617.50 in chips) 
teunuss: posts small blind $3
borntotilt: posts big blind $6
*** HOLE CARDS ***
teunuss: raises $6 to $12
borntotilt: calls $6
*** FLOP *** [Jd 9c 5s]
borntotilt: checks 
teunuss: checks 
*** TURN *** [Jd 9c 5s] [Tc]
borntotilt: checks 
teunuss: checks 
*** RIVER *** [Jd 9c 5s Tc] [Ts]
borntotilt: checks 
teunuss: bets $15
borntotilt: folds 
Uncalled bet ($15) returned to teunuss
teunuss collected $23.50 from pot
teunuss: doesn't show hand 
*** SUMMARY ***
Total pot $24 | Rake $0.50 
Board [Jd 9c 5s Tc Ts]
Seat 3: borntotilt (big blind) folded on the River
Seat 6: teunuss (button) (small blind) collected ($23.50)


PokerStars Game #102617621208:  Hold'em No Limit ($3/$6 USD) - 2013/08/11 14:36:00 ET
Table 'Tanete V 40-100 bb' 6-max Seat #3 is the button
Seat 3: borntotilt ($1370.70 in chips) 
Seat 6: teunuss ($629 in chips) 
borntotilt: posts small blind $3
teunuss: posts big blind $6
*** HOLE CARDS ***
borntotilt: raises $6 to $12
teunuss: folds 
Uncalled bet ($6) returned to borntotilt
borntotilt collected $12 from pot
borntotilt: doesn't show hand 
*** SUMMARY ***
Total pot $12 | Rake $0 
Seat 3: borntotilt (button) (small blind) collected ($12)
Seat 6: teunuss (big blind) folded before Flop


PokerStars Game #102617630782:  Hold'em No Limit ($3/$6 USD) - 2013/08/11 14:36:11 ET
Table 'Tanete V 40-100 bb' 6-max Seat #6 is the button
Seat 3: borntotilt ($1376.70 in chips) 
Seat 6: teunuss ($623 in chips) 
teunuss: posts small blind $3
borntotilt: posts big blind $6
*** HOLE CARDS ***
teunuss: raises $6 to $12
borntotilt: calls $6
*** FLOP *** [8d 2s 6c]
borntotilt: checks 
teunuss: bets $15
borntotilt: calls $15
*** TURN *** [8d 2s 6c] [Qd]
borntotilt: checks 
teunuss: bets $39
borntotilt: raises $99 to $138
teunuss: folds 
Uncalled bet ($99) returned to borntotilt
borntotilt collected $131.50 from pot
borntotilt: doesn't show hand 
*** SUMMARY ***
Total pot $132 | Rake $0.50 
Board [8d 2s 6c Qd]
Seat 3: borntotilt (big blind) collected ($131.50)
Seat 6: teunuss (button) (small blind) folded on the Turn


PokerStars Game #102617664105:  Hold'em No Limit ($3/$6 USD) - 2013/08/11 14:36:47 ET
Table 'Tanete V 40-100 bb' 6-max Seat #3 is the button
Seat 3: borntotilt ($1442.20 in chips) 
Seat 6: teunuss ($600 in chips) 
borntotilt: posts small blind $3
teunuss: posts big blind $6
*** HOLE CARDS ***
borntotilt: raises $6 to $12
teunuss: folds 
Uncalled bet ($6) returned to borntotilt
borntotilt collected $12 from pot
borntotilt: doesn't show hand 
*** SUMMARY ***
Total pot $12 | Rake $0 
Seat 3: borntotilt (button) (small blind) collected ($12)
Seat 6: teunuss (big blind) folded before Flop


PokerStars Game #102617671864:  Hold'em No Limit ($3/$6 USD) - 2013/08/11 14:36:56 ET
Table 'Tanete V 40-100 bb' 6-max Seat #6 is the button
Seat 3: borntotilt ($1448.20 in chips) 
Seat 6: teunuss ($600 in chips) 
teunuss: posts small blind $3
borntotilt: posts big blind $6
*** HOLE CARDS ***
teunuss: raises $6 to $12
borntotilt: folds 
Uncalled bet ($6) returned to teunuss
teunuss collected $12 from pot
teunuss: doesn't show hand 
*** SUMMARY ***
Total pot $12 | Rake $0 
Seat 3: borntotilt (big blind) folded before Flop
Seat 6: teunuss (button) (small blind) collected ($12)


PokerStars Game #102617681349:  Hold'em No Limit ($3/$6 USD) - 2013/08/11 14:37:06 ET
Table 'Tanete V 40-100 bb' 6-max Seat #3 is the button
Seat 3: borntotilt ($1442.20 in chips) 
Seat 6: teunuss ($606 in chips) 
borntotilt: posts small blind $3
teunuss: posts big blind $6
*** HOLE CARDS ***
borntotilt: raises $6 to $12
teunuss: raises $33 to $45
borntotilt: folds 
Uncalled bet ($33) returned to teunuss
teunuss collected $24 from pot
teunuss: doesn't show hand 
*** SUMMARY ***
Total pot $24 | Rake $0 
Seat 3: borntotilt (button) (small blind) folded before Flop
Seat 6: teunuss (big blind) collected ($24)


PokerStars Game #102617707123:  Hold'em No Limit ($3/$6 USD) - 2013/08/11 14:37:35 ET
Table 'Tanete V 40-100 bb' 6-max Seat #6 is the button
Seat 3: borntotilt ($1430.20 in chips) 
Seat 6: teunuss ($618 in chips) 
teunuss: posts small blind $3
borntotilt: posts big blind $6
*** HOLE CARDS ***
teunuss: raises $6 to $12
borntotilt: calls $6
*** FLOP *** [4d Ts 3d]
borntotilt: checks 
teunuss: bets $15
borntotilt: folds 
Uncalled bet ($15) returned to teunuss
teunuss collected $23.50 from pot
teunuss: doesn't show hand 
*** SUMMARY ***
Total pot $24 | Rake $0.50 
Board [4d Ts 3d]
Seat 3: borntotilt (big blind) folded on the Flop
Seat 6: teunuss (button) (small blind) collected ($23.50)


PokerStars Game #102617723911:  Hold'em No Limit ($3/$6 USD) - 2013/08/11 14:37:54 ET
Table 'Tanete V 40-100 bb' 6-max Seat #3 is the button
Seat 3: borntotilt ($1418.20 in chips) 
Seat 6: teunuss ($629.50 in chips) 
borntotilt: posts small blind $3
teunuss: posts big blind $6
*** HOLE CARDS ***
borntotilt: raises $6 to $12
teunuss: folds 
Uncalled bet ($6) returned to borntotilt
borntotilt collected $12 from pot
borntotilt: doesn't show hand 
*** SUMMARY ***
Total pot $12 | Rake $0 
Seat 3: borntotilt (button) (small blind) collected ($12)
Seat 6: teunuss (big blind) folded before Flop


PokerStars Game #102617739486:  Hold'em No Limit ($3/$6 USD) - 2013/08/11 14:38:11 ET
Table 'Tanete V 40-100 bb' 6-max Seat #6 is the button
Seat 3: borntotilt ($1424.20 in chips) 
Seat 6: teunuss ($623.50 in chips) 
teunuss: posts small blind $3
borntotilt: posts big blind $6
*** HOLE CARDS ***
teunuss: folds 
Uncalled bet ($3) returned to borntotilt
borntotilt collected $6 from pot
borntotilt: doesn't show hand 
*** SUMMARY ***
Total pot $6 | Rake $0 
Seat 3: borntotilt (big blind) collected ($6)
Seat 6: teunuss (button) (small blind) folded before Flop


PokerStars Game #102617744083:  Hold'em No Limit ($3/$6 USD) - 2013/08/11 14:38:16 ET
Table 'Tanete V 40-100 bb' 6-max Seat #3 is the button
Seat 3: borntotilt ($1427.20 in chips) 
Seat 6: teunuss ($620.50 in chips) 
borntotilt: posts small blind $3
teunuss: posts big blind $6
*** HOLE CARDS ***
borntotilt: raises $6 to $12
teunuss: calls $6
*** FLOP *** [8h Qh 7d]
teunuss: checks 
borntotilt: bets $18
teunuss: raises $45 to $63
borntotilt: calls $45
*** TURN *** [8h Qh 7d] [6s]
teunuss: bets $135
borntotilt: calls $135
*** RIVER *** [8h Qh 7d 6s] [7s]
teunuss: bets $410.50 and is all-in
borntotilt has timed out
borntotilt: folds 
Uncalled bet ($410.50) returned to teunuss
teunuss collected $419.50 from pot
teunuss: doesn't show hand 
*** SUMMARY ***
Total pot $420 | Rake $0.50 
Board [8h Qh 7d 6s 7s]
Seat 3: borntotilt (button) (small blind) folded on the River
Seat 6: teunuss (big blind) collected ($419.50)


PokerStars Game #102617319611:  Hold'em No Limit ($3/$6 USD) - 2013/08/11 14:30:28 ET
Table 'Tanete V 40-100 bb' 6-max Seat #3 is the button
Seat 3: borntotilt ($1312.70 in chips) 
Seat 6: teunuss ($600 in chips) 
borntotilt: posts small blind $3
teunuss: posts big blind $6
*** HOLE CARDS ***
borntotilt: raises $6 to $12
teunuss: calls $6
*** FLOP *** [Kd 3d As]
teunuss: checks 
borntotilt: bets $18
teunuss: calls $18
*** TURN *** [Kd 3d As] [Tc]
teunuss: checks 
borntotilt: bets $48
teunuss: calls $48
*** RIVER *** [Kd 3d As Tc] [Qd]
teunuss: checks 
borntotilt: checks 
*** SHOW DOWN ***
teunuss: shows [Ah 2h] (a pair of Aces)
borntotilt: shows [9s Jh] (a straight, Ten to Ace)
borntotilt collected $155.50 from pot
*** SUMMARY ***
Total pot $156 | Rake $0.50 
Board [Kd 3d As Tc Qd]
Seat 3: borntotilt (button) (small blind) showed [9s Jh] and won ($155.50) with a straight, Ten to Ace
Seat 6: teunuss (big blind) showed [Ah 2h] and lost with a pair of Aces


PokerStars Game #102617349856:  Hold'em No Limit ($3/$6 USD) - 2013/08/11 14:31:02 ET
Table 'Tanete V 40-100 bb' 6-max Seat #6 is the button
Seat 3: borntotilt ($1390.20 in chips) 
Seat 6: teunuss ($600 in chips) 
teunuss: posts small blind $3
borntotilt: posts big blind $6
*** HOLE CARDS ***
teunuss: raises $6 to $12
borntotilt: calls $6
*** FLOP *** [Ts 8s Js]
borntotilt: checks 
teunuss: checks 
*** TURN *** [Ts 8s Js] [2h]
borntotilt: bets $18
teunuss: folds 
Uncalled bet ($18) returned to borntotilt
borntotilt collected $23.50 from pot
borntotilt: doesn't show hand 
*** SUMMARY ***
Total pot $24 | Rake $0.50 
Board [Ts 8s Js 2h]
Seat 3: borntotilt (big blind) collected ($23.50)
Seat 6: teunuss (button) (small blind) folded on the Turn


PokerStars Game #102617376103:  Hold'em No Limit ($3/$6 USD) - 2013/08/11 14:31:31 ET
Table 'Tanete V 40-100 bb' 6-max Seat #3 is the button
Seat 3: borntotilt ($1401.70 in chips) 
Seat 6: teunuss ($600 in chips) 
borntotilt: posts small blind $3
teunuss: posts big blind $6
*** HOLE CARDS ***
borntotilt: raises $6 to $12
teunuss: raises $33 to $45
borntotilt: folds 
Uncalled bet ($33) returned to teunuss
teunuss collected $24 from pot
teunuss: doesn't show hand 
*** SUMMARY ***
Total pot $24 | Rake $0 
Seat 3: borntotilt (button) (small blind) folded before Flop
Seat 6: teunuss (big blind) collected ($24)


PokerStars Game #102617386627:  Hold'em No Limit ($3/$6 USD) - 2013/08/11 14:31:42 ET
Table 'Tanete V 40-100 bb' 6-max Seat #6 is the button
Seat 3: borntotilt ($1389.70 in chips) 
Seat 6: teunuss ($612 in chips) 
teunuss: posts small blind $3
borntotilt: posts big blind $6
*** HOLE CARDS ***
teunuss: raises $6 to $12
borntotilt: calls $6
*** FLOP *** [4h Qc 7s]
borntotilt: checks 
teunuss: checks 
*** TURN *** [4h Qc 7s] [Kc]
borntotilt: checks 
teunuss: checks 
*** RIVER *** [4h Qc 7s Kc] [Jd]
borntotilt: bets $20
teunuss: folds 
Uncalled bet ($20) returned to borntotilt
borntotilt collected $23.50 from pot
borntotilt: doesn't show hand 
*** SUMMARY ***
Total pot $24 | Rake $0.50 
Board [4h Qc 7s Kc Jd]
Seat 3: borntotilt (big blind) collected ($23.50)
Seat 6: teunuss (button) (small blind) folded on the River


PokerStars Game #102617424896:  Hold'em No Limit ($3/$6 USD) - 2013/08/11 14:32:25 ET
Table 'Tanete V 40-100 bb' 6-max Seat #3 is the button
Seat 3: borntotilt ($1401.20 in chips) 
Seat 6: teunuss ($600 in chips) 
borntotilt: posts small blind $3
teunuss: posts big blind $6
*** HOLE CARDS ***
borntotilt: raises $6 to $12
teunuss: calls $6
*** FLOP *** [2d 9h Ts]
teunuss: checks 
borntotilt: bets $18
teunuss: calls $18
*** TURN *** [2d 9h Ts] [As]
teunuss: checks 
borntotilt: checks 
*** RIVER *** [2d 9h Ts As] [2h]
teunuss: checks 
borntotilt: checks 
*** SHOW DOWN ***
teunuss: shows [9c Qc] (two pair, Nines and Deuces)
borntotilt: mucks hand 
teunuss collected $59.50 from pot
*** SUMMARY ***
Total pot $60 | Rake $0.50 
Board [2d 9h Ts As 2h]
Seat 3: borntotilt (button) (small blind) mucked
Seat 6: teunuss (big blind) showed [9c Qc] and won ($59.50) with two pair, Nines and Deuces


PokerStars Game #102617450904:  Hold'em No Limit ($3/$6 USD) - 2013/08/11 14:32:53 ET
Table 'Tanete V 40-100 bb' 6-max Seat #6 is the button
Seat 3: borntotilt ($1371.20 in chips) 
Seat 6: teunuss ($629.50 in chips) 
teunuss: posts small blind $3
borntotilt: posts big blind $6
*** HOLE CARDS ***
teunuss: raises $6 to $12
borntotilt: calls $6
*** FLOP *** [3h 7c 7h]
borntotilt: checks 
teunuss: bets $15
borntotilt: folds 
Uncalled bet ($15) returned to teunuss
teunuss collected $23.50 from pot
teunuss: doesn't show hand 
*** SUMMARY ***
Total pot $24 | Rake $0.50 
Board [3h 7c 7h]
Seat 3: borntotilt (big blind) folded on the Flop
Seat 6: teunuss (button) (small blind) collected ($23.50)


PokerStars Game #102617467261:  Hold'em No Limit ($3/$6 USD) - 2013/08/11 14:33:11 ET
Table 'Tanete V 40-100 bb' 6-max Seat #3 is the button
Seat 3: borntotilt ($1359.20 in chips) 
Seat 6: teunuss ($641 in chips) 
borntotilt: posts small blind $3
teunuss: posts big blind $6
*** HOLE CARDS ***
borntotilt: raises $6 to $12
teunuss: raises $33 to $45
borntotilt: folds 
Uncalled bet ($33) returned to teunuss
teunuss collected $24 from pot
teunuss: doesn't show hand 
*** SUMMARY ***
Total pot $24 | Rake $0 
Seat 3: borntotilt (button) (small blind) folded before Flop
Seat 6: teunuss (big blind) collected ($24)


PokerStars Game #102617481640:  Hold'em No Limit ($3/$6 USD) - 2013/08/11 14:33:27 ET
Table 'Tanete V 40-100 bb' 6-max Seat #6 is the button
Seat 3: borntotilt ($1347.20 in chips) 
Seat 6: teunuss ($653 in chips) 
teunuss: posts small blind $3
borntotilt: posts big blind $6
*** HOLE CARDS ***
teunuss: raises $6 to $12
borntotilt: folds 
Uncalled bet ($6) returned to teunuss
teunuss collected $12 from pot
teunuss: doesn't show hand 
*** SUMMARY ***
Total pot $12 | Rake $0 
Seat 3: borntotilt (big blind) folded before Flop
Seat 6: teunuss (button) (small blind) collected ($12)


PokerStars Game #102617487725:  Hold'em No Limit ($3/$6 USD) - 2013/08/11 14:33:34 ET
Table 'Tanete V 40-100 bb' 6-max Seat #3 is the button
Seat 3: borntotilt ($1341.20 in chips) 
Seat 6: teunuss ($659 in chips) 
borntotilt: posts small blind $3
teunuss: posts big blind $6
*** HOLE CARDS ***
borntotilt: raises $6 to $12
teunuss: folds 
Uncalled bet ($6) returned to borntotilt
borntotilt collected $12 from pot
borntotilt: doesn't show hand 
*** SUMMARY ***
Total pot $12 | Rake $0 
Seat 3: borntotilt (button) (small blind) collected ($12)
Seat 6: teunuss (big blind) folded before Flop


PokerStars Game #102617496381:  Hold'em No Limit ($3/$6 USD) - 2013/08/11 14:33:43 ET
Table 'Tanete V 40-100 bb' 6-max Seat #6 is the button
Seat 3: borntotilt ($1347.20 in chips) 
Seat 6: teunuss ($653 in chips) 
teunuss: posts small blind $3
borntotilt: posts big blind $6
*** HOLE CARDS ***
teunuss: raises $6 to $12
borntotilt: calls $6
*** FLOP *** [Kh Js Ts]
borntotilt: checks 
teunuss: bets $15
borntotilt: folds 
Uncalled bet ($15) returned to teunuss
teunuss collected $23.50 from pot
teunuss: doesn't show hand 
*** SUMMARY ***
Total pot $24 | Rake $0.50 
Board [Kh Js Ts]
Seat 3: borntotilt (big blind) folded on the Flop
Seat 6: teunuss (button) (small blind) collected ($23.50)


PokerStars Game #102617508097:  Hold'em No Limit ($3/$6 USD) - 2013/08/11 14:33:56 ET
Table 'Tanete V 40-100 bb' 6-max Seat #3 is the button
Seat 3: borntotilt ($1335.20 in chips) 
Seat 6: teunuss ($664.50 in chips) 
borntotilt: posts small blind $3
teunuss: posts big blind $6
*** HOLE CARDS ***
borntotilt: raises $6 to $12
teunuss: calls $6
*** FLOP *** [Ac 8c Js]
teunuss: checks 
borntotilt: checks 
*** TURN *** [Ac 8c Js] [5d]
teunuss: bets $15
borntotilt: calls $15
*** RIVER *** [Ac 8c Js 5d] [7h]
teunuss: bets $39
borntotilt: calls $39
*** SHOW DOWN ***
teunuss: shows [9h Qs] (high card Ace)
borntotilt: shows [Jh 6s] (a pair of Jacks)
borntotilt collected $131.50 from pot
*** SUMMARY ***
Total pot $132 | Rake $0.50 
Board [Ac 8c Js 5d 7h]
Seat 3: borntotilt (button) (small blind) showed [Jh 6s] and won ($131.50) with a pair of Jacks
Seat 6: teunuss (big blind) showed [9h Qs] and lost with high card Ace


PokerStars Game #102617540103:  Hold'em No Limit ($3/$6 USD) - 2013/08/11 14:34:31 ET
Table 'Tanete V 40-100 bb' 6-max Seat #6 is the button
Seat 3: borntotilt ($1400.70 in chips) 
Seat 6: teunuss ($600 in chips) 
teunuss: posts small blind $3
borntotilt: posts big blind $6
*** HOLE CARDS ***
teunuss: raises $6 to $12
borntotilt: folds 
Uncalled bet ($6) returned to teunuss
teunuss collected $12 from pot
teunuss: doesn't show hand 
*** SUMMARY ***
Total pot $12 | Rake $0 
Seat 3: borntotilt (big blind) folded before Flop
Seat 6: teunuss (button) (small blind) collected ($12)


PokerStars Game #102617551010:  Hold'em No Limit ($3/$6 USD) - 2013/08/11 14:34:43 ET
Table 'Tanete V 40-100 bb' 6-max Seat #3 is the button
Seat 3: borntotilt ($1394.70 in chips) 
Seat 6: teunuss ($606 in chips) 
borntotilt: posts small blind $3
teunuss: posts big blind $6
*** HOLE CARDS ***
borntotilt: raises $6 to $12
teunuss: calls $6
*** FLOP *** [2h 6h Kd]
teunuss: checks 
borntotilt: checks 
*** TURN *** [2h 6h Kd] [5d]
teunuss: checks 
borntotilt: checks 
*** RIVER *** [2h 6h Kd 5d] [4c]
teunuss: bets $15
borntotilt: folds 
Uncalled bet ($15) returned to teunuss
teunuss collected $23.50 from pot
teunuss: doesn't show hand 
*** SUMMARY ***
Total pot $24 | Rake $0.50 
Board [2h 6h Kd 5d 4c]
Seat 3: borntotilt (button) (small blind) folded on the River
Seat 6: teunuss (big blind) collected ($23.50)


PokerStars Game #102619377620:  Hold'em No Limit ($3/$6 USD) - 2013/08/11 15:10:38 ET
Table 'Tanete V 40-100 bb' 6-max Seat #1 is the button
Seat 1: shevliak ($240 in chips) 
Seat 3: borntotilt ($600 in chips) 
Seat 4: pindrokk ($806.20 in chips) 
Seat 5: GregAndrek ($612 in chips) 
Seat 6: teunuss ($1466 in chips) 
borntotilt: posts small blind $3
pindrokk: posts big blind $6
*** HOLE CARDS ***
GregAndrek: folds 
teunuss: raises $9 to $15
shevliak: folds 
borntotilt: folds 
pindrokk: folds 
Uncalled bet ($9) returned to teunuss
teunuss collected $15 from pot
teunuss: doesn't show hand 
*** SUMMARY ***
Total pot $15 | Rake $0 
Seat 1: shevliak (button) folded before Flop (didn't bet)
Seat 3: borntotilt (small blind) folded before Flop
Seat 4: pindrokk (big blind) folded before Flop
Seat 5: GregAndrek folded before Flop (didn't bet)
Seat 6: teunuss collected ($15)


PokerStars Game #102619401668:  Hold'em No Limit ($3/$6 USD) - 2013/08/11 15:11:04 ET
Table 'Tanete V 40-100 bb' 6-max Seat #3 is the button
Seat 1: shevliak ($240 in chips) 
Seat 3: borntotilt ($600 in chips) 
Seat 4: pindrokk ($800.20 in chips) 
Seat 5: GregAndrek ($612 in chips) 
Seat 6: teunuss ($1475 in chips) 
pindrokk: posts small blind $3
GregAndrek: posts big blind $6
*** HOLE CARDS ***
teunuss: folds 
shevliak: folds 
borntotilt: folds 
pindrokk: raises $9 to $15
GregAndrek: calls $9
*** FLOP *** [8c 2c Qd]
pindrokk: bets $20
GregAndrek: calls $20
*** TURN *** [8c 2c Qd] [Kc]
pindrokk: bets $50
GregAndrek: folds 
Uncalled bet ($50) returned to pindrokk
pindrokk collected $67.20 from pot
pindrokk: doesn't show hand 
*** SUMMARY ***
Total pot $70 | Rake $2.80 
Board [8c 2c Qd Kc]
Seat 1: shevliak folded before Flop (didn't bet)
Seat 3: borntotilt (button) folded before Flop (didn't bet)
Seat 4: pindrokk (small blind) collected ($67.20)
Seat 5: GregAndrek (big blind) folded on the Turn
Seat 6: teunuss folded before Flop (didn't bet)


PokerStars Game #102619451913:  Hold'em No Limit ($3/$6 USD) - 2013/08/11 15:11:57 ET
Table 'Tanete V 40-100 bb' 6-max Seat #4 is the button
Seat 1: shevliak ($240 in chips) 
Seat 2: ALBERT910 ($367.48 in chips) 
Seat 3: borntotilt ($600 in chips) 
Seat 4: pindrokk ($832.40 in chips) 
Seat 5: GregAndrek ($600 in chips) 
Seat 6: teunuss ($1475 in chips) 
GregAndrek: posts small blind $3
teunuss: posts big blind $6
ALBERT910: posts small blind $3
*** HOLE CARDS ***
shevliak: folds 
ALBERT910: calls $6
borntotilt: folds 
pindrokk: folds 
GregAndrek: folds 
teunuss: checks 
*** FLOP *** [7d 5d Tc]
teunuss: checks 
borntotilt leaves the table
ALBERT910: bets $12
teunuss: folds 
Uncalled bet ($12) returned to ALBERT910
ALBERT910 collected $17.19 from pot
ALBERT910: doesn't show hand 
*** SUMMARY ***
Total pot $18 | Rake $0.81 
Board [7d 5d Tc]
Seat 1: shevliak folded before Flop (didn't bet)
Seat 2: ALBERT910 collected ($17.19)
Seat 3: borntotilt folded before Flop (didn't bet)
Seat 4: pindrokk (button) folded before Flop (didn't bet)
Seat 5: GregAndrek (small blind) folded before Flop
Seat 6: teunuss (big blind) folded on the Flop


PokerStars Game #102619496790:  Hold'em No Limit ($3/$6 USD) - 2013/08/11 15:12:45 ET
Table 'Tanete V 40-100 bb' 6-max Seat #5 is the button
Seat 1: shevliak ($240 in chips) 
Seat 2: ALBERT910 ($375.67 in chips) 
Seat 4: pindrokk ($832.40 in chips) 
Seat 5: GregAndrek ($600 in chips) 
Seat 6: teunuss ($1469 in chips) 
teunuss: posts small blind $3
shevliak: posts big blind $6
*** HOLE CARDS ***
SEREJkE29 joins the table at seat #3 
ALBERT910: folds 
pindrokk: raises $9 to $15
GregAndrek: folds 
teunuss: folds 
shevliak: folds 
Uncalled bet ($9) returned to pindrokk
pindrokk collected $15 from pot
pindrokk: doesn't show hand 
*** SUMMARY ***
Total pot $15 | Rake $0 
Seat 1: shevliak (big blind) folded before Flop
Seat 2: ALBERT910 folded before Flop (didn't bet)
Seat 4: pindrokk collected ($15)
Seat 5: GregAndrek (button) folded before Flop (didn't bet)
Seat 6: teunuss (small blind) folded before Flop


PokerStars Game #102619511792:  Hold'em No Limit ($3/$6 USD) - 2013/08/11 15:13:02 ET
Table 'Tanete V 40-100 bb' 6-max Seat #6 is the button
Seat 1: shevliak ($240 in chips) 
Seat 2: ALBERT910 ($375.67 in chips) 
Seat 4: pindrokk ($841.40 in chips) 
Seat 5: GregAndrek ($600 in chips) 
Seat 6: teunuss ($1466 in chips) 
shevliak: posts small blind $3
ALBERT910: posts big blind $6
SEREJkE29: sits out 
*** HOLE CARDS ***
pindrokk: folds 
GregAndrek: folds 
teunuss: folds 
shevliak: raises $6.90 to $12.90
ALBERT910: folds 
Uncalled bet ($6.90) returned to shevliak
shevliak collected $12 from pot
shevliak: doesn't show hand 
*** SUMMARY ***
Total pot $12 | Rake $0 
Seat 1: shevliak (small blind) collected ($12)
Seat 2: ALBERT910 (big blind) folded before Flop
Seat 4: pindrokk folded before Flop (didn't bet)
Seat 5: GregAndrek folded before Flop (didn't bet)
Seat 6: teunuss (button) folded before Flop (didn't bet)


PokerStars Game #102619526166:  Hold'em No Limit ($3/$6 USD) - 2013/08/11 15:13:17 ET
Table 'Tanete V 40-100 bb' 6-max Seat #1 is the button
Seat 1: shevliak ($246 in chips) 
Seat 2: ALBERT910 ($369.67 in chips) 
Seat 3: SEREJkE29 ($600 in chips) 
Seat 4: pindrokk ($841.40 in chips) 
Seat 5: GregAndrek ($600 in chips) 
Seat 6: teunuss ($1466 in chips) 
ALBERT910: posts small blind $3
SEREJkE29: posts big blind $6
*** HOLE CARDS ***
pindrokk: folds 
GregAndrek: folds 
teunuss: folds 
shevliak: raises $6.90 to $12.90
ALBERT910: folds 
SEREJkE29: folds 
Uncalled bet ($6.90) returned to shevliak
shevliak collected $15 from pot
shevliak: doesn't show hand 
*** SUMMARY ***
Total pot $15 | Rake $0 
Seat 1: shevliak (button) collected ($15)
Seat 2: ALBERT910 (small blind) folded before Flop
Seat 3: SEREJkE29 (big blind) folded before Flop
Seat 4: pindrokk folded before Flop (didn't bet)
Seat 5: GregAndrek folded before Flop (didn't bet)
Seat 6: teunuss folded before Flop (didn't bet)


PokerStars Game #102619542826:  Hold'em No Limit ($3/$6 USD) - 2013/08/11 15:13:35 ET
Table 'Tanete V 40-100 bb' 6-max Seat #2 is the button
Seat 1: shevliak ($255 in chips) 
Seat 2: ALBERT910 ($366.67 in chips) 
Seat 3: SEREJkE29 ($600 in chips) 
Seat 4: pindrokk ($841.40 in chips) 
Seat 5: GregAndrek ($600 in chips) 
Seat 6: teunuss ($1466 in chips) 
SEREJkE29: posts small blind $3
pindrokk: posts big blind $6
*** HOLE CARDS ***
GregAndrek: folds 
teunuss: folds 
shevliak: folds 
ALBERT910: folds 
SEREJkE29: folds 
Uncalled bet ($3) returned to pindrokk
pindrokk collected $6 from pot
pindrokk: doesn't show hand 
*** SUMMARY ***
Total pot $6 | Rake $0 
Seat 1: shevliak folded before Flop (didn't bet)
Seat 2: ALBERT910 (button) folded before Flop (didn't bet)
Seat 3: SEREJkE29 (small blind) folded before Flop
Seat 4: pindrokk (big blind) collected ($6)
Seat 5: GregAndrek folded before Flop (didn't bet)
Seat 6: teunuss folded before Flop (didn't bet)


PokerStars Game #102619559143:  Hold'em No Limit ($3/$6 USD) - 2013/08/11 15:13:52 ET
Table 'Tanete V 40-100 bb' 6-max Seat #3 is the button
Seat 1: shevliak ($255 in chips) 
Seat 2: ALBERT910 ($366.67 in chips) 
Seat 3: SEREJkE29 ($600 in chips) 
Seat 4: pindrokk ($844.40 in chips) 
Seat 5: GregAndrek ($600 in chips) 
Seat 6: teunuss ($1466 in chips) 
pindrokk: posts small blind $3
GregAndrek: posts big blind $6
*** HOLE CARDS ***
teunuss: folds 
shevliak: folds 
ALBERT910 has timed out
ALBERT910: folds 
SEREJkE29: raises $6 to $12
pindrokk: folds 
GregAndrek: raises $30 to $42
SEREJkE29: calls $30
*** FLOP *** [2d Ad 8h]
GregAndrek: checks 
SEREJkE29: bets $24
GregAndrek: calls $24
*** TURN *** [2d Ad 8h] [Ac]
GregAndrek: checks 
SEREJkE29: checks 
*** RIVER *** [2d Ad 8h Ac] [4s]
GregAndrek: bets $75
SEREJkE29: folds 
Uncalled bet ($75) returned to GregAndrek
GregAndrek collected $132.20 from pot
GregAndrek: doesn't show hand 
*** SUMMARY ***
Total pot $135 | Rake $2.80 
Board [2d Ad 8h Ac 4s]
Seat 1: shevliak folded before Flop (didn't bet)
Seat 2: ALBERT910 folded before Flop (didn't bet)
Seat 3: SEREJkE29 (button) folded on the River
Seat 4: pindrokk (small blind) folded before Flop
Seat 5: GregAndrek (big blind) collected ($132.20)
Seat 6: teunuss folded before Flop (didn't bet)


PokerStars Game #102619076047:  Hold'em No Limit ($3/$6 USD) - 2013/08/11 15:05:18 ET
Table 'Tanete V 40-100 bb' 6-max Seat #1 is the button
Seat 1: shevliak ($240 in chips) 
Seat 2: ALBERT910 ($337.44 in chips) 
Seat 3: borntotilt ($600 in chips) 
Seat 4: pindrokk ($806.20 in chips) 
Seat 6: teunuss ($1472 in chips) 
ALBERT910: posts small blind $3
borntotilt: posts big blind $6
GregAndrek: sits out 
*** HOLE CARDS ***
pindrokk: folds 
teunuss: raises $9 to $15
shevliak: folds 
ALBERT910: calls $12
borntotilt: folds 
*** FLOP *** [Kd Ts 4d]
ALBERT910: bets $24
teunuss: folds 
Uncalled bet ($24) returned to ALBERT910
ALBERT910 collected $34.38 from pot
ALBERT910: doesn't show hand 
*** SUMMARY ***
Total pot $36 | Rake $1.62 
Board [Kd Ts 4d]
Seat 1: shevliak (button) folded before Flop (didn't bet)
Seat 2: ALBERT910 (small blind) collected ($34.38)
Seat 3: borntotilt (big blind) folded before Flop
Seat 4: pindrokk folded before Flop (didn't bet)
Seat 6: teunuss folded on the Flop


PokerStars Game #102619143070:  Hold'em No Limit ($3/$6 USD) - 2013/08/11 15:06:29 ET
Table 'Tanete V 40-100 bb' 6-max Seat #2 is the button
Seat 1: shevliak ($240 in chips) 
Seat 2: ALBERT910 ($356.82 in chips) 
Seat 3: borntotilt ($600 in chips) 
Seat 4: pindrokk ($806.20 in chips) 
Seat 6: teunuss ($1457 in chips) 
borntotilt: posts small blind $3
pindrokk: posts big blind $6
GregAndrek: sits out 
*** HOLE CARDS ***
teunuss: folds 
shevliak: folds 
ALBERT910: folds 
borntotilt has timed out
borntotilt: folds 
Uncalled bet ($3) returned to pindrokk
pindrokk collected $6 from pot
pindrokk: doesn't show hand 
*** SUMMARY ***
Total pot $6 | Rake $0 
Seat 1: shevliak folded before Flop (didn't bet)
Seat 2: ALBERT910 (button) folded before Flop (didn't bet)
Seat 3: borntotilt (small blind) folded before Flop
Seat 4: pindrokk (big blind) collected ($6)
Seat 6: teunuss folded before Flop (didn't bet)


PokerStars Game #102619181655:  Hold'em No Limit ($3/$6 USD) - 2013/08/11 15:07:10 ET
Table 'Tanete V 40-100 bb' 6-max Seat #3 is the button
Seat 1: shevliak ($240 in chips) 
Seat 2: ALBERT910 ($356.82 in chips) 
Seat 3: borntotilt ($600 in chips) 
Seat 4: pindrokk ($809.20 in chips) 
Seat 5: GregAndrek ($600 in chips) 
Seat 6: teunuss ($1457 in chips) 
pindrokk: posts small blind $3
GregAndrek: posts big blind $6
*** HOLE CARDS ***
teunuss: folds 
shevliak: folds 
ALBERT910: folds 
borntotilt: raises $6 to $12
pindrokk: folds 
GregAndrek: raises $30 to $42
borntotilt: folds 
Uncalled bet ($30) returned to GregAndrek
GregAndrek collected $27 from pot
GregAndrek: doesn't show hand 
*** SUMMARY ***
Total pot $27 | Rake $0 
Seat 1: shevliak folded before Flop (didn't bet)
Seat 2: ALBERT910 folded before Flop (didn't bet)
Seat 3: borntotilt (button) folded before Flop
Seat 4: pindrokk (small blind) folded before Flop
Seat 5: GregAndrek (big blind) collected ($27)
Seat 6: teunuss folded before Flop (didn't bet)


PokerStars Game #102619220325:  Hold'em No Limit ($3/$6 USD) - 2013/08/11 15:07:51 ET
Table 'Tanete V 40-100 bb' 6-max Seat #4 is the button
Seat 1: shevliak ($240 in chips) 
Seat 2: ALBERT910 ($356.82 in chips) 
Seat 3: borntotilt ($600 in chips) 
Seat 4: pindrokk ($806.20 in chips) 
Seat 5: GregAndrek ($615 in chips) 
Seat 6: teunuss ($1457 in chips) 
GregAndrek: posts small blind $3
teunuss: posts big blind $6
*** HOLE CARDS ***
shevliak: folds 
ALBERT910: folds 
borntotilt: folds 
pindrokk: folds 
GregAndrek: folds 
Uncalled bet ($3) returned to teunuss
teunuss collected $6 from pot
teunuss: doesn't show hand 
*** SUMMARY ***
Total pot $6 | Rake $0 
Seat 1: shevliak folded before Flop (didn't bet)
Seat 2: ALBERT910 folded before Flop (didn't bet)
Seat 3: borntotilt folded before Flop (didn't bet)
Seat 4: pindrokk (button) folded before Flop (didn't bet)
Seat 5: GregAndrek (small blind) folded before Flop
Seat 6: teunuss (big blind) collected ($6)


PokerStars Game #102619261036:  Hold'em No Limit ($3/$6 USD) - 2013/08/11 15:08:34 ET
Table 'Tanete V 40-100 bb' 6-max Seat #5 is the button
Seat 1: shevliak ($240 in chips) 
Seat 2: ALBERT910 ($356.82 in chips) 
Seat 3: borntotilt ($600 in chips) 
Seat 4: pindrokk ($806.20 in chips) 
Seat 5: GregAndrek ($612 in chips) 
Seat 6: teunuss ($1460 in chips) 
teunuss: posts small blind $3
shevliak: posts big blind $6
*** HOLE CARDS ***
ALBERT910: calls $6
borntotilt: folds 
pindrokk: folds 
GregAndrek: folds 
teunuss: folds 
shevliak: checks 
*** FLOP *** [Qh Qd Td]
shevliak: checks 
ALBERT910: checks 
*** TURN *** [Qh Qd Td] [7h]
shevliak: bets $9.16
ALBERT910: calls $9.16
*** RIVER *** [Qh Qd Td 7h] [8h]
shevliak: checks 
ALBERT910: checks 
*** SHOW DOWN ***
shevliak: shows [6s 2h] (a pair of Queens)
ALBERT910: shows [As Jc] (a pair of Queens - Ace kicker)
ALBERT910 collected $31.82 from pot
*** SUMMARY ***
Total pot $33.32 | Rake $1.50 
Board [Qh Qd Td 7h 8h]
Seat 1: shevliak (big blind) showed [6s 2h] and lost with a pair of Queens
Seat 2: ALBERT910 showed [As Jc] and won ($31.82) with a pair of Queens
Seat 3: borntotilt folded before Flop (didn't bet)
Seat 4: pindrokk folded before Flop (didn't bet)
Seat 5: GregAndrek (button) folded before Flop (didn't bet)
Seat 6: teunuss (small blind) folded before Flop


PokerStars Game #102619300602:  Hold'em No Limit ($3/$6 USD) - 2013/08/11 15:09:17 ET
Table 'Tanete V 40-100 bb' 6-max Seat #6 is the button
Seat 1: shevliak ($240 in chips) 
Seat 2: ALBERT910 ($373.48 in chips) 
Seat 3: borntotilt ($600 in chips) 
Seat 4: pindrokk ($806.20 in chips) 
Seat 5: GregAndrek ($612 in chips) 
Seat 6: teunuss ($1457 in chips) 
shevliak: posts small blind $3
ALBERT910: posts big blind $6
*** HOLE CARDS ***
borntotilt: folds 
pindrokk: folds 
GregAndrek: folds 
teunuss: raises $6 to $12
shevliak: folds 
ALBERT910 has timed out
ALBERT910: folds 
Uncalled bet ($6) returned to teunuss
teunuss collected $15 from pot
teunuss: doesn't show hand 
*** SUMMARY ***
Total pot $15 | Rake $0 
Seat 1: shevliak (small blind) folded before Flop
Seat 2: ALBERT910 (big blind) folded before Flop
Seat 3: borntotilt folded before Flop (didn't bet)
Seat 4: pindrokk folded before Flop (didn't bet)
Seat 5: GregAndrek folded before Flop (didn't bet)
Seat 6: teunuss (button) collected ($15)


PokerStars Game #102618722220:  Hold'em No Limit ($3/$6 USD) - 2013/08/11 14:57:23 ET
Table 'Tanete V 40-100 bb' 6-max Seat #6 is the button
Seat 3: borntotilt ($603 in chips) 
Seat 5: Subv ($933 in chips) 
Seat 6: teunuss ($1574 in chips) 
borntotilt: posts small blind $3
ALBERT910 joins the table at seat #2 
Subv: posts big blind $6
*** HOLE CARDS ***
teunuss: raises $6 to $12
pindrokk joins the table at seat #4 
shevliak joins the table at seat #1 
borntotilt: folds 
Subv: folds 
Uncalled bet ($6) returned to teunuss
teunuss collected $15 from pot
teunuss: doesn't show hand 
*** SUMMARY ***
Total pot $15 | Rake $0 
Seat 3: borntotilt (small blind) folded before Flop
Seat 5: Subv (big blind) folded before Flop
Seat 6: teunuss (button) collected ($15)


PokerStars Game #102618740612:  Hold'em No Limit ($3/$6 USD) - 2013/08/11 14:57:56 ET
Table 'Tanete V 40-100 bb' 6-max Seat #3 is the button
Seat 3: borntotilt ($600 in chips) 
Seat 5: Subv ($927 in chips) 
Seat 6: teunuss ($1583 in chips) 
pindrokk will be allowed to play after the button
Subv: posts small blind $3
teunuss: posts big blind $6
shevliak: sits out 
ALBERT910: sits out 
*** HOLE CARDS ***
borntotilt: raises $6 to $12
Subv: folds 
teunuss: calls $6
*** FLOP *** [6s Kd 6h]
teunuss: checks 
borntotilt: bets $18
teunuss: folds 
Uncalled bet ($18) returned to borntotilt
borntotilt collected $25.78 from pot
borntotilt: doesn't show hand 
*** SUMMARY ***
Total pot $27 | Rake $1.22 
Board [6s Kd 6h]
Seat 3: borntotilt (button) collected ($25.78)
Seat 5: Subv (small blind) folded before Flop
Seat 6: teunuss (big blind) folded on the Flop


PokerStars Game #102618760016:  Hold'em No Limit ($3/$6 USD) - 2013/08/11 14:58:32 ET
Table 'Tanete V 40-100 bb' 6-max Seat #5 is the button
Seat 1: shevliak ($240 in chips) 
Seat 3: borntotilt ($613.78 in chips) 
Seat 5: Subv ($924 in chips) 
Seat 6: teunuss ($1571 in chips) 
teunuss: posts small blind $3
shevliak: posts big blind $6
ALBERT910: sits out 
pindrokk: sits out 
*** HOLE CARDS ***
borntotilt: folds 
Subv: raises $6.30 to $12.30
teunuss: folds 
shevliak: folds 
Uncalled bet ($6.30) returned to Subv
Subv collected $15 from pot
Subv: doesn't show hand 
*** SUMMARY ***
Total pot $15 | Rake $0 
Seat 1: shevliak (big blind) folded before Flop
Seat 3: borntotilt folded before Flop (didn't bet)
Seat 5: Subv (button) collected ($15)
Seat 6: teunuss (small blind) folded before Flop


PokerStars Game #102618770879:  Hold'em No Limit ($3/$6 USD) - 2013/08/11 14:58:52 ET
Table 'Tanete V 40-100 bb' 6-max Seat #6 is the button
Seat 1: shevliak ($240 in chips) 
Seat 2: ALBERT910 ($240 in chips) 
Seat 3: borntotilt ($613.78 in chips) 
Seat 5: Subv ($933 in chips) 
Seat 6: teunuss ($1568 in chips) 
shevliak: posts small blind $3
ALBERT910: posts big blind $6
pindrokk: sits out 
*** HOLE CARDS ***
borntotilt: raises $12 to $18
Subv: folds 
teunuss: folds 
shevliak: folds 
ALBERT910: calls $12
*** FLOP *** [Ah Ks Ad]
ALBERT910: checks 
borntotilt: checks 
*** TURN *** [Ah Ks Ad] [5c]
ALBERT910: bets $24
borntotilt: folds 
Uncalled bet ($24) returned to ALBERT910
ALBERT910 collected $37.24 from pot
ALBERT910: doesn't show hand 
*** SUMMARY ***
Total pot $39 | Rake $1.76 
Board [Ah Ks Ad 5c]
Seat 1: shevliak (small blind) folded before Flop
Seat 2: ALBERT910 (big blind) collected ($37.24)
Seat 3: borntotilt folded on the Turn
Seat 5: Subv folded before Flop (didn't bet)
Seat 6: teunuss (button) folded before Flop (didn't bet)


PokerStars Game #102618803730:  Hold'em No Limit ($3/$6 USD) - 2013/08/11 14:59:51 ET
Table 'Tanete V 40-100 bb' 6-max Seat #1 is the button
Seat 1: shevliak ($240 in chips) 
Seat 2: ALBERT910 ($259.24 in chips) 
Seat 3: borntotilt ($600 in chips) 
Seat 5: Subv ($933 in chips) 
Seat 6: teunuss ($1568 in chips) 
ALBERT910: posts small blind $3
borntotilt: posts big blind $6
pindrokk: sits out 
*** HOLE CARDS ***
Subv: folds 
teunuss: folds 
shevliak: folds 
ALBERT910: calls $3
borntotilt: checks 
*** FLOP *** [Jd 7h 6c]
ALBERT910: checks 
borntotilt: checks 
*** TURN *** [Jd 7h 6c] [Ah]
ALBERT910: bets $12
borntotilt: calls $12
*** RIVER *** [Jd 7h 6c Ah] [3d]
ALBERT910: checks 
borntotilt: checks 
*** SHOW DOWN ***
ALBERT910: shows [Ks Kd] (a pair of Kings)
borntotilt: shows [4s As] (a pair of Aces)
borntotilt collected $34.38 from pot
*** SUMMARY ***
Total pot $36 | Rake $1.62 
Board [Jd 7h 6c Ah 3d]
Seat 1: shevliak (button) folded before Flop (didn't bet)
Seat 2: ALBERT910 (small blind) showed [Ks Kd] and lost with a pair of Kings
Seat 3: borntotilt (big blind) showed [4s As] and won ($34.38) with a pair of Aces
Seat 5: Subv folded before Flop (didn't bet)
Seat 6: teunuss folded before Flop (didn't bet)


PokerStars Game #102618846088:  Hold'em No Limit ($3/$6 USD) - 2013/08/11 15:00:56 ET
Table 'Tanete V 40-100 bb' 6-max Seat #2 is the button
Seat 1: shevliak ($240 in chips) 
Seat 2: ALBERT910 ($241.24 in chips) 
Seat 3: borntotilt ($616.38 in chips) 
Seat 4: pindrokk ($600 in chips) 
Seat 5: Subv ($933 in chips) 
Seat 6: teunuss ($1568 in chips) 
borntotilt: posts small blind $3
pindrokk: posts big blind $6
*** HOLE CARDS ***
Subv: folds 
teunuss: raises $9 to $15
shevliak: folds 
ALBERT910: folds 
borntotilt: folds 
pindrokk: folds 
Uncalled bet ($9) returned to teunuss
teunuss collected $15 from pot
teunuss: doesn't show hand 
*** SUMMARY ***
Total pot $15 | Rake $0 
Seat 1: shevliak folded before Flop (didn't bet)
Seat 2: ALBERT910 (button) folded before Flop (didn't bet)
Seat 3: borntotilt (small blind) folded before Flop
Seat 4: pindrokk (big blind) folded before Flop
Seat 5: Subv folded before Flop (didn't bet)
Seat 6: teunuss collected ($15)


PokerStars Game #102618881077:  Hold'em No Limit ($3/$6 USD) - 2013/08/11 15:01:42 ET
Table 'Tanete V 40-100 bb' 6-max Seat #3 is the button
Seat 1: shevliak ($240 in chips) 
Seat 2: ALBERT910 ($241.24 in chips) 
Seat 3: borntotilt ($613.38 in chips) 
Seat 4: pindrokk ($600 in chips) 
Seat 6: teunuss ($1577 in chips) 
pindrokk: posts small blind $3
Subv: is sitting out 
teunuss: posts big blind $6
*** HOLE CARDS ***
Subv leaves the table
GregAndrek joins the table at seat #5 
shevliak: folds 
ALBERT910: folds 
borntotilt: raises $6 to $12
pindrokk: raises $32 to $44
teunuss: folds 
borntotilt: calls $32
*** FLOP *** [Ah 9d 5s]
pindrokk: bets $45
borntotilt: calls $45
*** TURN *** [Ah 9d 5s] [Ts]
pindrokk: bets $114
borntotilt: calls $114
*** RIVER *** [Ah 9d 5s Ts] [Jc]
pindrokk: bets $397 and is all-in
borntotilt: folds 
Uncalled bet ($397) returned to pindrokk
pindrokk collected $409.20 from pot
pindrokk: doesn't show hand 
*** SUMMARY ***
Total pot $412 | Rake $2.80 
Board [Ah 9d 5s Ts Jc]
Seat 1: shevliak folded before Flop (didn't bet)
Seat 2: ALBERT910 folded before Flop (didn't bet)
Seat 3: borntotilt (button) folded on the River
Seat 4: pindrokk (small blind) collected ($409.20)
Seat 6: teunuss (big blind) folded before Flop


PokerStars Game #102618975744:  Hold'em No Limit ($3/$6 USD) - 2013/08/11 15:03:30 ET
Table 'Tanete V 40-100 bb' 6-max Seat #4 is the button
Seat 1: shevliak ($240 in chips) 
Seat 2: ALBERT910 ($241.24 in chips) 
Seat 3: borntotilt ($600 in chips) 
Seat 4: pindrokk ($806.20 in chips) 
Seat 6: teunuss ($1571 in chips) 
GregAndrek will be allowed to play after the button
teunuss: posts small blind $3
shevliak: posts big blind $6
*** HOLE CARDS ***
ALBERT910: folds 
borntotilt: folds 
pindrokk: folds 
teunuss: folds 
Uncalled bet ($3) returned to shevliak
shevliak collected $6 from pot
shevliak: doesn't show hand 
*** SUMMARY ***
Total pot $6 | Rake $0 
Seat 1: shevliak (big blind) collected ($6)
Seat 2: ALBERT910 folded before Flop (didn't bet)
Seat 3: borntotilt folded before Flop (didn't bet)
Seat 4: pindrokk (button) folded before Flop (didn't bet)
Seat 6: teunuss (small blind) folded before Flop


PokerStars Game #102619009511:  Hold'em No Limit ($3/$6 USD) - 2013/08/11 15:04:07 ET
Table 'Tanete V 40-100 bb' 6-max Seat #6 is the button
Seat 1: shevliak ($243 in chips) 
Seat 2: ALBERT910 ($241.24 in chips) 
Seat 3: borntotilt ($600 in chips) 
Seat 4: pindrokk ($806.20 in chips) 
Seat 6: teunuss ($1568 in chips) 
shevliak: posts small blind $3
ALBERT910: posts big blind $6
GregAndrek: sits out 
*** HOLE CARDS ***
borntotilt: folds 
pindrokk: folds 
teunuss: raises $6 to $12
shevliak: folds 
ALBERT910: calls $6
*** FLOP *** [8h 9s 5d]
ALBERT910: checks 
teunuss: bets $18
ALBERT910: raises $24 to $42
teunuss: calls $24
*** TURN *** [8h 9s 5d] [Ad]
ALBERT910: bets $42
teunuss: calls $42
*** RIVER *** [8h 9s 5d Ad] [6h]
ALBERT910: bets $42
teunuss: folds 
Uncalled bet ($42) returned to ALBERT910
ALBERT910 collected $192.20 from pot
ALBERT910: doesn't show hand 
*** SUMMARY ***
Total pot $195 | Rake $2.80 
Board [8h 9s 5d Ad 6h]
Seat 1: shevliak (small blind) folded before Flop
Seat 2: ALBERT910 (big blind) collected ($192.20)
Seat 3: borntotilt folded before Flop (didn't bet)
Seat 4: pindrokk folded before Flop (didn't bet)
Seat 6: teunuss (button) folded on the River


PokerStars Game #102618684552:  Hold'em No Limit ($3/$6 USD) - 2013/08/11 14:56:13 ET
Table 'Tanete V 40-100 bb' 6-max Seat #3 is the button
Seat 3: borntotilt ($600 in chips) 
Seat 6: teunuss ($1556.50 in chips) 
borntotilt: posts small blind $3
teunuss: posts big blind $6
*** HOLE CARDS ***
borntotilt: raises $6 to $12
teunuss: folds 
Uncalled bet ($6) returned to borntotilt
borntotilt collected $12 from pot
borntotilt: doesn't show hand 
*** SUMMARY ***
Total pot $12 | Rake $0 
Seat 3: borntotilt (button) (small blind) collected ($12)
Seat 6: teunuss (big blind) folded before Flop


PokerStars Game #102618687956:  Hold'em No Limit ($3/$6 USD) - 2013/08/11 14:56:19 ET
Table 'Tanete V 40-100 bb' 6-max Seat #6 is the button
Seat 3: borntotilt ($606 in chips) 
Seat 6: teunuss ($1550.50 in chips) 
teunuss: posts small blind $3
borntotilt: posts big blind $6
*** HOLE CARDS ***
teunuss: folds 
Uncalled bet ($3) returned to borntotilt
borntotilt collected $6 from pot
borntotilt: doesn't show hand 
*** SUMMARY ***
Total pot $6 | Rake $0 
Seat 3: borntotilt (big blind) collected ($6)
Seat 6: teunuss (button) (small blind) folded before Flop


PokerStars Game #102618690069:  Hold'em No Limit ($3/$6 USD) - 2013/08/11 14:56:23 ET
Table 'Tanete V 40-100 bb' 6-max Seat #3 is the button
Seat 3: borntotilt ($609 in chips) 
Seat 6: teunuss ($1547.50 in chips) 
borntotilt: posts small blind $3
teunuss: posts big blind $6
*** HOLE CARDS ***
borntotilt: raises $6 to $12
teunuss: calls $6
*** FLOP *** [9c Tc Ts]
teunuss: checks 
borntotilt: bets $18
teunuss: calls $18
*** TURN *** [9c Tc Ts] [8d]
teunuss: checks 
borntotilt: checks 
*** RIVER *** [9c Tc Ts 8d] [2s]
teunuss: bets $45
borntotilt: folds 
Uncalled bet ($45) returned to teunuss
teunuss collected $59.50 from pot
teunuss: doesn't show hand 
*** SUMMARY ***
Total pot $60 | Rake $0.50 
Board [9c Tc Ts 8d 2s]
Seat 3: borntotilt (button) (small blind) folded on the River
Seat 6: teunuss (big blind) collected ($59.50)


PokerStars Game #102618711424:  Hold'em No Limit ($3/$6 USD) - 2013/08/11 14:57:02 ET
Table 'Tanete V 40-100 bb' 6-max Seat #6 is the button
Seat 3: borntotilt ($600 in chips) 
Seat 6: teunuss ($1577 in chips) 
teunuss: posts small blind $3
borntotilt: posts big blind $6
*** HOLE CARDS ***
teunuss: folds 
Uncalled bet ($3) returned to borntotilt
borntotilt collected $6 from pot
borntotilt: doesn't show hand 
*** SUMMARY ***
Total pot $6 | Rake $0 
Seat 3: borntotilt (big blind) collected ($6)
Seat 6: teunuss (button) (small blind) folded before Flop


PokerStars Game #102618714462:  Hold'em No Limit ($3/$6 USD) - 2013/08/11 14:57:08 ET
Table 'Tanete V 40-100 bb' 6-max Seat #3 is the button
Seat 3: borntotilt ($603 in chips) 
Seat 6: teunuss ($1574 in chips) 
borntotilt: posts small blind $3
teunuss: posts big blind $6
*** HOLE CARDS ***
borntotilt: folds 
Uncalled bet ($3) returned to teunuss
teunuss collected $6 from pot
teunuss: doesn't show hand 
*** SUMMARY ***
Total pot $6 | Rake $0 
Seat 3: borntotilt (button) (small blind) folded before Flop
Seat 6: teunuss (big blind) collected ($6)


PokerStars Game #102618716987:  Hold'em No Limit ($3/$6 USD) - 2013/08/11 14:57:13 ET
Table 'Tanete V 40-100 bb' 6-max Seat #6 is the button
Seat 3: borntotilt ($600 in chips) 
Seat 6: teunuss ($1577 in chips) 
teunuss: posts small blind $3
borntotilt: posts big blind $6
*** HOLE CARDS ***
Subv joins the table at seat #5 
teunuss: folds 
Uncalled bet ($3) returned to borntotilt
borntotilt collected $6 from pot
borntotilt: doesn't show hand 
*** SUMMARY ***
Total pot $6 | Rake $0 
Seat 3: borntotilt (big blind) collected ($6)
Seat 6: teunuss (button) (small blind) folded before Flop


PokerStars Game #102618378052:  Hold'em No Limit ($3/$6 USD) - 2013/08/11 14:50:02 ET
Table 'Tanete V 40-100 bb' 6-max Seat #3 is the button
Seat 3: borntotilt ($665.50 in chips) 
Seat 6: teunuss ($1223 in chips) 
borntotilt: posts small blind $3
teunuss: posts big blind $6
*** HOLE CARDS ***
borntotilt: raises $6 to $12
teunuss: folds 
Uncalled bet ($6) returned to borntotilt
borntotilt collected $12 from pot
borntotilt: doesn't show hand 
*** SUMMARY ***
Total pot $12 | Rake $0 
Seat 3: borntotilt (button) (small blind) collected ($12)
Seat 6: teunuss (big blind) folded before Flop


PokerStars Game #102618383840:  Hold'em No Limit ($3/$6 USD) - 2013/08/11 14:50:08 ET
Table 'Tanete V 40-100 bb' 6-max Seat #6 is the button
Seat 3: borntotilt ($671.50 in chips) 
Seat 6: teunuss ($1217 in chips) 
teunuss: posts small blind $3
borntotilt: posts big blind $6
*** HOLE CARDS ***
teunuss: raises $6 to $12
borntotilt: folds 
Uncalled bet ($6) returned to teunuss
teunuss collected $12 from pot
teunuss: doesn't show hand 
*** SUMMARY ***
Total pot $12 | Rake $0 
Seat 3: borntotilt (big blind) folded before Flop
Seat 6: teunuss (button) (small blind) collected ($12)


PokerStars Game #102618394682:  Hold'em No Limit ($3/$6 USD) - 2013/08/11 14:50:20 ET
Table 'Tanete V 40-100 bb' 6-max Seat #3 is the button
Seat 3: borntotilt ($665.50 in chips) 
Seat 6: teunuss ($1223 in chips) 
borntotilt: posts small blind $3
teunuss: posts big blind $6
*** HOLE CARDS ***
borntotilt: raises $6 to $12
teunuss: folds 
Uncalled bet ($6) returned to borntotilt
borntotilt collected $12 from pot
borntotilt: doesn't show hand 
*** SUMMARY ***
Total pot $12 | Rake $0 
Seat 3: borntotilt (button) (small blind) collected ($12)
Seat 6: teunuss (big blind) folded before Flop


PokerStars Game #102618399447:  Hold'em No Limit ($3/$6 USD) - 2013/08/11 14:50:26 ET
Table 'Tanete V 40-100 bb' 6-max Seat #6 is the button
Seat 3: borntotilt ($671.50 in chips) 
Seat 6: teunuss ($1217 in chips) 
teunuss: posts small blind $3
borntotilt: posts big blind $6
*** HOLE CARDS ***
teunuss: folds 
Uncalled bet ($3) returned to borntotilt
borntotilt collected $6 from pot
borntotilt: doesn't show hand 
*** SUMMARY ***
Total pot $6 | Rake $0 
Seat 3: borntotilt (big blind) collected ($6)
Seat 6: teunuss (button) (small blind) folded before Flop


PokerStars Game #102618403558:  Hold'em No Limit ($3/$6 USD) - 2013/08/11 14:50:31 ET
Table 'Tanete V 40-100 bb' 6-max Seat #3 is the button
Seat 3: borntotilt ($674.50 in chips) 
Seat 6: teunuss ($1214 in chips) 
borntotilt: posts small blind $3
teunuss: posts big blind $6
*** HOLE CARDS ***
borntotilt: folds 
Uncalled bet ($3) returned to teunuss
teunuss collected $6 from pot
teunuss: doesn't show hand 
*** SUMMARY ***
Total pot $6 | Rake $0 
Seat 3: borntotilt (button) (small blind) folded before Flop
Seat 6: teunuss (big blind) collected ($6)


PokerStars Game #102618411117:  Hold'em No Limit ($3/$6 USD) - 2013/08/11 14:50:39 ET
Table 'Tanete V 40-100 bb' 6-max Seat #6 is the button
Seat 3: borntotilt ($671.50 in chips) 
Seat 6: teunuss ($1217 in chips) 
teunuss: posts small blind $3
borntotilt: posts big blind $6
*** HOLE CARDS ***
teunuss: raises $6 to $12
borntotilt: calls $6
*** FLOP *** [As 6s 5s]
borntotilt: checks 
teunuss: checks 
*** TURN *** [As 6s 5s] [Ts]
borntotilt: bets $18
teunuss: folds 
Uncalled bet ($18) returned to borntotilt
borntotilt collected $23.50 from pot
borntotilt: doesn't show hand 
*** SUMMARY ***
Total pot $24 | Rake $0.50 
Board [As 6s 5s Ts]
Seat 3: borntotilt (big blind) collected ($23.50)
Seat 6: teunuss (button) (small blind) folded on the Turn


PokerStars Game #102618433513:  Hold'em No Limit ($3/$6 USD) - 2013/08/11 14:51:04 ET
Table 'Tanete V 40-100 bb' 6-max Seat #3 is the button
Seat 3: borntotilt ($683 in chips) 
Seat 6: teunuss ($1205 in chips) 
borntotilt: posts small blind $3
teunuss: posts big blind $6
*** HOLE CARDS ***
borntotilt: raises $6 to $12
teunuss: folds 
Uncalled bet ($6) returned to borntotilt
borntotilt collected $12 from pot
borntotilt: doesn't show hand 
*** SUMMARY ***
Total pot $12 | Rake $0 
Seat 3: borntotilt (button) (small blind) collected ($12)
Seat 6: teunuss (big blind) folded before Flop


PokerStars Game #102618441614:  Hold'em No Limit ($3/$6 USD) - 2013/08/11 14:51:13 ET
Table 'Tanete V 40-100 bb' 6-max Seat #6 is the button
Seat 3: borntotilt ($689 in chips) 
Seat 6: teunuss ($1199 in chips) 
teunuss: posts small blind $3
borntotilt: posts big blind $6
*** HOLE CARDS ***
teunuss: raises $6 to $12
borntotilt: calls $6
*** FLOP *** [9h 8d 4s]
borntotilt: checks 
teunuss: checks 
*** TURN *** [9h 8d 4s] [8h]
borntotilt: bets $20
teunuss: folds 
Uncalled bet ($20) returned to borntotilt
borntotilt collected $23.50 from pot
borntotilt: doesn't show hand 
*** SUMMARY ***
Total pot $24 | Rake $0.50 
Board [9h 8d 4s 8h]
Seat 3: borntotilt (big blind) collected ($23.50)
Seat 6: teunuss (button) (small blind) folded on the Turn


PokerStars Game #102618478467:  Hold'em No Limit ($3/$6 USD) - 2013/08/11 14:51:54 ET
Table 'Tanete V 40-100 bb' 6-max Seat #3 is the button
Seat 3: borntotilt ($700.50 in chips) 
Seat 6: teunuss ($1187 in chips) 
borntotilt: posts small blind $3
teunuss: posts big blind $6
*** HOLE CARDS ***
borntotilt: raises $6 to $12
teunuss: folds 
Uncalled bet ($6) returned to borntotilt
borntotilt collected $12 from pot
borntotilt: doesn't show hand 
*** SUMMARY ***
Total pot $12 | Rake $0 
Seat 3: borntotilt (button) (small blind) collected ($12)
Seat 6: teunuss (big blind) folded before Flop


PokerStars Game #102618490061:  Hold'em No Limit ($3/$6 USD) - 2013/08/11 14:52:07 ET
Table 'Tanete V 40-100 bb' 6-max Seat #6 is the button
Seat 3: borntotilt ($706.50 in chips) 
Seat 6: teunuss ($1181 in chips) 
teunuss: posts small blind $3
borntotilt: posts big blind $6
*** HOLE CARDS ***
teunuss: raises $6 to $12
borntotilt: raises $36 to $48
teunuss: raises $57 to $105
borntotilt: folds 
Uncalled bet ($57) returned to teunuss
teunuss collected $96 from pot
teunuss: doesn't show hand 
*** SUMMARY ***
Total pot $96 | Rake $0 
Seat 3: borntotilt (big blind) folded before Flop
Seat 6: teunuss (button) (small blind) collected ($96)


PokerStars Game #102618523313:  Hold'em No Limit ($3/$6 USD) - 2013/08/11 14:52:44 ET
Table 'Tanete V 40-100 bb' 6-max Seat #3 is the button
Seat 3: borntotilt ($658.50 in chips) 
Seat 6: teunuss ($1229 in chips) 
borntotilt: posts small blind $3
teunuss: posts big blind $6
*** HOLE CARDS ***
borntotilt: raises $6 to $12
teunuss: raises $33 to $45
borntotilt: folds 
Uncalled bet ($33) returned to teunuss
teunuss collected $24 from pot
teunuss: doesn't show hand 
*** SUMMARY ***
Total pot $24 | Rake $0 
Seat 3: borntotilt (button) (small blind) folded before Flop
Seat 6: teunuss (big blind) collected ($24)


PokerStars Game #102618541307:  Hold'em No Limit ($3/$6 USD) - 2013/08/11 14:53:04 ET
Table 'Tanete V 40-100 bb' 6-max Seat #6 is the button
Seat 3: borntotilt ($646.50 in chips) 
Seat 6: teunuss ($1241 in chips) 
teunuss: posts small blind $3
borntotilt: posts big blind $6
*** HOLE CARDS ***
teunuss: raises $6 to $12
borntotilt: raises $36 to $48
teunuss: calls $36
*** FLOP *** [Qh 4s 7h]
borntotilt: bets $56
teunuss: folds 
Uncalled bet ($56) returned to borntotilt
borntotilt collected $95.50 from pot
borntotilt: doesn't show hand 
*** SUMMARY ***
Total pot $96 | Rake $0.50 
Board [Qh 4s 7h]
Seat 3: borntotilt (big blind) collected ($95.50)
Seat 6: teunuss (button) (small blind) folded on the Flop


PokerStars Game #102618570836:  Hold'em No Limit ($3/$6 USD) - 2013/08/11 14:53:38 ET
Table 'Tanete V 40-100 bb' 6-max Seat #3 is the button
Seat 3: borntotilt ($694 in chips) 
Seat 6: teunuss ($1193 in chips) 
borntotilt: posts small blind $3
teunuss: posts big blind $6
*** HOLE CARDS ***
borntotilt: raises $6 to $12
teunuss: calls $6
*** FLOP *** [Jc 5h 9d]
teunuss: checks 
borntotilt: bets $18
teunuss: calls $18
*** TURN *** [Jc 5h 9d] [8d]
teunuss: checks 
borntotilt: bets $48
teunuss: calls $48
*** RIVER *** [Jc 5h 9d 8d] [9c]
teunuss: checks 
borntotilt: checks 
*** SHOW DOWN ***
teunuss: shows [Kd 5d] (two pair, Nines and Fives)
borntotilt: shows [Js 3h] (two pair, Jacks and Nines)
borntotilt collected $155.50 from pot
*** SUMMARY ***
Total pot $156 | Rake $0.50 
Board [Jc 5h 9d 8d 9c]
Seat 3: borntotilt (button) (small blind) showed [Js 3h] and won ($155.50) with two pair, Jacks and Nines
Seat 6: teunuss (big blind) showed [Kd 5d] and lost with two pair, Nines and Fives


PokerStars Game #102618616803:  Hold'em No Limit ($3/$6 USD) - 2013/08/11 14:54:30 ET
Table 'Tanete V 40-100 bb' 6-max Seat #6 is the button
Seat 3: borntotilt ($771.50 in chips) 
Seat 6: teunuss ($1115 in chips) 
teunuss: posts small blind $3
borntotilt: posts big blind $6
*** HOLE CARDS ***
teunuss: raises $6 to $12
borntotilt: calls $6
*** FLOP *** [8c Jc Ks]
borntotilt: checks 
teunuss: bets $15
borntotilt: raises $33 to $48
teunuss: calls $33
*** TURN *** [8c Jc Ks] [As]
borntotilt: bets $106
teunuss: calls $106
*** RIVER *** [8c Jc Ks As] [9d]
borntotilt: bets $276
teunuss: raises $673 to $949 and is all-in
borntotilt: folds 
Uncalled bet ($673) returned to teunuss
teunuss collected $883.50 from pot
teunuss: doesn't show hand 
*** SUMMARY ***
Total pot $884 | Rake $0.50 
Board [8c Jc Ks As 9d]
Seat 3: borntotilt (big blind) folded on the River
Seat 6: teunuss (button) (small blind) collected ($883.50)


PokerStars Game #102620473899:  Hold'em No Limit ($3/$6 USD) - 2013/08/11 15:30:19 ET
Table 'Tanete V 40-100 bb' 6-max Seat #2 is the button
Seat 1: shevliak ($272.27 in chips) 
Seat 2: ALBERT910 ($360.97 in chips) 
Seat 3: SEREJkE29 ($699.48 in chips) 
Seat 4: pindrokk ($808.40 in chips) 
Seat 5: GregAndrek ($600 in chips) 
Seat 6: teunuss ($1508.85 in chips) 
SEREJkE29: posts small blind $3
pindrokk: posts big blind $6
*** HOLE CARDS ***
GregAndrek: folds 
teunuss: folds 
shevliak: folds 
ALBERT910: calls $6
SEREJkE29: calls $3
pindrokk: checks 
*** FLOP *** [6c 5h Th]
SEREJkE29: checks 
pindrokk: bets $13
ALBERT910: folds 
SEREJkE29: folds 
Uncalled bet ($13) returned to pindrokk
pindrokk collected $17.19 from pot
pindrokk: doesn't show hand 
*** SUMMARY ***
Total pot $18 | Rake $0.81 
Board [6c 5h Th]
Seat 1: shevliak folded before Flop (didn't bet)
Seat 2: ALBERT910 (button) folded on the Flop
Seat 3: SEREJkE29 (small blind) folded on the Flop
Seat 4: pindrokk (big blind) collected ($17.19)
Seat 5: GregAndrek folded before Flop (didn't bet)
Seat 6: teunuss folded before Flop (didn't bet)


PokerStars Game #102620525868:  Hold'em No Limit ($3/$6 USD) - 2013/08/11 15:31:15 ET
Table 'Tanete V 40-100 bb' 6-max Seat #3 is the button
Seat 1: shevliak ($272.27 in chips) 
Seat 2: ALBERT910 ($354.97 in chips) 
Seat 3: SEREJkE29 ($693.48 in chips) 
Seat 4: pindrokk ($819.59 in chips) 
Seat 5: GregAndrek ($600 in chips) 
Seat 6: teunuss ($1508.85 in chips) 
pindrokk: posts small blind $3
GregAndrek: posts big blind $6
*** HOLE CARDS ***
teunuss: folds 
shevliak: folds 
ALBERT910: folds 
SEREJkE29: raises $6 to $12
pindrokk: folds 
GregAndrek: folds 
Uncalled bet ($6) returned to SEREJkE29
SEREJkE29 collected $15 from pot
SEREJkE29: doesn't show hand 
*** SUMMARY ***
Total pot $15 | Rake $0 
Seat 1: shevliak folded before Flop (didn't bet)
Seat 2: ALBERT910 folded before Flop (didn't bet)
Seat 3: SEREJkE29 (button) collected ($15)
Seat 4: pindrokk (small blind) folded before Flop
Seat 5: GregAndrek (big blind) folded before Flop
Seat 6: teunuss folded before Flop (didn't bet)


PokerStars Game #102620553580:  Hold'em No Limit ($3/$6 USD) - 2013/08/11 15:31:46 ET
Table 'Tanete V 40-100 bb' 6-max Seat #4 is the button
Seat 1: shevliak ($272.27 in chips) 
Seat 2: ALBERT910 ($354.97 in chips) 
Seat 3: SEREJkE29 ($702.48 in chips) 
Seat 4: pindrokk ($816.59 in chips) 
Seat 5: GregAndrek ($600 in chips) 
Seat 6: teunuss ($1508.85 in chips) 
GregAndrek: posts small blind $3
teunuss: posts big blind $6
*** HOLE CARDS ***
shevliak: folds 
ALBERT910: folds 
SEREJkE29: folds 
pindrokk: raises $6 to $12
GregAndrek: folds 
teunuss: raises $36 to $48
pindrokk: folds 
Uncalled bet ($36) returned to teunuss
teunuss collected $27 from pot
teunuss: doesn't show hand 
*** SUMMARY ***
Total pot $27 | Rake $0 
Seat 1: shevliak folded before Flop (didn't bet)
Seat 2: ALBERT910 folded before Flop (didn't bet)
Seat 3: SEREJkE29 folded before Flop (didn't bet)
Seat 4: pindrokk (button) folded before Flop
Seat 5: GregAndrek (small blind) folded before Flop
Seat 6: teunuss (big blind) collected ($27)


PokerStars Game #102620577068:  Hold'em No Limit ($3/$6 USD) - 2013/08/11 15:32:11 ET
Table 'Tanete V 40-100 bb' 6-max Seat #5 is the button
Seat 1: shevliak ($272.27 in chips) 
Seat 2: ALBERT910 ($354.97 in chips) 
Seat 3: SEREJkE29 ($702.48 in chips) 
Seat 4: pindrokk ($804.59 in chips) 
Seat 5: GregAndrek ($600 in chips) 
Seat 6: teunuss ($1523.85 in chips) 
teunuss: posts small blind $3
shevliak: posts big blind $6
*** HOLE CARDS ***
ALBERT910 has timed out
ALBERT910: folds 
SEREJkE29: folds 
pindrokk: folds 
GregAndrek: folds 
teunuss: folds 
Uncalled bet ($3) returned to shevliak
shevliak collected $6 from pot
shevliak: doesn't show hand 
*** SUMMARY ***
Total pot $6 | Rake $0 
Seat 1: shevliak (big blind) collected ($6)
Seat 2: ALBERT910 folded before Flop (didn't bet)
Seat 3: SEREJkE29 folded before Flop (didn't bet)
Seat 4: pindrokk folded before Flop (didn't bet)
Seat 5: GregAndrek (button) folded before Flop (didn't bet)
Seat 6: teunuss (small blind) folded before Flop


PokerStars Game #102620620314:  Hold'em No Limit ($3/$6 USD) - 2013/08/11 15:32:59 ET
Table 'Tanete V 40-100 bb' 6-max Seat #6 is the button
Seat 1: shevliak ($275.27 in chips) 
Seat 3: SEREJkE29 ($702.48 in chips) 
Seat 4: pindrokk ($804.59 in chips) 
Seat 5: GregAndrek ($600 in chips) 
Seat 6: teunuss ($1520.85 in chips) 
shevliak: posts small blind $3
SEREJkE29: posts big blind $6
*** HOLE CARDS ***
pindrokk: folds 
GregAndrek: folds 
teunuss: raises $6 to $12
shevliak: folds 
SEREJkE29: calls $6
*** FLOP *** [9h Qh 6c]
SEREJkE29: checks 
teunuss: bets $18
SEREJkE29: folds 
Uncalled bet ($18) returned to teunuss
teunuss collected $25.78 from pot
teunuss: doesn't show hand 
*** SUMMARY ***
Total pot $27 | Rake $1.22 
Board [9h Qh 6c]
Seat 1: shevliak (small blind) folded before Flop
Seat 3: SEREJkE29 (big blind) folded on the Flop
Seat 4: pindrokk folded before Flop (didn't bet)
Seat 5: GregAndrek folded before Flop (didn't bet)
Seat 6: teunuss (button) collected ($25.78)


PokerStars Game #102620661039:  Hold'em No Limit ($3/$6 USD) - 2013/08/11 15:33:44 ET
Table 'Tanete V 40-100 bb' 6-max Seat #1 is the button
Seat 1: shevliak ($272.27 in chips) 
Seat 3: SEREJkE29 ($690.48 in chips) 
Seat 4: pindrokk ($804.59 in chips) 
Seat 5: GregAndrek ($600 in chips) 
Seat 6: teunuss ($1534.63 in chips) 
ALBERT910 will be allowed to play after the button
SEREJkE29: posts small blind $3
pindrokk: posts big blind $6
*** HOLE CARDS ***
GregAndrek: folds 
teunuss: raises $9 to $15
shevliak: folds 
SEREJkE29: folds 
pindrokk: folds 
Uncalled bet ($9) returned to teunuss
teunuss collected $15 from pot
teunuss: doesn't show hand 
*** SUMMARY ***
Total pot $15 | Rake $0 
Seat 1: shevliak (button) folded before Flop (didn't bet)
Seat 3: SEREJkE29 (small blind) folded before Flop
Seat 4: pindrokk (big blind) folded before Flop
Seat 5: GregAndrek folded before Flop (didn't bet)
Seat 6: teunuss collected ($15)


PokerStars Game #102620678892:  Hold'em No Limit ($3/$6 USD) - 2013/08/11 15:34:03 ET
Table 'Tanete V 40-100 bb' 6-max Seat #3 is the button
Seat 1: shevliak ($272.27 in chips) 
Seat 2: ALBERT910 ($354.97 in chips) 
Seat 3: SEREJkE29 ($687.48 in chips) 
Seat 4: pindrokk ($798.59 in chips) 
Seat 5: GregAndrek ($600 in chips) 
Seat 6: teunuss ($1543.63 in chips) 
pindrokk: posts small blind $3
GregAndrek: posts big blind $6
ALBERT910: posts small & big blinds $9
*** HOLE CARDS ***
teunuss: folds 
shevliak: folds 
ALBERT910: checks 
SEREJkE29: raises $12 to $18
pindrokk: folds 
GregAndrek: folds 
ALBERT910: folds 
Uncalled bet ($12) returned to SEREJkE29
SEREJkE29 collected $24 from pot
SEREJkE29: doesn't show hand 
*** SUMMARY ***
Total pot $24 | Rake $0 
Seat 1: shevliak folded before Flop (didn't bet)
Seat 2: ALBERT910 folded before Flop
Seat 3: SEREJkE29 (button) collected ($24)
Seat 4: pindrokk (small blind) folded before Flop
Seat 5: GregAndrek (big blind) folded before Flop
Seat 6: teunuss folded before Flop (didn't bet)


PokerStars Game #102620698615:  Hold'em No Limit ($3/$6 USD) - 2013/08/11 15:34:25 ET
Table 'Tanete V 40-100 bb' 6-max Seat #4 is the button
Seat 1: shevliak ($272.27 in chips) 
Seat 2: ALBERT910 ($345.97 in chips) 
Seat 3: SEREJkE29 ($705.48 in chips) 
Seat 4: pindrokk ($795.59 in chips) 
Seat 5: GregAndrek ($600 in chips) 
Seat 6: teunuss ($1543.63 in chips) 
GregAndrek: posts small blind $3
teunuss: posts big blind $6
*** HOLE CARDS ***
shevliak: raises $6.90 to $12.90
ALBERT910: folds 
SEREJkE29: folds 
pindrokk: folds 
GregAndrek: folds 
teunuss: folds 
Uncalled bet ($6.90) returned to shevliak
shevliak collected $15 from pot
shevliak: doesn't show hand 
*** SUMMARY ***
Total pot $15 | Rake $0 
Seat 1: shevliak collected ($15)
Seat 2: ALBERT910 folded before Flop (didn't bet)
Seat 3: SEREJkE29 folded before Flop (didn't bet)
Seat 4: pindrokk (button) folded before Flop (didn't bet)
Seat 5: GregAndrek (small blind) folded before Flop
Seat 6: teunuss (big blind) folded before Flop


PokerStars Game #102620717732:  Hold'em No Limit ($3/$6 USD) - 2013/08/11 15:34:46 ET
Table 'Tanete V 40-100 bb' 6-max Seat #5 is the button
Seat 1: shevliak ($281.27 in chips) 
Seat 2: ALBERT910 ($345.97 in chips) 
Seat 3: SEREJkE29 ($705.48 in chips) 
Seat 4: pindrokk ($795.59 in chips) 
Seat 5: GregAndrek ($600 in chips) 
Seat 6: teunuss ($1537.63 in chips) 
teunuss: posts small blind $3
shevliak: posts big blind $6
*** HOLE CARDS ***
ALBERT910: folds 
SEREJkE29: folds 
pindrokk has timed out
pindrokk: folds 
GregAndrek: raises $6 to $12
teunuss: folds 
shevliak: folds 
Uncalled bet ($6) returned to GregAndrek
GregAndrek collected $15 from pot
GregAndrek: doesn't show hand 
*** SUMMARY ***
Total pot $15 | Rake $0 
Seat 1: shevliak (big blind) folded before Flop
Seat 2: ALBERT910 folded before Flop (didn't bet)
Seat 3: SEREJkE29 folded before Flop (didn't bet)
Seat 4: pindrokk folded before Flop (didn't bet)
Seat 5: GregAndrek (button) collected ($15)
Seat 6: teunuss (small blind) folded before Flop


PokerStars Game #102620236680:  Hold'em No Limit ($3/$6 USD) - 2013/08/11 15:25:59 ET
Table 'Tanete V 40-100 bb' 6-max Seat #2 is the button
Seat 1: shevliak ($282.71 in chips) 
Seat 2: ALBERT910 ($350.45 in chips) 
Seat 3: SEREJkE29 ($714.48 in chips) 
Seat 4: pindrokk ($817.40 in chips) 
Seat 5: GregAndrek ($603.20 in chips) 
Seat 6: teunuss ($1481.15 in chips) 
SEREJkE29: posts small blind $3
pindrokk: posts big blind $6
*** HOLE CARDS ***
GregAndrek: folds 
teunuss: folds 
shevliak: folds 
ALBERT910: raises $9 to $15
SEREJkE29: folds 
pindrokk: calls $9
*** FLOP *** [2h Kc 4s]
pindrokk: checks 
ALBERT910: bets $18
pindrokk: folds 
Uncalled bet ($18) returned to ALBERT910
ALBERT910 collected $31.52 from pot
ALBERT910: doesn't show hand 
*** SUMMARY ***
Total pot $33 | Rake $1.48 
Board [2h Kc 4s]
Seat 1: shevliak folded before Flop (didn't bet)
Seat 2: ALBERT910 (button) collected ($31.52)
Seat 3: SEREJkE29 (small blind) folded before Flop
Seat 4: pindrokk (big blind) folded on the Flop
Seat 5: GregAndrek folded before Flop (didn't bet)
Seat 6: teunuss folded before Flop (didn't bet)


PokerStars Game #102620299558:  Hold'em No Limit ($3/$6 USD) - 2013/08/11 15:27:08 ET
Table 'Tanete V 40-100 bb' 6-max Seat #3 is the button
Seat 1: shevliak ($282.71 in chips) 
Seat 2: ALBERT910 ($366.97 in chips) 
Seat 3: SEREJkE29 ($711.48 in chips) 
Seat 4: pindrokk ($802.40 in chips) 
Seat 5: GregAndrek ($603.20 in chips) 
Seat 6: teunuss ($1481.15 in chips) 
pindrokk: posts small blind $3
GregAndrek: posts big blind $6
*** HOLE CARDS ***
teunuss: folds 
shevliak: folds 
ALBERT910: folds 
SEREJkE29: folds 
pindrokk: raises $9 to $15
GregAndrek: folds 
Uncalled bet ($9) returned to pindrokk
pindrokk collected $12 from pot
pindrokk: doesn't show hand 
*** SUMMARY ***
Total pot $12 | Rake $0 
Seat 1: shevliak folded before Flop (didn't bet)
Seat 2: ALBERT910 folded before Flop (didn't bet)
Seat 3: SEREJkE29 (button) folded before Flop (didn't bet)
Seat 4: pindrokk (small blind) collected ($12)
Seat 5: GregAndrek (big blind) folded before Flop
Seat 6: teunuss folded before Flop (didn't bet)


PokerStars Game #102620326647:  Hold'em No Limit ($3/$6 USD) - 2013/08/11 15:27:38 ET
Table 'Tanete V 40-100 bb' 6-max Seat #4 is the button
Seat 1: shevliak ($282.71 in chips) 
Seat 2: ALBERT910 ($366.97 in chips) 
Seat 3: SEREJkE29 ($711.48 in chips) 
Seat 4: pindrokk ($808.40 in chips) 
Seat 5: GregAndrek ($600 in chips) 
Seat 6: teunuss ($1481.15 in chips) 
GregAndrek: posts small blind $3
teunuss: posts big blind $6
*** HOLE CARDS ***
shevliak: raises $6.90 to $12.90
ALBERT910: folds 
SEREJkE29: folds 
pindrokk: folds 
GregAndrek: folds 
teunuss: calls $6.90
*** FLOP *** [8h Kh Ah]
teunuss: checks 
shevliak: bets $17.60
teunuss: calls $17.60
*** TURN *** [8h Kh Ah] [Kd]
teunuss: checks 
shevliak: checks 
*** RIVER *** [8h Kh Ah Kd] [2d]
teunuss: bets $36
shevliak: folds 
Uncalled bet ($36) returned to teunuss
teunuss collected $61.20 from pot
teunuss: doesn't show hand 
*** SUMMARY ***
Total pot $64 | Rake $2.80 
Board [8h Kh Ah Kd 2d]
Seat 1: shevliak folded on the River
Seat 2: ALBERT910 folded before Flop (didn't bet)
Seat 3: SEREJkE29 folded before Flop (didn't bet)
Seat 4: pindrokk (button) folded before Flop (didn't bet)
Seat 5: GregAndrek (small blind) folded before Flop
Seat 6: teunuss (big blind) collected ($61.20)


PokerStars Game #102620382141:  Hold'em No Limit ($3/$6 USD) - 2013/08/11 15:28:38 ET
Table 'Tanete V 40-100 bb' 6-max Seat #5 is the button
Seat 1: shevliak ($252.21 in chips) 
Seat 2: ALBERT910 ($366.97 in chips) 
Seat 3: SEREJkE29 ($711.48 in chips) 
Seat 4: pindrokk ($808.40 in chips) 
Seat 5: GregAndrek ($600 in chips) 
Seat 6: teunuss ($1511.85 in chips) 
teunuss: posts small blind $3
shevliak: posts big blind $6
*** HOLE CARDS ***
ALBERT910: calls $6
SEREJkE29: calls $6
pindrokk: folds 
GregAndrek: folds 
teunuss: folds 
shevliak: checks 
*** FLOP *** [7d Qc 3c]
shevliak: bets $15
ALBERT910: folds 
SEREJkE29: folds 
Uncalled bet ($15) returned to shevliak
shevliak collected $20.06 from pot
shevliak: doesn't show hand 
*** SUMMARY ***
Total pot $21 | Rake $0.94 
Board [7d Qc 3c]
Seat 1: shevliak (big blind) collected ($20.06)
Seat 2: ALBERT910 folded on the Flop
Seat 3: SEREJkE29 folded on the Flop
Seat 4: pindrokk folded before Flop (didn't bet)
Seat 5: GregAndrek (button) folded before Flop (didn't bet)
Seat 6: teunuss (small blind) folded before Flop


PokerStars Game #102620418976:  Hold'em No Limit ($3/$6 USD) - 2013/08/11 15:29:19 ET
Table 'Tanete V 40-100 bb' 6-max Seat #6 is the button
Seat 1: shevliak ($266.27 in chips) 
Seat 2: ALBERT910 ($360.97 in chips) 
Seat 3: SEREJkE29 ($705.48 in chips) 
Seat 4: pindrokk ($808.40 in chips) 
Seat 5: GregAndrek ($600 in chips) 
Seat 6: teunuss ($1508.85 in chips) 
shevliak: posts small blind $3
ALBERT910: posts big blind $6
*** HOLE CARDS ***
SEREJkE29: folds 
pindrokk: folds 
GregAndrek: folds 
teunuss: folds 
shevliak: folds 
Uncalled bet ($3) returned to ALBERT910
ALBERT910 collected $6 from pot
ALBERT910: doesn't show hand 
*** SUMMARY ***
Total pot $6 | Rake $0 
Seat 1: shevliak (small blind) folded before Flop
Seat 2: ALBERT910 (big blind) collected ($6)
Seat 3: SEREJkE29 folded before Flop (didn't bet)
Seat 4: pindrokk folded before Flop (didn't bet)
Seat 5: GregAndrek folded before Flop (didn't bet)
Seat 6: teunuss (button) folded before Flop (didn't bet)


PokerStars Game #102620447362:  Hold'em No Limit ($3/$6 USD) - 2013/08/11 15:29:50 ET
Table 'Tanete V 40-100 bb' 6-max Seat #1 is the button
Seat 1: shevliak ($263.27 in chips) 
Seat 2: ALBERT910 ($363.97 in chips) 
Seat 3: SEREJkE29 ($705.48 in chips) 
Seat 4: pindrokk ($808.40 in chips) 
Seat 5: GregAndrek ($600 in chips) 
Seat 6: teunuss ($1508.85 in chips) 
ALBERT910: posts small blind $3
SEREJkE29: posts big blind $6
*** HOLE CARDS ***
pindrokk: folds 
GregAndrek: folds 
teunuss: folds 
shevliak: raises $6.90 to $12.90
ALBERT910: folds 
SEREJkE29: folds 
Uncalled bet ($6.90) returned to shevliak
shevliak collected $15 from pot
shevliak: doesn't show hand 
*** SUMMARY ***
Total pot $15 | Rake $0 
Seat 1: shevliak (button) collected ($15)
Seat 2: ALBERT910 (small blind) folded before Flop
Seat 3: SEREJkE29 (big blind) folded before Flop
Seat 4: pindrokk folded before Flop (didn't bet)
Seat 5: GregAndrek folded before Flop (didn't bet)
Seat 6: teunuss folded before Flop (didn't bet)


PokerStars Game #102619921345:  Hold'em No Limit ($3/$6 USD) - 2013/08/11 15:20:18 ET
Table 'Tanete V 40-100 bb' 6-max Seat #6 is the button
Seat 1: shevliak ($240 in chips) 
Seat 2: ALBERT910 ($359.45 in chips) 
Seat 3: SEREJkE29 ($633.98 in chips) 
Seat 4: pindrokk ($829.40 in chips) 
Seat 5: GregAndrek ($675.20 in chips) 
Seat 6: teunuss ($1520.15 in chips) 
shevliak: posts small blind $3
ALBERT910: posts big blind $6
*** HOLE CARDS ***
SEREJkE29: raises $12 to $18
pindrokk: folds 
GregAndrek: folds 
teunuss: folds 
shevliak: calls $15
ALBERT910: folds 
*** FLOP *** [Ah Qd Jh]
shevliak: checks 
SEREJkE29: checks 
*** TURN *** [Ah Qd Jh] [9s]
shevliak: bets $30
SEREJkE29: folds 
Uncalled bet ($30) returned to shevliak
shevliak collected $40.11 from pot
shevliak: doesn't show hand 
*** SUMMARY ***
Total pot $42 | Rake $1.89 
Board [Ah Qd Jh 9s]
Seat 1: shevliak (small blind) collected ($40.11)
Seat 2: ALBERT910 (big blind) folded before Flop
Seat 3: SEREJkE29 folded on the Turn
Seat 4: pindrokk folded before Flop (didn't bet)
Seat 5: GregAndrek folded before Flop (didn't bet)
Seat 6: teunuss (button) folded before Flop (didn't bet)


PokerStars Game #102619959850:  Hold'em No Limit ($3/$6 USD) - 2013/08/11 15:21:00 ET
Table 'Tanete V 40-100 bb' 6-max Seat #1 is the button
Seat 1: shevliak ($262.11 in chips) 
Seat 2: ALBERT910 ($353.45 in chips) 
Seat 3: SEREJkE29 ($615.98 in chips) 
Seat 4: pindrokk ($829.40 in chips) 
Seat 5: GregAndrek ($675.20 in chips) 
Seat 6: teunuss ($1520.15 in chips) 
ALBERT910: posts small blind $3
SEREJkE29: posts big blind $6
*** HOLE CARDS ***
pindrokk: folds 
GregAndrek: folds 
teunuss: folds 
shevliak: raises $6.90 to $12.90
ALBERT910: folds 
SEREJkE29: calls $6.90
*** FLOP *** [6d Td Ts]
SEREJkE29: checks 
shevliak: bets $17.60
SEREJkE29: folds 
Uncalled bet ($17.60) returned to shevliak
shevliak collected $27.50 from pot
shevliak: doesn't show hand 
*** SUMMARY ***
Total pot $28.80 | Rake $1.30 
Board [6d Td Ts]
Seat 1: shevliak (button) collected ($27.50)
Seat 2: ALBERT910 (small blind) folded before Flop
Seat 3: SEREJkE29 (big blind) folded on the Flop
Seat 4: pindrokk folded before Flop (didn't bet)
Seat 5: GregAndrek folded before Flop (didn't bet)
Seat 6: teunuss folded before Flop (didn't bet)


PokerStars Game #102619989654:  Hold'em No Limit ($3/$6 USD) - 2013/08/11 15:21:31 ET
Table 'Tanete V 40-100 bb' 6-max Seat #2 is the button
Seat 1: shevliak ($276.71 in chips) 
Seat 2: ALBERT910 ($350.45 in chips) 
Seat 3: SEREJkE29 ($603.08 in chips) 
Seat 4: pindrokk ($829.40 in chips) 
Seat 5: GregAndrek ($675.20 in chips) 
Seat 6: teunuss ($1520.15 in chips) 
SEREJkE29: posts small blind $3
pindrokk: posts big blind $6
*** HOLE CARDS ***
GregAndrek: raises $12 to $18
teunuss: folds 
shevliak: folds 
ALBERT910: folds 
SEREJkE29: folds 
pindrokk: folds 
Uncalled bet ($12) returned to GregAndrek
GregAndrek collected $15 from pot
GregAndrek: doesn't show hand 
*** SUMMARY ***
Total pot $15 | Rake $0 
Seat 1: shevliak folded before Flop (didn't bet)
Seat 2: ALBERT910 (button) folded before Flop (didn't bet)
Seat 3: SEREJkE29 (small blind) folded before Flop
Seat 4: pindrokk (big blind) folded before Flop
Seat 5: GregAndrek collected ($15)
Seat 6: teunuss folded before Flop (didn't bet)


PokerStars Game #102620032658:  Hold'em No Limit ($3/$6 USD) - 2013/08/11 15:22:18 ET
Table 'Tanete V 40-100 bb' 6-max Seat #3 is the button
Seat 1: shevliak ($276.71 in chips) 
Seat 2: ALBERT910 ($350.45 in chips) 
Seat 3: SEREJkE29 ($600.08 in chips) 
Seat 4: pindrokk ($823.40 in chips) 
Seat 5: GregAndrek ($684.20 in chips) 
Seat 6: teunuss ($1520.15 in chips) 
pindrokk: posts small blind $3
GregAndrek: posts big blind $6
*** HOLE CARDS ***
teunuss: folds 
shevliak: folds 
ALBERT910: folds 
SEREJkE29: folds 
pindrokk: raises $9 to $15
GregAndrek: folds 
Uncalled bet ($9) returned to pindrokk
pindrokk collected $12 from pot
pindrokk: doesn't show hand 
*** SUMMARY ***
Total pot $12 | Rake $0 
Seat 1: shevliak folded before Flop (didn't bet)
Seat 2: ALBERT910 folded before Flop (didn't bet)
Seat 3: SEREJkE29 (button) folded before Flop (didn't bet)
Seat 4: pindrokk (small blind) collected ($12)
Seat 5: GregAndrek (big blind) folded before Flop
Seat 6: teunuss folded before Flop (didn't bet)


PokerStars Game #102620065269:  Hold'em No Limit ($3/$6 USD) - 2013/08/11 15:22:53 ET
Table 'Tanete V 40-100 bb' 6-max Seat #4 is the button
Seat 1: shevliak ($276.71 in chips) 
Seat 2: ALBERT910 ($350.45 in chips) 
Seat 3: SEREJkE29 ($600.08 in chips) 
Seat 4: pindrokk ($829.40 in chips) 
Seat 5: GregAndrek ($678.20 in chips) 
Seat 6: teunuss ($1520.15 in chips) 
GregAndrek: posts small blind $3
teunuss: posts big blind $6
*** HOLE CARDS ***
shevliak: folds 
ALBERT910: folds 
SEREJkE29: raises $9 to $15
pindrokk: folds 
GregAndrek: folds 
teunuss: calls $9
*** FLOP *** [7d Ah 9h]
teunuss: checks 
SEREJkE29: checks 
*** TURN *** [7d Ah 9h] [6c]
teunuss: checks 
SEREJkE29: checks 
*** RIVER *** [7d Ah 9h 6c] [2h]
teunuss: bets $21
SEREJkE29: calls $21
*** SHOW DOWN ***
teunuss: shows [Qs Jh] (high card Ace)
SEREJkE29: shows [8d Ad] (a pair of Aces)
SEREJkE29 collected $72.20 from pot
*** SUMMARY ***
Total pot $75 | Rake $2.80 
Board [7d Ah 9h 6c 2h]
Seat 1: shevliak folded before Flop (didn't bet)
Seat 2: ALBERT910 folded before Flop (didn't bet)
Seat 3: SEREJkE29 showed [8d Ad] and won ($72.20) with a pair of Aces
Seat 4: pindrokk (button) folded before Flop (didn't bet)
Seat 5: GregAndrek (small blind) folded before Flop
Seat 6: teunuss (big blind) showed [Qs Jh] and lost with high card Ace


PokerStars Game #102620111798:  Hold'em No Limit ($3/$6 USD) - 2013/08/11 15:23:43 ET
Table 'Tanete V 40-100 bb' 6-max Seat #5 is the button
Seat 1: shevliak ($276.71 in chips) 
Seat 2: ALBERT910 ($350.45 in chips) 
Seat 3: SEREJkE29 ($636.28 in chips) 
Seat 4: pindrokk ($829.40 in chips) 
Seat 5: GregAndrek ($675.20 in chips) 
Seat 6: teunuss ($1484.15 in chips) 
teunuss: posts small blind $3
shevliak: posts big blind $6
*** HOLE CARDS ***
ALBERT910: folds 
SEREJkE29: folds 
pindrokk: raises $6 to $12
GregAndrek: calls $12
teunuss: folds 
shevliak: raises $27.30 to $39.30
pindrokk: folds 
GregAndrek: folds 
Uncalled bet ($27.30) returned to shevliak
shevliak collected $39 from pot
shevliak: doesn't show hand 
*** SUMMARY ***
Total pot $39 | Rake $0 
Seat 1: shevliak (big blind) collected ($39)
Seat 2: ALBERT910 folded before Flop (didn't bet)
Seat 3: SEREJkE29 folded before Flop (didn't bet)
Seat 4: pindrokk folded before Flop
Seat 5: GregAndrek (button) folded before Flop
Seat 6: teunuss (small blind) folded before Flop


PokerStars Game #102620163654:  Hold'em No Limit ($3/$6 USD) - 2013/08/11 15:24:39 ET
Table 'Tanete V 40-100 bb' 6-max Seat #6 is the button
Seat 1: shevliak ($303.71 in chips) 
Seat 2: ALBERT910 ($350.45 in chips) 
Seat 3: SEREJkE29 ($636.28 in chips) 
Seat 4: pindrokk ($817.40 in chips) 
Seat 5: GregAndrek ($663.20 in chips) 
Seat 6: teunuss ($1481.15 in chips) 
shevliak: posts small blind $3
ALBERT910: posts big blind $6
*** HOLE CARDS ***
SEREJkE29: folds 
pindrokk: folds 
GregAndrek: folds 
teunuss: folds 
shevliak: folds 
Uncalled bet ($3) returned to ALBERT910
ALBERT910 collected $6 from pot
ALBERT910: doesn't show hand 
*** SUMMARY ***
Total pot $6 | Rake $0 
Seat 1: shevliak (small blind) folded before Flop
Seat 2: ALBERT910 (big blind) collected ($6)
Seat 3: SEREJkE29 folded before Flop (didn't bet)
Seat 4: pindrokk folded before Flop (didn't bet)
Seat 5: GregAndrek folded before Flop (didn't bet)
Seat 6: teunuss (button) folded before Flop (didn't bet)


PokerStars Game #102620181214:  Hold'em No Limit ($3/$6 USD) - 2013/08/11 15:24:59 ET
Table 'Tanete V 40-100 bb' 6-max Seat #1 is the button
Seat 1: shevliak ($300.71 in chips) 
Seat 2: ALBERT910 ($353.45 in chips) 
Seat 3: SEREJkE29 ($636.28 in chips) 
Seat 4: pindrokk ($817.40 in chips) 
Seat 5: GregAndrek ($663.20 in chips) 
Seat 6: teunuss ($1481.15 in chips) 
ALBERT910: posts small blind $3
SEREJkE29: posts big blind $6
*** HOLE CARDS ***
pindrokk: folds 
GregAndrek: raises $12 to $18
teunuss: folds 
shevliak: calls $18
ALBERT910: folds 
SEREJkE29: calls $12
*** FLOP *** [8c 5s 5c]
SEREJkE29: checks 
GregAndrek: bets $42
shevliak: folds 
SEREJkE29: raises $72 to $114
GregAndrek: folds 
Uncalled bet ($72) returned to SEREJkE29
SEREJkE29 collected $138.20 from pot
SEREJkE29: doesn't show hand 
*** SUMMARY ***
Total pot $141 | Rake $2.80 
Board [8c 5s 5c]
Seat 1: shevliak (button) folded on the Flop
Seat 2: ALBERT910 (small blind) folded before Flop
Seat 3: SEREJkE29 (big blind) collected ($138.20)
Seat 4: pindrokk folded before Flop (didn't bet)
Seat 5: GregAndrek folded on the Flop
Seat 6: teunuss folded before Flop (didn't bet)


PokerStars Game #102619642985:  Hold'em No Limit ($3/$6 USD) - 2013/08/11 15:15:22 ET
Table 'Tanete V 40-100 bb' 6-max Seat #4 is the button
Seat 1: shevliak ($255 in chips) 
Seat 2: ALBERT910 ($366.67 in chips) 
Seat 3: SEREJkE29 ($600 in chips) 
Seat 4: pindrokk ($841.40 in chips) 
Seat 5: GregAndrek ($666.20 in chips) 
Seat 6: teunuss ($1466 in chips) 
GregAndrek: posts small blind $3
teunuss: posts big blind $6
*** HOLE CARDS ***
shevliak: folds 
ALBERT910: calls $6
SEREJkE29: raises $12 to $18
pindrokk: folds 
GregAndrek: folds 
teunuss: folds 
ALBERT910: calls $12
*** FLOP *** [Td Jh 4h]
ALBERT910: checks 
SEREJkE29: bets $24
ALBERT910: folds 
Uncalled bet ($24) returned to SEREJkE29
SEREJkE29 collected $42.98 from pot
SEREJkE29: doesn't show hand 
*** SUMMARY ***
Total pot $45 | Rake $2.02 
Board [Td Jh 4h]
Seat 1: shevliak folded before Flop (didn't bet)
Seat 2: ALBERT910 folded on the Flop
Seat 3: SEREJkE29 collected ($42.98)
Seat 4: pindrokk (button) folded before Flop (didn't bet)
Seat 5: GregAndrek (small blind) folded before Flop
Seat 6: teunuss (big blind) folded before Flop


PokerStars Game #102619680626:  Hold'em No Limit ($3/$6 USD) - 2013/08/11 15:16:02 ET
Table 'Tanete V 40-100 bb' 6-max Seat #5 is the button
Seat 1: shevliak ($255 in chips) 
Seat 2: ALBERT910 ($348.67 in chips) 
Seat 3: SEREJkE29 ($624.98 in chips) 
Seat 4: pindrokk ($841.40 in chips) 
Seat 5: GregAndrek ($663.20 in chips) 
Seat 6: teunuss ($1460 in chips) 
teunuss: posts small blind $3
shevliak: posts big blind $6
*** HOLE CARDS ***
ALBERT910: folds 
SEREJkE29: folds 
pindrokk: folds 
GregAndrek: folds 
teunuss: raises $12 to $18
shevliak: folds 
Uncalled bet ($12) returned to teunuss
teunuss collected $12 from pot
teunuss: doesn't show hand 
*** SUMMARY ***
Total pot $12 | Rake $0 
Seat 1: shevliak (big blind) folded before Flop
Seat 2: ALBERT910 folded before Flop (didn't bet)
Seat 3: SEREJkE29 folded before Flop (didn't bet)
Seat 4: pindrokk folded before Flop (didn't bet)
Seat 5: GregAndrek (button) folded before Flop (didn't bet)
Seat 6: teunuss (small blind) collected ($12)


PokerStars Game #102619695422:  Hold'em No Limit ($3/$6 USD) - 2013/08/11 15:16:18 ET
Table 'Tanete V 40-100 bb' 6-max Seat #6 is the button
Seat 1: shevliak ($249 in chips) 
Seat 2: ALBERT910 ($348.67 in chips) 
Seat 3: SEREJkE29 ($624.98 in chips) 
Seat 4: pindrokk ($841.40 in chips) 
Seat 5: GregAndrek ($663.20 in chips) 
Seat 6: teunuss ($1466 in chips) 
shevliak: posts small blind $3
ALBERT910: posts big blind $6
*** HOLE CARDS ***
SEREJkE29: folds 
pindrokk: folds 
GregAndrek: folds 
teunuss: raises $6 to $12
shevliak: folds 
ALBERT910: calls $6
*** FLOP *** [3h 5h 5c]
ALBERT910: checks 
teunuss: checks 
*** TURN *** [3h 5h 5c] [4s]
ALBERT910: checks 
teunuss: checks 
*** RIVER *** [3h 5h 5c 4s] [5s]
ALBERT910: checks 
teunuss: checks 
*** SHOW DOWN ***
ALBERT910: shows [3s 3c] (a full house, Fives full of Threes)
teunuss: mucks hand 
ALBERT910 collected $25.78 from pot
*** SUMMARY ***
Total pot $27 | Rake $1.22 
Board [3h 5h 5c 4s 5s]
Seat 1: shevliak (small blind) folded before Flop
Seat 2: ALBERT910 (big blind) showed [3s 3c] and won ($25.78) with a full house, Fives full of Threes
Seat 3: SEREJkE29 folded before Flop (didn't bet)
Seat 4: pindrokk folded before Flop (didn't bet)
Seat 5: GregAndrek folded before Flop (didn't bet)
Seat 6: teunuss (button) mucked


PokerStars Game #102619745619:  Hold'em No Limit ($3/$6 USD) - 2013/08/11 15:17:11 ET
Table 'Tanete V 40-100 bb' 6-max Seat #1 is the button
Seat 1: shevliak ($246 in chips) 
Seat 2: ALBERT910 ($362.45 in chips) 
Seat 3: SEREJkE29 ($624.98 in chips) 
Seat 4: pindrokk ($841.40 in chips) 
Seat 5: GregAndrek ($663.20 in chips) 
Seat 6: teunuss ($1454 in chips) 
ALBERT910: posts small blind $3
SEREJkE29: posts big blind $6
*** HOLE CARDS ***
pindrokk: folds 
GregAndrek: folds 
teunuss: folds 
shevliak: folds 
ALBERT910: folds 
Uncalled bet ($3) returned to SEREJkE29
SEREJkE29 collected $6 from pot
SEREJkE29: doesn't show hand 
*** SUMMARY ***
Total pot $6 | Rake $0 
Seat 1: shevliak (button) folded before Flop (didn't bet)
Seat 2: ALBERT910 (small blind) folded before Flop
Seat 3: SEREJkE29 (big blind) collected ($6)
Seat 4: pindrokk folded before Flop (didn't bet)
Seat 5: GregAndrek folded before Flop (didn't bet)
Seat 6: teunuss folded before Flop (didn't bet)


PokerStars Game #102619758062:  Hold'em No Limit ($3/$6 USD) - 2013/08/11 15:17:24 ET
Table 'Tanete V 40-100 bb' 6-max Seat #2 is the button
Seat 1: shevliak ($246 in chips) 
Seat 2: ALBERT910 ($359.45 in chips) 
Seat 3: SEREJkE29 ($627.98 in chips) 
Seat 4: pindrokk ($841.40 in chips) 
Seat 5: GregAndrek ($663.20 in chips) 
Seat 6: teunuss ($1454 in chips) 
SEREJkE29: posts small blind $3
pindrokk: posts big blind $6
*** HOLE CARDS ***
GregAndrek: folds 
teunuss: folds 
shevliak: folds 
ALBERT910: folds 
SEREJkE29: folds 
Uncalled bet ($3) returned to pindrokk
pindrokk collected $6 from pot
pindrokk: doesn't show hand 
*** SUMMARY ***
Total pot $6 | Rake $0 
Seat 1: shevliak folded before Flop (didn't bet)
Seat 2: ALBERT910 (button) folded before Flop (didn't bet)
Seat 3: SEREJkE29 (small blind) folded before Flop
Seat 4: pindrokk (big blind) collected ($6)
Seat 5: GregAndrek folded before Flop (didn't bet)
Seat 6: teunuss folded before Flop (didn't bet)


PokerStars Game #102619786285:  Hold'em No Limit ($3/$6 USD) - 2013/08/11 15:17:54 ET
Table 'Tanete V 40-100 bb' 6-max Seat #3 is the button
Seat 1: shevliak ($246 in chips) 
Seat 2: ALBERT910 ($359.45 in chips) 
Seat 3: SEREJkE29 ($624.98 in chips) 
Seat 4: pindrokk ($844.40 in chips) 
Seat 5: GregAndrek ($663.20 in chips) 
Seat 6: teunuss ($1454 in chips) 
pindrokk: posts small blind $3
GregAndrek: posts big blind $6
*** HOLE CARDS ***
teunuss: folds 
shevliak: folds 
ALBERT910: folds 
SEREJkE29: raises $6 to $12
pindrokk: folds 
GregAndrek: folds 
Uncalled bet ($6) returned to SEREJkE29
SEREJkE29 collected $15 from pot
SEREJkE29: doesn't show hand 
*** SUMMARY ***
Total pot $15 | Rake $0 
Seat 1: shevliak folded before Flop (didn't bet)
Seat 2: ALBERT910 folded before Flop (didn't bet)
Seat 3: SEREJkE29 (button) collected ($15)
Seat 4: pindrokk (small blind) folded before Flop
Seat 5: GregAndrek (big blind) folded before Flop
Seat 6: teunuss folded before Flop (didn't bet)


PokerStars Game #102619799839:  Hold'em No Limit ($3/$6 USD) - 2013/08/11 15:18:09 ET
Table 'Tanete V 40-100 bb' 6-max Seat #4 is the button
Seat 1: shevliak ($246 in chips) 
Seat 2: ALBERT910 ($359.45 in chips) 
Seat 3: SEREJkE29 ($633.98 in chips) 
Seat 4: pindrokk ($841.40 in chips) 
Seat 5: GregAndrek ($657.20 in chips) 
Seat 6: teunuss ($1454 in chips) 
GregAndrek: posts small blind $3
teunuss: posts big blind $6
*** HOLE CARDS ***
shevliak: folds 
ALBERT910 has timed out
ALBERT910: folds 
SEREJkE29: folds 
pindrokk: raises $6 to $12
GregAndrek: raises $30 to $42
teunuss: folds 
pindrokk: folds 
Uncalled bet ($30) returned to GregAndrek
GregAndrek collected $30 from pot
GregAndrek: doesn't show hand 
*** SUMMARY ***
Total pot $30 | Rake $0 
Seat 1: shevliak folded before Flop (didn't bet)
Seat 2: ALBERT910 folded before Flop (didn't bet)
Seat 3: SEREJkE29 folded before Flop (didn't bet)
Seat 4: pindrokk (button) folded before Flop
Seat 5: GregAndrek (small blind) collected ($30)
Seat 6: teunuss (big blind) folded before Flop


PokerStars Game #102619850368:  Hold'em No Limit ($3/$6 USD) - 2013/08/11 15:19:02 ET
Table 'Tanete V 40-100 bb' 6-max Seat #5 is the button
Seat 1: shevliak ($246 in chips) 
Seat 2: ALBERT910 ($359.45 in chips) 
Seat 3: SEREJkE29 ($633.98 in chips) 
Seat 4: pindrokk ($829.40 in chips) 
Seat 5: GregAndrek ($675.20 in chips) 
Seat 6: teunuss ($1448 in chips) 
teunuss: posts small blind $3
shevliak: posts big blind $6
*** HOLE CARDS ***
ALBERT910: folds 
SEREJkE29: folds 
pindrokk: folds 
GregAndrek: folds 
teunuss: raises $12 to $18
shevliak: calls $12
*** FLOP *** [6c 9c 2c]
teunuss: bets $24
shevliak: raises $32.95 to $56.95
teunuss: raises $1373.05 to $1430 and is all-in
shevliak: folds 
Uncalled bet ($1373.05) returned to teunuss
teunuss collected $147.10 from pot
teunuss: doesn't show hand 
*** SUMMARY ***
Total pot $149.90 | Rake $2.80 
Board [6c 9c 2c]
Seat 1: shevliak (big blind) folded on the Flop
Seat 2: ALBERT910 folded before Flop (didn't bet)
Seat 3: SEREJkE29 folded before Flop (didn't bet)
Seat 4: pindrokk folded before Flop (didn't bet)
Seat 5: GregAndrek (button) folded before Flop (didn't bet)
Seat 6: teunuss (small blind) collected ($147.10)


PokerStars Game #102621552612:  Hold'em No Limit ($3/$6 USD) - 2013/08/11 15:50:16 ET
Table 'Tanete V 40-100 bb' 6-max Seat #6 is the button
Seat 1: shevliak ($246.08 in chips) 
Seat 2: ALBERT910 ($205.50 in chips) 
Seat 3: SEREJkE29 ($879.66 in chips) 
Seat 4: pindrokk ($813.79 in chips) 
Seat 5: GregAndrek ($671 in chips) 
Seat 6: teunuss ($1687.94 in chips) 
shevliak: posts small blind $3
ALBERT910: posts big blind $6
*** HOLE CARDS ***
SEREJkE29: folds 
pindrokk: raises $12 to $18
GregAndrek: calls $18
teunuss: raises $48 to $66
shevliak: folds 
ALBERT910: folds 
pindrokk: calls $48
GregAndrek: folds 
*** FLOP *** [9c 6d Ks]
pindrokk: checks 
teunuss: bets $87
pindrokk: folds 
Uncalled bet ($87) returned to teunuss
teunuss collected $156.20 from pot
teunuss: doesn't show hand 
*** SUMMARY ***
Total pot $159 | Rake $2.80 
Board [9c 6d Ks]
Seat 1: shevliak (small blind) folded before Flop
Seat 2: ALBERT910 (big blind) folded before Flop
Seat 3: SEREJkE29 folded before Flop (didn't bet)
Seat 4: pindrokk folded on the Flop
Seat 5: GregAndrek folded before Flop
Seat 6: teunuss (button) collected ($156.20)


PokerStars Game #102621654910:  Hold'em No Limit ($3/$6 USD) - 2013/08/11 15:52:11 ET
Table 'Tanete V 40-100 bb' 6-max Seat #1 is the button
Seat 1: shevliak ($243.08 in chips) 
Seat 2: ALBERT910 ($199.50 in chips) 
Seat 3: SEREJkE29 ($879.66 in chips) 
Seat 4: pindrokk ($747.79 in chips) 
Seat 5: GregAndrek ($653 in chips) 
Seat 6: teunuss ($1778.14 in chips) 
ALBERT910: posts small blind $3
SEREJkE29: posts big blind $6
*** HOLE CARDS ***
pindrokk: folds 
GregAndrek: raises $12 to $18
teunuss: folds 
shevliak: calls $18
ALBERT910: calls $15
SEREJkE29: folds 
*** FLOP *** [7h As 3d]
ALBERT910: checks 
GregAndrek: checks 
shevliak: checks 
*** TURN *** [7h As 3d] [4h]
ALBERT910: bets $12
GregAndrek: raises $42 to $54
shevliak: folds 
ALBERT910: calls $42
*** RIVER *** [7h As 3d 4h] [9s]
ALBERT910: checks 
GregAndrek: bets $129
ALBERT910: folds 
Uncalled bet ($129) returned to GregAndrek
GregAndrek collected $165.20 from pot
GregAndrek: doesn't show hand 
*** SUMMARY ***
Total pot $168 | Rake $2.80 
Board [7h As 3d 4h 9s]
Seat 1: shevliak (button) folded on the Turn
Seat 2: ALBERT910 (small blind) folded on the River
Seat 3: SEREJkE29 (big blind) folded before Flop
Seat 4: pindrokk folded before Flop (didn't bet)
Seat 5: GregAndrek collected ($165.20)
Seat 6: teunuss folded before Flop (didn't bet)


PokerStars Game #102621747296:  Hold'em No Limit ($3/$6 USD) - 2013/08/11 15:53:58 ET
Table 'Tanete V 40-100 bb' 6-max Seat #2 is the button
Seat 1: shevliak ($240 in chips) 
Seat 2: ALBERT910 ($127.50 in chips) 
Seat 3: SEREJkE29 ($873.66 in chips) 
Seat 4: pindrokk ($747.79 in chips) 
Seat 5: GregAndrek ($746.20 in chips) 
Seat 6: teunuss ($1778.14 in chips) 
SEREJkE29: posts small blind $3
pindrokk: posts big blind $6
*** HOLE CARDS ***
GregAndrek: folds 
teunuss: folds 
shevliak: folds 
ALBERT910: folds 
SEREJkE29: raises $12 to $18
pindrokk: raises $32 to $50
SEREJkE29: folds 
Uncalled bet ($32) returned to pindrokk
pindrokk collected $36 from pot
pindrokk: doesn't show hand 
*** SUMMARY ***
Total pot $36 | Rake $0 
Seat 1: shevliak folded before Flop (didn't bet)
Seat 2: ALBERT910 (button) folded before Flop (didn't bet)
Seat 3: SEREJkE29 (small blind) folded before Flop
Seat 4: pindrokk (big blind) collected ($36)
Seat 5: GregAndrek folded before Flop (didn't bet)
Seat 6: teunuss folded before Flop (didn't bet)


PokerStars Game #102621783612:  Hold'em No Limit ($3/$6 USD) - 2013/08/11 15:54:40 ET
Table 'Tanete V 40-100 bb' 6-max Seat #3 is the button
Seat 1: shevliak ($240 in chips) 
Seat 2: ALBERT910 ($127.50 in chips) 
Seat 3: SEREJkE29 ($855.66 in chips) 
Seat 4: pindrokk ($765.79 in chips) 
pindrokk: posts small blind $3
GregAndrek: is sitting out 
teunuss: is sitting out 
shevliak: posts big blind $6
*** HOLE CARDS ***
ALBERT910 has timed out
ALBERT910: folds 
SEREJkE29: folds 
pindrokk: folds 
Uncalled bet ($3) returned to shevliak
shevliak collected $6 from pot
shevliak: doesn't show hand 
*** SUMMARY ***
Total pot $6 | Rake $0 
Seat 1: shevliak (big blind) collected ($6)
Seat 2: ALBERT910 folded before Flop (didn't bet)
Seat 3: SEREJkE29 (button) folded before Flop (didn't bet)
Seat 4: pindrokk (small blind) folded before Flop


PokerStars Game #102621006658:  Hold'em No Limit ($3/$6 USD) - 2013/08/11 15:40:03 ET
Table 'Tanete V 40-100 bb' 6-max Seat #6 is the button
Seat 1: shevliak ($243 in chips) 
Seat 2: ALBERT910 ($388.17 in chips) 
Seat 3: SEREJkE29 ($721.46 in chips) 
Seat 4: pindrokk ($795.59 in chips) 
Seat 5: GregAndrek ($609 in chips) 
Seat 6: teunuss ($1741.10 in chips) 
shevliak: posts small blind $3
ALBERT910: posts big blind $6
*** HOLE CARDS ***
SEREJkE29: folds 
pindrokk: folds 
GregAndrek: folds 
teunuss: raises $6 to $12
shevliak: raises $24 to $36
ALBERT910: folds 
teunuss: raises $1705.10 to $1741.10 and is all-in
shevliak: calls $207 and is all-in
Uncalled bet ($1498.10) returned to teunuss
*** FIRST FLOP *** [Js 9s 4d]
*** FIRST TURN *** [Js 9s 4d] [8s]
*** FIRST RIVER *** [Js 9s 4d 8s] [Jh]
*** SECOND FLOP *** [Kc Jd 9c]
*** SECOND TURN *** [Kc Jd 9c] [6c]
*** SECOND RIVER *** [Kc Jd 9c 6c] [Qh]
*** FIRST SHOW DOWN ***
shevliak: shows [Ts Ac] (a pair of Jacks)
teunuss: shows [Tc Ad] (a pair of Jacks)
shevliak collected $122.30 from pot
teunuss collected $122.30 from pot
*** SECOND SHOW DOWN ***
shevliak: shows [Ts Ac] (a straight, Ten to Ace)
teunuss: shows [Tc Ad] (a straight, Ten to Ace)
shevliak collected $122.30 from pot
teunuss collected $122.30 from pot
*** SUMMARY ***
Total pot $492 | Rake $2.80 
Hand was run twice
FIRST Board [Js 9s 4d 8s Jh]
SECOND Board [Kc Jd 9c 6c Qh]
Seat 1: shevliak (small blind) showed [Ts Ac] and won ($122.30) with a pair of Jacks, and won ($122.30) with a straight, Ten to Ace
Seat 2: ALBERT910 (big blind) folded before Flop
Seat 3: SEREJkE29 folded before Flop (didn't bet)
Seat 4: pindrokk folded before Flop (didn't bet)
Seat 5: GregAndrek folded before Flop (didn't bet)
Seat 6: teunuss (button) showed [Tc Ad] and won ($122.30) with a pair of Jacks, and won ($122.30) with a straight, Ten to Ace


PokerStars Game #102621048603:  Hold'em No Limit ($3/$6 USD) - 2013/08/11 15:40:50 ET
Table 'Tanete V 40-100 bb' 6-max Seat #1 is the button
Seat 1: shevliak ($244.60 in chips) 
Seat 2: ALBERT910 ($382.17 in chips) 
Seat 3: SEREJkE29 ($721.46 in chips) 
Seat 4: pindrokk ($795.59 in chips) 
Seat 5: GregAndrek ($609 in chips) 
Seat 6: teunuss ($1742.70 in chips) 
ALBERT910: posts small blind $3
SEREJkE29: posts big blind $6
*** HOLE CARDS ***
pindrokk: folds 
GregAndrek: folds 
teunuss: raises $9 to $15
shevliak: calls $15
ALBERT910: folds 
SEREJkE29: folds 
*** FLOP *** [4s Jc 9h]
teunuss: bets $27
shevliak: folds 
Uncalled bet ($27) returned to teunuss
teunuss collected $37.24 from pot
teunuss: doesn't show hand 
*** SUMMARY ***
Total pot $39 | Rake $1.76 
Board [4s Jc 9h]
Seat 1: shevliak (button) folded on the Flop
Seat 2: ALBERT910 (small blind) folded before Flop
Seat 3: SEREJkE29 (big blind) folded before Flop
Seat 4: pindrokk folded before Flop (didn't bet)
Seat 5: GregAndrek folded before Flop (didn't bet)
Seat 6: teunuss collected ($37.24)


PokerStars Game #102621078109:  Hold'em No Limit ($3/$6 USD) - 2013/08/11 15:41:23 ET
Table 'Tanete V 40-100 bb' 6-max Seat #2 is the button
Seat 1: shevliak ($240 in chips) 
Seat 2: ALBERT910 ($379.17 in chips) 
Seat 3: SEREJkE29 ($715.46 in chips) 
Seat 4: pindrokk ($795.59 in chips) 
Seat 5: GregAndrek ($609 in chips) 
Seat 6: teunuss ($1764.94 in chips) 
SEREJkE29: posts small blind $3
pindrokk: posts big blind $6
*** HOLE CARDS ***
GregAndrek: raises $12 to $18
teunuss: folds 
shevliak: folds 
ALBERT910: folds 
SEREJkE29: folds 
pindrokk: folds 
Uncalled bet ($12) returned to GregAndrek
GregAndrek collected $15 from pot
GregAndrek: doesn't show hand 
*** SUMMARY ***
Total pot $15 | Rake $0 
Seat 1: shevliak folded before Flop (didn't bet)
Seat 2: ALBERT910 (button) folded before Flop (didn't bet)
Seat 3: SEREJkE29 (small blind) folded before Flop
Seat 4: pindrokk (big blind) folded before Flop
Seat 5: GregAndrek collected ($15)
Seat 6: teunuss folded before Flop (didn't bet)


PokerStars Game #102621111383:  Hold'em No Limit ($3/$6 USD) - 2013/08/11 15:42:01 ET
Table 'Tanete V 40-100 bb' 6-max Seat #3 is the button
Seat 1: shevliak ($240 in chips) 
Seat 2: ALBERT910 ($379.17 in chips) 
Seat 3: SEREJkE29 ($712.46 in chips) 
Seat 4: pindrokk ($789.59 in chips) 
Seat 5: GregAndrek ($618 in chips) 
Seat 6: teunuss ($1764.94 in chips) 
pindrokk: posts small blind $3
GregAndrek: posts big blind $6
*** HOLE CARDS ***
teunuss: folds 
shevliak: folds 
ALBERT910: folds 
SEREJkE29: raises $6 to $12
pindrokk: raises $32 to $44
GregAndrek: folds 
SEREJkE29: folds 
Uncalled bet ($32) returned to pindrokk
pindrokk collected $30 from pot
pindrokk: doesn't show hand 
*** SUMMARY ***
Total pot $30 | Rake $0 
Seat 1: shevliak folded before Flop (didn't bet)
Seat 2: ALBERT910 folded before Flop (didn't bet)
Seat 3: SEREJkE29 (button) folded before Flop
Seat 4: pindrokk (small blind) collected ($30)
Seat 5: GregAndrek (big blind) folded before Flop
Seat 6: teunuss folded before Flop (didn't bet)


PokerStars Game #102621148503:  Hold'em No Limit ($3/$6 USD) - 2013/08/11 15:42:43 ET
Table 'Tanete V 40-100 bb' 6-max Seat #4 is the button
Seat 1: shevliak ($240 in chips) 
Seat 2: ALBERT910 ($379.17 in chips) 
Seat 3: SEREJkE29 ($700.46 in chips) 
Seat 4: pindrokk ($807.59 in chips) 
Seat 5: GregAndrek ($612 in chips) 
Seat 6: teunuss ($1764.94 in chips) 
GregAndrek: posts small blind $3
teunuss: posts big blind $6
*** HOLE CARDS ***
shevliak: folds 
ALBERT910: folds 
SEREJkE29: raises $9 to $15
pindrokk has timed out
pindrokk: folds 
GregAndrek: folds 
teunuss: folds 
Uncalled bet ($9) returned to SEREJkE29
SEREJkE29 collected $15 from pot
SEREJkE29: doesn't show hand 
*** SUMMARY ***
Total pot $15 | Rake $0 
Seat 1: shevliak folded before Flop (didn't bet)
Seat 2: ALBERT910 folded before Flop (didn't bet)
Seat 3: SEREJkE29 collected ($15)
Seat 4: pindrokk (button) folded before Flop (didn't bet)
Seat 5: GregAndrek (small blind) folded before Flop
Seat 6: teunuss (big blind) folded before Flop


PokerStars Game #102621186031:  Hold'em No Limit ($3/$6 USD) - 2013/08/11 15:43:25 ET
Table 'Tanete V 40-100 bb' 6-max Seat #5 is the button
Seat 1: shevliak ($240 in chips) 
Seat 2: ALBERT910 ($379.17 in chips) 
Seat 3: SEREJkE29 ($709.46 in chips) 
Seat 4: pindrokk ($807.59 in chips) 
Seat 5: GregAndrek ($609 in chips) 
Seat 6: teunuss ($1758.94 in chips) 
teunuss: posts small blind $3
shevliak: posts big blind $6
*** HOLE CARDS ***
ALBERT910: folds 
SEREJkE29: folds 
pindrokk: folds 
GregAndrek: folds 
teunuss: raises $12 to $18
shevliak: folds 
Uncalled bet ($12) returned to teunuss
teunuss collected $12 from pot
teunuss: doesn't show hand 
*** SUMMARY ***
Total pot $12 | Rake $0 
Seat 1: shevliak (big blind) folded before Flop
Seat 2: ALBERT910 folded before Flop (didn't bet)
Seat 3: SEREJkE29 folded before Flop (didn't bet)
Seat 4: pindrokk folded before Flop (didn't bet)
Seat 5: GregAndrek (button) folded before Flop (didn't bet)
Seat 6: teunuss (small blind) collected ($12)


PokerStars Game #102621202947:  Hold'em No Limit ($3/$6 USD) - 2013/08/11 15:43:45 ET
Table 'Tanete V 40-100 bb' 6-max Seat #6 is the button
Seat 1: shevliak ($240 in chips) 
Seat 2: ALBERT910 ($379.17 in chips) 
Seat 3: SEREJkE29 ($709.46 in chips) 
Seat 4: pindrokk ($807.59 in chips) 
Seat 5: GregAndrek ($609 in chips) 
Seat 6: teunuss ($1764.94 in chips) 
shevliak: posts small blind $3
ALBERT910: posts big blind $6
*** HOLE CARDS ***
SEREJkE29: folds 
pindrokk: folds 
GregAndrek: raises $9 to $15
teunuss: folds 
shevliak: folds 
ALBERT910: folds 
Uncalled bet ($9) returned to GregAndrek
GregAndrek collected $15 from pot
GregAndrek: doesn't show hand 
*** SUMMARY ***
Total pot $15 | Rake $0 
Seat 1: shevliak (small blind) folded before Flop
Seat 2: ALBERT910 (big blind) folded before Flop
Seat 3: SEREJkE29 folded before Flop (didn't bet)
Seat 4: pindrokk folded before Flop (didn't bet)
Seat 5: GregAndrek collected ($15)
Seat 6: teunuss (button) folded before Flop (didn't bet)


PokerStars Game #102621219986:  Hold'em No Limit ($3/$6 USD) - 2013/08/11 15:44:04 ET
Table 'Tanete V 40-100 bb' 6-max Seat #1 is the button
Seat 1: shevliak ($240 in chips) 
Seat 2: ALBERT910 ($373.17 in chips) 
Seat 3: SEREJkE29 ($709.46 in chips) 
Seat 4: pindrokk ($807.59 in chips) 
Seat 5: GregAndrek ($618 in chips) 
Seat 6: teunuss ($1764.94 in chips) 
ALBERT910: posts small blind $3
SEREJkE29: posts big blind $6
*** HOLE CARDS ***
pindrokk: raises $12 to $18
GregAndrek: folds 
teunuss: folds 
shevliak: calls $18
ALBERT910: folds 
SEREJkE29: folds 
*** FLOP *** [Jh 2s 8s]
pindrokk: checks 
shevliak: bets $23.20
pindrokk: folds 
Uncalled bet ($23.20) returned to shevliak
shevliak collected $42.98 from pot
shevliak: doesn't show hand 
*** SUMMARY ***
Total pot $45 | Rake $2.02 
Board [Jh 2s 8s]
Seat 1: shevliak (button) collected ($42.98)
Seat 2: ALBERT910 (small blind) folded before Flop
Seat 3: SEREJkE29 (big blind) folded before Flop
Seat 4: pindrokk folded on the Flop
Seat 5: GregAndrek folded before Flop (didn't bet)
Seat 6: teunuss folded before Flop (didn't bet)


PokerStars Game #102621258428:  Hold'em No Limit ($3/$6 USD) - 2013/08/11 15:44:47 ET
Table 'Tanete V 40-100 bb' 6-max Seat #2 is the button
Seat 1: shevliak ($264.98 in chips) 
Seat 2: ALBERT910 ($370.17 in chips) 
Seat 3: SEREJkE29 ($703.46 in chips) 
Seat 4: pindrokk ($789.59 in chips) 
Seat 5: GregAndrek ($618 in chips) 
Seat 6: teunuss ($1764.94 in chips) 
SEREJkE29: posts small blind $3
pindrokk: posts big blind $6
*** HOLE CARDS ***
GregAndrek: folds 
teunuss: folds 
shevliak: raises $6.90 to $12.90
ALBERT910: calls $12.90
SEREJkE29: folds 
pindrokk: folds 
*** FLOP *** [Tc 7h 8h]
shevliak: checks 
ALBERT910: bets $18
shevliak: folds 
Uncalled bet ($18) returned to ALBERT910
ALBERT910 collected $33.23 from pot
ALBERT910: doesn't show hand 
*** SUMMARY ***
Total pot $34.80 | Rake $1.57 
Board [Tc 7h 8h]
Seat 1: shevliak folded on the Flop
Seat 2: ALBERT910 (button) collected ($33.23)
Seat 3: SEREJkE29 (small blind) folded before Flop
Seat 4: pindrokk (big blind) folded before Flop
Seat 5: GregAndrek folded before Flop (didn't bet)
Seat 6: teunuss folded before Flop (didn't bet)


PokerStars Game #102620765229:  Hold'em No Limit ($3/$6 USD) - 2013/08/11 15:35:38 ET
Table 'Tanete V 40-100 bb' 6-max Seat #6 is the button
Seat 1: shevliak ($275.27 in chips) 
Seat 2: ALBERT910 ($345.97 in chips) 
Seat 3: SEREJkE29 ($705.48 in chips) 
Seat 4: pindrokk ($795.59 in chips) 
Seat 5: GregAndrek ($609 in chips) 
Seat 6: teunuss ($1534.63 in chips) 
shevliak: posts small blind $3
ALBERT910: posts big blind $6
*** HOLE CARDS ***
SEREJkE29: folds 
pindrokk: folds 
GregAndrek: folds 
teunuss: raises $6 to $12
shevliak: raises $27 to $39
ALBERT910: folds 
teunuss: calls $27
*** FLOP *** [Td Th 9h]
shevliak: bets $32.48
teunuss: calls $32.48
*** TURN *** [Td Th 9h] [3d]
shevliak: checks 
teunuss: bets $120
shevliak: raises $83.79 to $203.79 and is all-in
teunuss: calls $83.79
*** FIRST RIVER *** [Td Th 9h 3d] [Kh]
*** SECOND RIVER *** [Td Th 9h 3d] [7d]
*** FIRST SHOW DOWN ***
shevliak: shows [As Ac] (two pair, Aces and Tens)
teunuss: shows [8s Ts] (three of a kind, Tens)
teunuss collected $276.87 from pot
*** SECOND SHOW DOWN ***
shevliak: shows [As Ac] (two pair, Aces and Tens)
teunuss: shows [8s Ts] (three of a kind, Tens)
teunuss collected $276.87 from pot
*** SUMMARY ***
Total pot $556.54 | Rake $2.80 
Hand was run twice
FIRST Board [Td Th 9h 3d Kh]
SECOND Board [Td Th 9h 3d 7d]
Seat 1: shevliak (small blind) showed [As Ac] and lost with two pair, Aces and Tens, and lost with two pair, Aces and Tens
Seat 2: ALBERT910 (big blind) folded before Flop
Seat 3: SEREJkE29 folded before Flop (didn't bet)
Seat 4: pindrokk folded before Flop (didn't bet)
Seat 5: GregAndrek folded before Flop (didn't bet)
Seat 6: teunuss (button) showed [8s Ts] and won ($276.87) with three of a kind, Tens, and won ($276.87) with three of a kind, Tens


PokerStars Game #102620833675:  Hold'em No Limit ($3/$6 USD) - 2013/08/11 15:36:52 ET
Table 'Tanete V 40-100 bb' 6-max Seat #1 is the button
Seat 1: shevliak ($240 in chips) 
Seat 2: ALBERT910 ($339.97 in chips) 
Seat 3: SEREJkE29 ($705.48 in chips) 
Seat 4: pindrokk ($795.59 in chips) 
Seat 5: GregAndrek ($609 in chips) 
Seat 6: teunuss ($1813.10 in chips) 
ALBERT910: posts small blind $3
SEREJkE29: posts big blind $6
*** HOLE CARDS ***
pindrokk: folds 
GregAndrek: folds 
teunuss: raises $9 to $15
shevliak: folds 
ALBERT910: calls $12
SEREJkE29: folds 
*** FLOP *** [Jc Js 6h]
ALBERT910: checks 
teunuss: bets $24
ALBERT910: raises $24 to $48
teunuss: calls $24
*** TURN *** [Jc Js 6h] [5h]
ALBERT910: bets $50
teunuss: folds 
Uncalled bet ($50) returned to ALBERT910
ALBERT910 collected $129.20 from pot
ALBERT910: doesn't show hand 
*** SUMMARY ***
Total pot $132 | Rake $2.80 
Board [Jc Js 6h 5h]
Seat 1: shevliak (button) folded before Flop (didn't bet)
Seat 2: ALBERT910 (small blind) collected ($129.20)
Seat 3: SEREJkE29 (big blind) folded before Flop
Seat 4: pindrokk folded before Flop (didn't bet)
Seat 5: GregAndrek folded before Flop (didn't bet)
Seat 6: teunuss folded on the Turn


PokerStars Game #102620902216:  Hold'em No Limit ($3/$6 USD) - 2013/08/11 15:38:08 ET
Table 'Tanete V 40-100 bb' 6-max Seat #2 is the button
Seat 1: shevliak ($240 in chips) 
Seat 2: ALBERT910 ($406.17 in chips) 
Seat 3: SEREJkE29 ($699.48 in chips) 
Seat 4: pindrokk ($795.59 in chips) 
Seat 5: GregAndrek ($609 in chips) 
Seat 6: teunuss ($1750.10 in chips) 
SEREJkE29: posts small blind $3
pindrokk: posts big blind $6
*** HOLE CARDS ***
GregAndrek: raises $12 to $18
teunuss: folds 
shevliak: folds 
ALBERT910: folds 
SEREJkE29: folds 
pindrokk: folds 
Uncalled bet ($12) returned to GregAndrek
GregAndrek collected $15 from pot
GregAndrek: doesn't show hand 
*** SUMMARY ***
Total pot $15 | Rake $0 
Seat 1: shevliak folded before Flop (didn't bet)
Seat 2: ALBERT910 (button) folded before Flop (didn't bet)
Seat 3: SEREJkE29 (small blind) folded before Flop
Seat 4: pindrokk (big blind) folded before Flop
Seat 5: GregAndrek collected ($15)
Seat 6: teunuss folded before Flop (didn't bet)


PokerStars Game #102620931650:  Hold'em No Limit ($3/$6 USD) - 2013/08/11 15:38:40 ET
Table 'Tanete V 40-100 bb' 6-max Seat #3 is the button
Seat 1: shevliak ($240 in chips) 
Seat 2: ALBERT910 ($406.17 in chips) 
Seat 3: SEREJkE29 ($696.48 in chips) 
Seat 4: pindrokk ($789.59 in chips) 
Seat 5: GregAndrek ($618 in chips) 
Seat 6: teunuss ($1750.10 in chips) 
pindrokk: posts small blind $3
GregAndrek: posts big blind $6
*** HOLE CARDS ***
teunuss: folds 
shevliak: folds 
ALBERT910: calls $6
SEREJkE29: raises $12 to $18
pindrokk: folds 
GregAndrek: folds 
ALBERT910: calls $12
*** FLOP *** [7s 4c 4h]
ALBERT910: checks 
SEREJkE29: bets $24
ALBERT910: folds 
Uncalled bet ($24) returned to SEREJkE29
SEREJkE29 collected $42.98 from pot
SEREJkE29: doesn't show hand 
*** SUMMARY ***
Total pot $45 | Rake $2.02 
Board [7s 4c 4h]
Seat 1: shevliak folded before Flop (didn't bet)
Seat 2: ALBERT910 folded on the Flop
Seat 3: SEREJkE29 (button) collected ($42.98)
Seat 4: pindrokk (small blind) folded before Flop
Seat 5: GregAndrek (big blind) folded before Flop
Seat 6: teunuss folded before Flop (didn't bet)


PokerStars Game #102620975200:  Hold'em No Limit ($3/$6 USD) - 2013/08/11 15:39:28 ET
Table 'Tanete V 40-100 bb' 6-max Seat #4 is the button
Seat 1: shevliak ($240 in chips) 
Seat 2: ALBERT910 ($388.17 in chips) 
Seat 3: SEREJkE29 ($721.46 in chips) 
Seat 4: pindrokk ($786.59 in chips) 
Seat 5: GregAndrek ($612 in chips) 
Seat 6: teunuss ($1750.10 in chips) 
GregAndrek: posts small blind $3
teunuss: posts big blind $6
*** HOLE CARDS ***
shevliak: folds 
ALBERT910: folds 
SEREJkE29: folds 
pindrokk: raises $6 to $12
GregAndrek: folds 
teunuss: folds 
Uncalled bet ($6) returned to pindrokk
pindrokk collected $15 from pot
pindrokk: doesn't show hand 
*** SUMMARY ***
Total pot $15 | Rake $0 
Seat 1: shevliak folded before Flop (didn't bet)
Seat 2: ALBERT910 folded before Flop (didn't bet)
Seat 3: SEREJkE29 folded before Flop (didn't bet)
Seat 4: pindrokk (button) collected ($15)
Seat 5: GregAndrek (small blind) folded before Flop
Seat 6: teunuss (big blind) folded before Flop


PokerStars Game #102620991752:  Hold'em No Limit ($3/$6 USD) - 2013/08/11 15:39:47 ET
Table 'Tanete V 40-100 bb' 6-max Seat #5 is the button
Seat 1: shevliak ($240 in chips) 
Seat 2: ALBERT910 ($388.17 in chips) 
Seat 3: SEREJkE29 ($721.46 in chips) 
Seat 4: pindrokk ($795.59 in chips) 
Seat 5: GregAndrek ($609 in chips) 
Seat 6: teunuss ($1744.10 in chips) 
teunuss: posts small blind $3
shevliak: posts big blind $6
*** HOLE CARDS ***
ALBERT910: folds 
SEREJkE29: folds 
pindrokk: folds 
GregAndrek: folds 
teunuss: folds 
Uncalled bet ($3) returned to shevliak
shevliak collected $6 from pot
shevliak: doesn't show hand 
*** SUMMARY ***
Total pot $6 | Rake $0 
Seat 1: shevliak (big blind) collected ($6)
Seat 2: ALBERT910 folded before Flop (didn't bet)
Seat 3: SEREJkE29 folded before Flop (didn't bet)
Seat 4: pindrokk folded before Flop (didn't bet)
Seat 5: GregAndrek (button) folded before Flop (didn't bet)
Seat 6: teunuss (small blind) folded before Flop


PokerStars Game #102622740691:  Hold'em No Limit ($3/$6 USD) - 2013/08/11 16:15:09 ET
Table 'Tanete V 40-100 bb' 6-max Seat #6 is the button
Seat 1: shevliak ($342.72 in chips) 
Seat 2: ALBERT910 ($258.60 in chips) 
Seat 3: SEREJkE29 ($786.88 in chips) 
Seat 4: pindrokk ($692.29 in chips) 
Seat 5: GregAndrek ($600 in chips) 
Seat 6: mikimiki88 ($676.85 in chips) 
shevliak: posts small blind $3
ALBERT910: posts big blind $6
*** HOLE CARDS ***
SEREJkE29: folds 
pindrokk: folds 
GregAndrek: raises $9 to $15
mikimiki88: raises $24 to $39
shevliak: folds 
ALBERT910: folds 
GregAndrek: folds 
Uncalled bet ($24) returned to mikimiki88
mikimiki88 collected $39 from pot
mikimiki88: doesn't show hand 
*** SUMMARY ***
Total pot $39 | Rake $0 
Seat 1: shevliak (small blind) folded before Flop
Seat 2: ALBERT910 (big blind) folded before Flop
Seat 3: SEREJkE29 folded before Flop (didn't bet)
Seat 4: pindrokk folded before Flop (didn't bet)
Seat 5: GregAndrek folded before Flop
Seat 6: mikimiki88 (button) collected ($39)


PokerStars Game #102622780561:  Hold'em No Limit ($3/$6 USD) - 2013/08/11 16:15:55 ET
Table 'Tanete V 40-100 bb' 6-max Seat #1 is the button
Seat 1: shevliak ($339.72 in chips) 
Seat 2: ALBERT910 ($252.60 in chips) 
Seat 3: SEREJkE29 ($786.88 in chips) 
Seat 4: pindrokk ($692.29 in chips) 
Seat 5: GregAndrek ($600 in chips) 
Seat 6: mikimiki88 ($700.85 in chips) 
ALBERT910: posts small blind $3
SEREJkE29: posts big blind $6
*** HOLE CARDS ***
pindrokk: folds 
GregAndrek: folds 
mikimiki88: folds 
shevliak: folds 
ALBERT910: folds 
Uncalled bet ($3) returned to SEREJkE29
SEREJkE29 collected $6 from pot
SEREJkE29: doesn't show hand 
*** SUMMARY ***
Total pot $6 | Rake $0 
Seat 1: shevliak (button) folded before Flop (didn't bet)
Seat 2: ALBERT910 (small blind) folded before Flop
Seat 3: SEREJkE29 (big blind) collected ($6)
Seat 4: pindrokk folded before Flop (didn't bet)
Seat 5: GregAndrek folded before Flop (didn't bet)
Seat 6: mikimiki88 folded before Flop (didn't bet)


PokerStars Game #102622791306:  Hold'em No Limit ($3/$6 USD) - 2013/08/11 16:16:07 ET
Table 'Tanete V 40-100 bb' 6-max Seat #2 is the button
Seat 1: shevliak ($339.72 in chips) 
Seat 2: ALBERT910 ($249.60 in chips) 
Seat 3: SEREJkE29 ($789.88 in chips) 
Seat 4: pindrokk ($692.29 in chips) 
Seat 5: GregAndrek ($600 in chips) 
Seat 6: mikimiki88 ($700.85 in chips) 
SEREJkE29: posts small blind $3
pindrokk: posts big blind $6
*** HOLE CARDS ***
GregAndrek: folds 
mikimiki88: folds 
shevliak: folds 
ALBERT910: folds 
SEREJkE29: raises $12 to $18
pindrokk: calls $12
*** FLOP *** [6c Ad 3h]
SEREJkE29: bets $24
pindrokk: calls $24
*** TURN *** [6c Ad 3h] [9s]
SEREJkE29: checks 
pindrokk: checks 
*** RIVER *** [6c Ad 3h 9s] [Jh]
SEREJkE29: checks 
pindrokk: checks 
*** SHOW DOWN ***
SEREJkE29: shows [6s 8s] (a pair of Sixes)
pindrokk: shows [7s 7d] (a pair of Sevens)
pindrokk collected $81.20 from pot
*** SUMMARY ***
Total pot $84 | Rake $2.80 
Board [6c Ad 3h 9s Jh]
Seat 1: shevliak folded before Flop (didn't bet)
Seat 2: ALBERT910 (button) folded before Flop (didn't bet)
Seat 3: SEREJkE29 (small blind) showed [6s 8s] and lost with a pair of Sixes
Seat 4: pindrokk (big blind) showed [7s 7d] and won ($81.20) with a pair of Sevens
Seat 5: GregAndrek folded before Flop (didn't bet)
Seat 6: mikimiki88 folded before Flop (didn't bet)


PokerStars Game #102622870626:  Hold'em No Limit ($3/$6 USD) - 2013/08/11 16:17:38 ET
Table 'Tanete V 40-100 bb' 6-max Seat #3 is the button
Seat 1: shevliak ($339.72 in chips) 
Seat 2: ALBERT910 ($249.60 in chips) 
Seat 3: SEREJkE29 ($747.88 in chips) 
Seat 4: pindrokk ($731.49 in chips) 
Seat 5: GregAndrek ($600 in chips) 
Seat 6: mikimiki88 ($700.85 in chips) 
pindrokk: posts small blind $3
GregAndrek: posts big blind $6
*** HOLE CARDS ***
mikimiki88: raises $12 to $18
shevliak: folds 
ALBERT910: folds 
SEREJkE29: folds 
pindrokk: folds 
GregAndrek: folds 
Uncalled bet ($12) returned to mikimiki88
mikimiki88 collected $15 from pot
mikimiki88: doesn't show hand 
*** SUMMARY ***
Total pot $15 | Rake $0 
Seat 1: shevliak folded before Flop (didn't bet)
Seat 2: ALBERT910 folded before Flop (didn't bet)
Seat 3: SEREJkE29 (button) folded before Flop (didn't bet)
Seat 4: pindrokk (small blind) folded before Flop
Seat 5: GregAndrek (big blind) folded before Flop
Seat 6: mikimiki88 collected ($15)


PokerStars Game #102622897667:  Hold'em No Limit ($3/$6 USD) - 2013/08/11 16:18:08 ET
Table 'Tanete V 40-100 bb' 6-max Seat #4 is the button
Seat 1: shevliak ($339.72 in chips) 
Seat 2: ALBERT910 ($249.60 in chips) 
Seat 3: SEREJkE29 ($747.88 in chips) 
Seat 4: pindrokk ($728.49 in chips) 
Seat 5: GregAndrek ($600 in chips) 
Seat 6: mikimiki88 ($709.85 in chips) 
GregAndrek: posts small blind $3
mikimiki88: posts big blind $6
*** HOLE CARDS ***
shevliak: folds 
ALBERT910: folds 
SEREJkE29: raises $9 to $15
pindrokk: folds 
GregAndrek: folds 
mikimiki88: folds 
Uncalled bet ($9) returned to SEREJkE29
SEREJkE29 collected $15 from pot
SEREJkE29: doesn't show hand 
*** SUMMARY ***
Total pot $15 | Rake $0 
Seat 1: shevliak folded before Flop (didn't bet)
Seat 2: ALBERT910 folded before Flop (didn't bet)
Seat 3: SEREJkE29 collected ($15)
Seat 4: pindrokk (button) folded before Flop (didn't bet)
Seat 5: GregAndrek (small blind) folded before Flop
Seat 6: mikimiki88 (big blind) folded before Flop


PokerStars Game #102622925610:  Hold'em No Limit ($3/$6 USD) - 2013/08/11 16:18:40 ET
Table 'Tanete V 40-100 bb' 6-max Seat #5 is the button
Seat 1: shevliak ($339.72 in chips) 
Seat 2: ALBERT910 ($249.60 in chips) 
Seat 3: SEREJkE29 ($756.88 in chips) 
Seat 4: pindrokk ($728.49 in chips) 
Seat 5: GregAndrek ($600 in chips) 
Seat 6: mikimiki88 ($703.85 in chips) 
mikimiki88: posts small blind $3
shevliak: posts big blind $6
*** HOLE CARDS ***
ALBERT910: folds 
SEREJkE29: folds 
pindrokk: folds 
GregAndrek: raises $6 to $12
mikimiki88: folds 
shevliak: calls $6
*** FLOP *** [Tc 5c 3c]
shevliak: checks 
GregAndrek: checks 
*** TURN *** [Tc 5c 3c] [Jd]
shevliak: bets $19.20
GregAndrek: calls $19.20
*** RIVER *** [Tc 5c 3c Jd] [4h]
shevliak: checks 
GregAndrek: bets $48
shevliak: folds 
Uncalled bet ($48) returned to GregAndrek
GregAndrek collected $62.60 from pot
GregAndrek: doesn't show hand 
*** SUMMARY ***
Total pot $65.40 | Rake $2.80 
Board [Tc 5c 3c Jd 4h]
Seat 1: shevliak (big blind) folded on the River
Seat 2: ALBERT910 folded before Flop (didn't bet)
Seat 3: SEREJkE29 folded before Flop (didn't bet)
Seat 4: pindrokk folded before Flop (didn't bet)
Seat 5: GregAndrek (button) collected ($62.60)
Seat 6: mikimiki88 (small blind) folded before Flop


PokerStars Game #102622980382:  Hold'em No Limit ($3/$6 USD) - 2013/08/11 16:19:43 ET
Table 'Tanete V 40-100 bb' 6-max Seat #6 is the button
Seat 1: shevliak ($308.52 in chips) 
Seat 2: ALBERT910 ($249.60 in chips) 
Seat 3: SEREJkE29 ($756.88 in chips) 
Seat 4: pindrokk ($728.49 in chips) 
Seat 5: GregAndrek ($631.40 in chips) 
Seat 6: mikimiki88 ($700.85 in chips) 
shevliak: posts small blind $3
ALBERT910: posts big blind $6
*** HOLE CARDS ***
SEREJkE29: folds 
pindrokk: folds 
GregAndrek: folds 
mikimiki88: folds 
shevliak: folds 
Uncalled bet ($3) returned to ALBERT910
ALBERT910 collected $6 from pot
ALBERT910: doesn't show hand 
*** SUMMARY ***
Total pot $6 | Rake $0 
Seat 1: shevliak (small blind) folded before Flop
Seat 2: ALBERT910 (big blind) collected ($6)
Seat 3: SEREJkE29 folded before Flop (didn't bet)
Seat 4: pindrokk folded before Flop (didn't bet)
Seat 5: GregAndrek folded before Flop (didn't bet)
Seat 6: mikimiki88 (button) folded before Flop (didn't bet)


PokerStars Game #102622500742:  Hold'em No Limit ($3/$6 USD) - 2013/08/11 16:10:31 ET
Table 'Tanete V 40-100 bb' 6-max Seat #6 is the button
Seat 1: shevliak ($360.72 in chips) 
Seat 2: ALBERT910 ($133.70 in chips) 
Seat 3: SEREJkE29 ($834.88 in chips) 
Seat 4: pindrokk ($701.29 in chips) 
Seat 5: GregAndrek ($695.20 in chips) 
Seat 6: mikimiki88 ($600 in chips) 
shevliak: posts small blind $3
ALBERT910: posts big blind $6
*** HOLE CARDS ***
SEREJkE29: folds 
pindrokk: folds 
GregAndrek: folds 
mikimiki88: folds 
shevliak: folds 
Uncalled bet ($3) returned to ALBERT910
ALBERT910 collected $6 from pot
ALBERT910: doesn't show hand 
*** SUMMARY ***
Total pot $6 | Rake $0 
Seat 1: shevliak (small blind) folded before Flop
Seat 2: ALBERT910 (big blind) collected ($6)
Seat 3: SEREJkE29 folded before Flop (didn't bet)
Seat 4: pindrokk folded before Flop (didn't bet)
Seat 5: GregAndrek folded before Flop (didn't bet)
Seat 6: mikimiki88 (button) folded before Flop (didn't bet)


PokerStars Game #102622516770:  Hold'em No Limit ($3/$6 USD) - 2013/08/11 16:10:50 ET
Table 'Tanete V 40-100 bb' 6-max Seat #1 is the button
Seat 1: shevliak ($357.72 in chips) 
Seat 2: ALBERT910 ($136.70 in chips) 
Seat 3: SEREJkE29 ($834.88 in chips) 
Seat 4: pindrokk ($701.29 in chips) 
Seat 5: GregAndrek ($695.20 in chips) 
Seat 6: mikimiki88 ($600 in chips) 
ALBERT910: posts small blind $3
SEREJkE29: posts big blind $6
*** HOLE CARDS ***
pindrokk: folds 
GregAndrek: folds 
mikimiki88: raises $6 to $12
shevliak: folds 
ALBERT910: folds 
SEREJkE29: calls $6
*** FLOP *** [9s Qd 5s]
SEREJkE29: checks 
mikimiki88: bets $18.30
SEREJkE29: raises $38.70 to $57
mikimiki88: raises $81 to $138
SEREJkE29: folds 
Uncalled bet ($81) returned to mikimiki88
mikimiki88 collected $138.20 from pot
mikimiki88: doesn't show hand 
*** SUMMARY ***
Total pot $141 | Rake $2.80 
Board [9s Qd 5s]
Seat 1: shevliak (button) folded before Flop (didn't bet)
Seat 2: ALBERT910 (small blind) folded before Flop
Seat 3: SEREJkE29 (big blind) folded on the Flop
Seat 4: pindrokk folded before Flop (didn't bet)
Seat 5: GregAndrek folded before Flop (didn't bet)
Seat 6: mikimiki88 collected ($138.20)


PokerStars Game #102622582365:  Hold'em No Limit ($3/$6 USD) - 2013/08/11 16:12:06 ET
Table 'Tanete V 40-100 bb' 6-max Seat #2 is the button
Seat 1: shevliak ($357.72 in chips) 
Seat 2: ALBERT910 ($133.70 in chips) 
Seat 3: SEREJkE29 ($765.88 in chips) 
Seat 4: pindrokk ($701.29 in chips) 
Seat 5: GregAndrek ($695.20 in chips) 
Seat 6: mikimiki88 ($669.20 in chips) 
SEREJkE29: posts small blind $3
pindrokk: posts big blind $6
*** HOLE CARDS ***
GregAndrek: folds 
mikimiki88: folds 
shevliak: folds 
ALBERT910: calls $6
SEREJkE29: raises $24 to $30
pindrokk: folds 
ALBERT910: folds 
Uncalled bet ($24) returned to SEREJkE29
SEREJkE29 collected $18 from pot
SEREJkE29: doesn't show hand 
*** SUMMARY ***
Total pot $18 | Rake $0 
Seat 1: shevliak folded before Flop (didn't bet)
Seat 2: ALBERT910 (button) folded before Flop
Seat 3: SEREJkE29 (small blind) collected ($18)
Seat 4: pindrokk (big blind) folded before Flop
Seat 5: GregAndrek folded before Flop (didn't bet)
Seat 6: mikimiki88 folded before Flop (didn't bet)


PokerStars Game #102622613775:  Hold'em No Limit ($3/$6 USD) - 2013/08/11 16:12:42 ET
Table 'Tanete V 40-100 bb' 6-max Seat #3 is the button
Seat 1: shevliak ($357.72 in chips) 
Seat 2: ALBERT910 ($127.70 in chips) 
Seat 3: SEREJkE29 ($777.88 in chips) 
Seat 4: pindrokk ($695.29 in chips) 
Seat 5: GregAndrek ($695.20 in chips) 
Seat 6: mikimiki88 ($669.20 in chips) 
pindrokk: posts small blind $3
GregAndrek: posts big blind $6
*** HOLE CARDS ***
mikimiki88: folds 
shevliak: folds 
ALBERT910: folds 
SEREJkE29: raises $6 to $12
pindrokk: folds 
GregAndrek: folds 
Uncalled bet ($6) returned to SEREJkE29
SEREJkE29 collected $15 from pot
SEREJkE29: doesn't show hand 
*** SUMMARY ***
Total pot $15 | Rake $0 
Seat 1: shevliak folded before Flop (didn't bet)
Seat 2: ALBERT910 folded before Flop (didn't bet)
Seat 3: SEREJkE29 (button) collected ($15)
Seat 4: pindrokk (small blind) folded before Flop
Seat 5: GregAndrek (big blind) folded before Flop
Seat 6: mikimiki88 folded before Flop (didn't bet)


PokerStars Game #102622634427:  Hold'em No Limit ($3/$6 USD) - 2013/08/11 16:13:06 ET
Table 'Tanete V 40-100 bb' 6-max Seat #4 is the button
Seat 1: shevliak ($357.72 in chips) 
Seat 2: ALBERT910 ($127.70 in chips) 
Seat 3: SEREJkE29 ($786.88 in chips) 
Seat 4: pindrokk ($692.29 in chips) 
Seat 5: GregAndrek ($689.20 in chips) 
Seat 6: mikimiki88 ($669.20 in chips) 
GregAndrek: posts small blind $3
mikimiki88: posts big blind $6
*** HOLE CARDS ***
shevliak: folds 
ALBERT910: calls $6
SEREJkE29: folds 
pindrokk: folds 
GregAndrek: raises $15 to $21
mikimiki88: folds 
ALBERT910: raises $106.70 to $127.70 and is all-in
GregAndrek: calls $106.70
*** FLOP *** [8h 7s 5d]
*** TURN *** [8h 7s 5d] [Ts]
*** RIVER *** [8h 7s 5d Ts] [9h]
*** SHOW DOWN ***
GregAndrek: shows [Ad Qd] (high card Ace)
ALBERT910: shows [Kd As] (high card Ace - King kicker)
ALBERT910 collected $258.60 from pot
*** SUMMARY ***
Total pot $261.40 | Rake $2.80 
Board [8h 7s 5d Ts 9h]
Seat 1: shevliak folded before Flop (didn't bet)
Seat 2: ALBERT910 showed [Kd As] and won ($258.60) with high card Ace
Seat 3: SEREJkE29 folded before Flop (didn't bet)
Seat 4: pindrokk (button) folded before Flop (didn't bet)
Seat 5: GregAndrek (small blind) showed [Ad Qd] and lost with high card Ace
Seat 6: mikimiki88 (big blind) folded before Flop


PokerStars Game #102622665150:  Hold'em No Limit ($3/$6 USD) - 2013/08/11 16:13:42 ET
Table 'Tanete V 40-100 bb' 6-max Seat #5 is the button
Seat 1: shevliak ($357.72 in chips) 
Seat 2: ALBERT910 ($258.60 in chips) 
Seat 3: SEREJkE29 ($786.88 in chips) 
Seat 4: pindrokk ($692.29 in chips) 
Seat 5: GregAndrek ($600 in chips) 
Seat 6: mikimiki88 ($663.20 in chips) 
mikimiki88: posts small blind $3
shevliak: posts big blind $6
*** HOLE CARDS ***
ALBERT910: folds 
SEREJkE29: folds 
pindrokk: folds 
GregAndrek: folds 
mikimiki88: raises $9 to $15
shevliak: calls $9
*** FLOP *** [Kc Ah 7h]
mikimiki88: bets $20.34
shevliak: folds 
Uncalled bet ($20.34) returned to mikimiki88
mikimiki88 collected $28.65 from pot
mikimiki88: doesn't show hand 
*** SUMMARY ***
Total pot $30 | Rake $1.35 
Board [Kc Ah 7h]
Seat 1: shevliak (big blind) folded on the Flop
Seat 2: ALBERT910 folded before Flop (didn't bet)
Seat 3: SEREJkE29 folded before Flop (didn't bet)
Seat 4: pindrokk folded before Flop (didn't bet)
Seat 5: GregAndrek (button) folded before Flop (didn't bet)
Seat 6: mikimiki88 (small blind) collected ($28.65)


PokerStars Game #102622219131:  Hold'em No Limit ($3/$6 USD) - 2013/08/11 16:05:13 ET
Table 'Tanete V 40-100 bb' 6-max Seat #5 is the button
Seat 1: shevliak ($311.14 in chips) 
Seat 2: ALBERT910 ($60.60 in chips) 
Seat 3: SEREJkE29 ($898.48 in chips) 
Seat 4: pindrokk ($710.29 in chips) 
Seat 5: GregAndrek ($743.20 in chips) 
Seat 6: mikimiki88 ($603 in chips) 
mikimiki88: posts small blind $3
shevliak: posts big blind $6
*** HOLE CARDS ***
ALBERT910: raises $6 to $12
SEREJkE29: folds 
pindrokk: folds 
GregAndrek: folds 
mikimiki88: folds 
shevliak: folds 
Uncalled bet ($6) returned to ALBERT910
ALBERT910 collected $15 from pot
ALBERT910: doesn't show hand 
*** SUMMARY ***
Total pot $15 | Rake $0 
Seat 1: shevliak (big blind) folded before Flop
Seat 2: ALBERT910 collected ($15)
Seat 3: SEREJkE29 folded before Flop (didn't bet)
Seat 4: pindrokk folded before Flop (didn't bet)
Seat 5: GregAndrek (button) folded before Flop (didn't bet)
Seat 6: mikimiki88 (small blind) folded before Flop


PokerStars Game #102622240268:  Hold'em No Limit ($3/$6 USD) - 2013/08/11 16:05:37 ET
Table 'Tanete V 40-100 bb' 6-max Seat #6 is the button
Seat 1: shevliak ($305.14 in chips) 
Seat 2: ALBERT910 ($69.60 in chips) 
Seat 3: SEREJkE29 ($898.48 in chips) 
Seat 4: pindrokk ($710.29 in chips) 
Seat 5: GregAndrek ($743.20 in chips) 
Seat 6: mikimiki88 ($600 in chips) 
shevliak: posts small blind $3
ALBERT910: posts big blind $6
*** HOLE CARDS ***
SEREJkE29: folds 
pindrokk: folds 
GregAndrek: folds 
mikimiki88: folds 
shevliak: raises $12 to $18
ALBERT910: calls $12
*** FLOP *** [Qs Qd Qh]
shevliak: bets $25.80
ALBERT910: folds 
Uncalled bet ($25.80) returned to shevliak
shevliak collected $34.38 from pot
shevliak: doesn't show hand 
*** SUMMARY ***
Total pot $36 | Rake $1.62 
Board [Qs Qd Qh]
Seat 1: shevliak (small blind) collected ($34.38)
Seat 2: ALBERT910 (big blind) folded on the Flop
Seat 3: SEREJkE29 folded before Flop (didn't bet)
Seat 4: pindrokk folded before Flop (didn't bet)
Seat 5: GregAndrek folded before Flop (didn't bet)
Seat 6: mikimiki88 (button) folded before Flop (didn't bet)


PokerStars Game #102622285078:  Hold'em No Limit ($3/$6 USD) - 2013/08/11 16:06:27 ET
Table 'Tanete V 40-100 bb' 6-max Seat #1 is the button
Seat 1: shevliak ($321.52 in chips) 
Seat 2: ALBERT910 ($51.60 in chips) 
Seat 3: SEREJkE29 ($898.48 in chips) 
Seat 4: pindrokk ($710.29 in chips) 
Seat 5: GregAndrek ($743.20 in chips) 
Seat 6: mikimiki88 ($600 in chips) 
ALBERT910: posts small blind $3
SEREJkE29: posts big blind $6
*** HOLE CARDS ***
pindrokk: folds 
GregAndrek: folds 
mikimiki88: folds 
shevliak: folds 
ALBERT910: calls $3
SEREJkE29: checks 
*** FLOP *** [Ac Kc 4d]
ALBERT910: bets $12
SEREJkE29: calls $12
*** TURN *** [Ac Kc 4d] [Th]
ALBERT910: bets $33.60 and is all-in
SEREJkE29: calls $33.60
*** RIVER *** [Ac Kc 4d Th] [2c]
*** SHOW DOWN ***
ALBERT910: shows [6c 8c] (a flush, Ace high)
SEREJkE29: shows [Ks Td] (two pair, Kings and Tens)
ALBERT910 collected $100.40 from pot
*** SUMMARY ***
Total pot $103.20 | Rake $2.80 
Board [Ac Kc 4d Th 2c]
Seat 1: shevliak (button) folded before Flop (didn't bet)
Seat 2: ALBERT910 (small blind) showed [6c 8c] and won ($100.40) with a flush, Ace high
Seat 3: SEREJkE29 (big blind) showed [Ks Td] and lost with two pair, Kings and Tens
Seat 4: pindrokk folded before Flop (didn't bet)
Seat 5: GregAndrek folded before Flop (didn't bet)
Seat 6: mikimiki88 folded before Flop (didn't bet)


PokerStars Game #102622315202:  Hold'em No Limit ($3/$6 USD) - 2013/08/11 16:07:01 ET
Table 'Tanete V 40-100 bb' 6-max Seat #2 is the button
Seat 1: shevliak ($321.52 in chips) 
Seat 2: ALBERT910 ($100.40 in chips) 
Seat 3: SEREJkE29 ($846.88 in chips) 
Seat 4: pindrokk ($710.29 in chips) 
Seat 5: GregAndrek ($743.20 in chips) 
Seat 6: mikimiki88 ($600 in chips) 
SEREJkE29: posts small blind $3
pindrokk: posts big blind $6
*** HOLE CARDS ***
GregAndrek: folds 
mikimiki88: folds 
shevliak: folds 
ALBERT910: calls $6
SEREJkE29: folds 
pindrokk: checks 
*** FLOP *** [6h 7h 5c]
pindrokk: checks 
ALBERT910: bets $12
pindrokk: folds 
Uncalled bet ($12) returned to ALBERT910
ALBERT910 collected $14.32 from pot
ALBERT910: doesn't show hand 
*** SUMMARY ***
Total pot $15 | Rake $0.68 
Board [6h 7h 5c]
Seat 1: shevliak folded before Flop (didn't bet)
Seat 2: ALBERT910 (button) collected ($14.32)
Seat 3: SEREJkE29 (small blind) folded before Flop
Seat 4: pindrokk (big blind) folded on the Flop
Seat 5: GregAndrek folded before Flop (didn't bet)
Seat 6: mikimiki88 folded before Flop (didn't bet)


PokerStars Game #102622347807:  Hold'em No Limit ($3/$6 USD) - 2013/08/11 16:07:37 ET
Table 'Tanete V 40-100 bb' 6-max Seat #3 is the button
Seat 1: shevliak ($321.52 in chips) 
Seat 2: ALBERT910 ($108.72 in chips) 
Seat 3: SEREJkE29 ($843.88 in chips) 
Seat 4: pindrokk ($704.29 in chips) 
Seat 5: GregAndrek ($743.20 in chips) 
Seat 6: mikimiki88 ($600 in chips) 
pindrokk: posts small blind $3
GregAndrek: posts big blind $6
*** HOLE CARDS ***
mikimiki88: folds 
shevliak: folds 
ALBERT910: calls $6
SEREJkE29: raises $12 to $18
pindrokk: folds 
GregAndrek: folds 
ALBERT910: calls $12
*** FLOP *** [9d 4s Td]
ALBERT910: checks 
SEREJkE29: checks 
*** TURN *** [9d 4s Td] [8d]
ALBERT910: checks 
SEREJkE29: checks 
*** RIVER *** [9d 4s Td 8d] [3c]
ALBERT910: bets $30
SEREJkE29: folds 
Uncalled bet ($30) returned to ALBERT910
ALBERT910 collected $42.98 from pot
ALBERT910: doesn't show hand 
*** SUMMARY ***
Total pot $45 | Rake $2.02 
Board [9d 4s Td 8d 3c]
Seat 1: shevliak folded before Flop (didn't bet)
Seat 2: ALBERT910 collected ($42.98)
Seat 3: SEREJkE29 (button) folded on the River
Seat 4: pindrokk (small blind) folded before Flop
Seat 5: GregAndrek (big blind) folded before Flop
Seat 6: mikimiki88 folded before Flop (didn't bet)


PokerStars Game #102622423108:  Hold'em No Limit ($3/$6 USD) - 2013/08/11 16:09:02 ET
Table 'Tanete V 40-100 bb' 6-max Seat #4 is the button
Seat 1: shevliak ($321.52 in chips) 
Seat 2: ALBERT910 ($133.70 in chips) 
Seat 3: SEREJkE29 ($825.88 in chips) 
Seat 4: pindrokk ($701.29 in chips) 
Seat 5: GregAndrek ($737.20 in chips) 
Seat 6: mikimiki88 ($600 in chips) 
GregAndrek: posts small blind $3
mikimiki88: posts big blind $6
*** HOLE CARDS ***
shevliak: folds 
ALBERT910: folds 
SEREJkE29: raises $9 to $15
pindrokk: folds 
GregAndrek: folds 
mikimiki88: folds 
Uncalled bet ($9) returned to SEREJkE29
SEREJkE29 collected $15 from pot
SEREJkE29: doesn't show hand 
*** SUMMARY ***
Total pot $15 | Rake $0 
Seat 1: shevliak folded before Flop (didn't bet)
Seat 2: ALBERT910 folded before Flop (didn't bet)
Seat 3: SEREJkE29 collected ($15)
Seat 4: pindrokk (button) folded before Flop (didn't bet)
Seat 5: GregAndrek (small blind) folded before Flop
Seat 6: mikimiki88 (big blind) folded before Flop


PokerStars Game #102622447236:  Hold'em No Limit ($3/$6 USD) - 2013/08/11 16:09:30 ET
Table 'Tanete V 40-100 bb' 6-max Seat #5 is the button
Seat 1: shevliak ($321.52 in chips) 
Seat 2: ALBERT910 ($133.70 in chips) 
Seat 3: SEREJkE29 ($834.88 in chips) 
Seat 4: pindrokk ($701.29 in chips) 
Seat 5: GregAndrek ($734.20 in chips) 
Seat 6: mikimiki88 ($600 in chips) 
mikimiki88: posts small blind $3
shevliak: posts big blind $6
*** HOLE CARDS ***
ALBERT910: folds 
SEREJkE29: folds 
pindrokk: folds 
GregAndrek: raises $6 to $12
mikimiki88: folds 
shevliak: raises $27 to $39
GregAndrek: calls $27
*** FLOP *** [7d 3c 6d]
shevliak: bets $42.22
GregAndrek: folds 
Uncalled bet ($42.22) returned to shevliak
shevliak collected $78.20 from pot
shevliak: doesn't show hand 
*** SUMMARY ***
Total pot $81 | Rake $2.80 
Board [7d 3c 6d]
Seat 1: shevliak (big blind) collected ($78.20)
Seat 2: ALBERT910 folded before Flop (didn't bet)
Seat 3: SEREJkE29 folded before Flop (didn't bet)
Seat 4: pindrokk folded before Flop (didn't bet)
Seat 5: GregAndrek (button) folded on the Flop
Seat 6: mikimiki88 (small blind) folded before Flop


PokerStars Game #102621805819:  Hold'em No Limit ($3/$6 USD) - 2013/08/11 15:55:07 ET
Table 'Tanete V 40-100 bb' 6-max Seat #4 is the button
Seat 1: shevliak ($243 in chips) 
Seat 3: SEREJkE29 ($855.66 in chips) 
Seat 4: pindrokk ($762.79 in chips) 
shevliak: posts small blind $3
SEREJkE29: posts big blind $6
*** HOLE CARDS ***
pindrokk: folds 
shevliak: raises $6.90 to $12.90
SEREJkE29: calls $6.90
*** FLOP *** [6c Ah 8c]
shevliak: bets $15.76
SEREJkE29: folds 
Uncalled bet ($15.76) returned to shevliak
shevliak collected $24.64 from pot
shevliak: doesn't show hand 
*** SUMMARY ***
Total pot $25.80 | Rake $1.16 
Board [6c Ah 8c]
Seat 1: shevliak (small blind) collected ($24.64)
Seat 3: SEREJkE29 (big blind) folded on the Flop
Seat 4: pindrokk (button) folded before Flop (didn't bet)


PokerStars Game #102621819607:  Hold'em No Limit ($3/$6 USD) - 2013/08/11 15:55:30 ET
Table 'Tanete V 40-100 bb' 6-max Seat #1 is the button
Seat 1: shevliak ($254.74 in chips) 
Seat 3: SEREJkE29 ($842.76 in chips) 
Seat 4: pindrokk ($762.79 in chips) 
ALBERT910 will be allowed to play after the button
SEREJkE29: posts small blind $3
pindrokk: posts big blind $6
*** HOLE CARDS ***
shevliak: folds 
SEREJkE29: raises $12 to $18
pindrokk: folds 
Uncalled bet ($12) returned to SEREJkE29
SEREJkE29 collected $12 from pot
SEREJkE29: doesn't show hand 
*** SUMMARY ***
Total pot $12 | Rake $0 
Seat 1: shevliak (button) folded before Flop (didn't bet)
Seat 3: SEREJkE29 (small blind) collected ($12)
Seat 4: pindrokk (big blind) folded before Flop


PokerStars Game #102621826278:  Hold'em No Limit ($3/$6 USD) - 2013/08/11 15:55:43 ET
Table 'Tanete V 40-100 bb' 6-max Seat #3 is the button
Seat 1: shevliak ($254.74 in chips) 
Seat 2: ALBERT910 ($127.50 in chips) 
Seat 3: SEREJkE29 ($848.76 in chips) 
Seat 4: pindrokk ($756.79 in chips) 
pindrokk: posts small blind $3
shevliak: posts big blind $6
ALBERT910: posts small & big blinds $9
*** HOLE CARDS ***
ALBERT910: checks 
SEREJkE29: raises $12 to $18
pindrokk: folds 
shevliak: raises $36 to $54
ALBERT910: folds 
SEREJkE29: folds 
Uncalled bet ($36) returned to shevliak
shevliak collected $48 from pot
shevliak: doesn't show hand 
*** SUMMARY ***
Total pot $48 | Rake $0 
Seat 1: shevliak (big blind) collected ($48)
Seat 2: ALBERT910 folded before Flop
Seat 3: SEREJkE29 (button) folded before Flop
Seat 4: pindrokk (small blind) folded before Flop


PokerStars Game #102621851630:  Hold'em No Limit ($3/$6 USD) - 2013/08/11 15:56:29 ET
Table 'Tanete V 40-100 bb' 6-max Seat #4 is the button
Seat 1: shevliak ($284.74 in chips) 
Seat 2: ALBERT910 ($118.50 in chips) 
Seat 3: SEREJkE29 ($830.76 in chips) 
Seat 4: pindrokk ($753.79 in chips) 
shevliak: posts small blind $3
ALBERT910: posts big blind $6
*** HOLE CARDS ***
SEREJkE29: raises $9 to $15
pindrokk: folds 
shevliak: folds 
ALBERT910: calls $9
*** FLOP *** [7h 9c Td]
ALBERT910: checks 
SEREJkE29: bets $21
ALBERT910: folds 
Uncalled bet ($21) returned to SEREJkE29
SEREJkE29 collected $31.52 from pot
SEREJkE29: doesn't show hand 
*** SUMMARY ***
Total pot $33 | Rake $1.48 
Board [7h 9c Td]
Seat 1: shevliak (small blind) folded before Flop
Seat 2: ALBERT910 (big blind) folded on the Flop
Seat 3: SEREJkE29 collected ($31.52)
Seat 4: pindrokk (button) folded before Flop (didn't bet)


PokerStars Game #102621869193:  Hold'em No Limit ($3/$6 USD) - 2013/08/11 15:57:00 ET
Table 'Tanete V 40-100 bb' 6-max Seat #1 is the button
Seat 1: shevliak ($281.74 in chips) 
Seat 2: ALBERT910 ($103.50 in chips) 
Seat 3: SEREJkE29 ($847.28 in chips) 
Seat 4: pindrokk ($753.79 in chips) 
ALBERT910: posts small blind $3
SEREJkE29: posts big blind $6
*** HOLE CARDS ***
pindrokk: folds 
shevliak: folds 
ALBERT910: folds 
Uncalled bet ($3) returned to SEREJkE29
SEREJkE29 collected $6 from pot
SEREJkE29: doesn't show hand 
*** SUMMARY ***
Total pot $6 | Rake $0 
Seat 1: shevliak (button) folded before Flop (didn't bet)
Seat 2: ALBERT910 (small blind) folded before Flop
Seat 3: SEREJkE29 (big blind) collected ($6)
Seat 4: pindrokk folded before Flop (didn't bet)


PokerStars Game #102621874349:  Hold'em No Limit ($3/$6 USD) - 2013/08/11 15:57:10 ET
Table 'Tanete V 40-100 bb' 6-max Seat #2 is the button
Seat 1: shevliak ($281.74 in chips) 
Seat 2: ALBERT910 ($100.50 in chips) 
Seat 3: SEREJkE29 ($850.28 in chips) 
Seat 4: pindrokk ($753.79 in chips) 
SEREJkE29: posts small blind $3
pindrokk: posts big blind $6
*** HOLE CARDS ***
shevliak: raises $6.90 to $12.90
ALBERT910: folds 
SEREJkE29: folds 
pindrokk: folds 
Uncalled bet ($6.90) returned to shevliak
shevliak collected $15 from pot
shevliak: doesn't show hand 
*** SUMMARY ***
Total pot $15 | Rake $0 
Seat 1: shevliak collected ($15)
Seat 2: ALBERT910 (button) folded before Flop (didn't bet)
Seat 3: SEREJkE29 (small blind) folded before Flop
Seat 4: pindrokk (big blind) folded before Flop


PokerStars Game #102621883807:  Hold'em No Limit ($3/$6 USD) - 2013/08/11 15:57:27 ET
Table 'Tanete V 40-100 bb' 6-max Seat #3 is the button
Seat 1: shevliak ($290.74 in chips) 
Seat 2: ALBERT910 ($100.50 in chips) 
Seat 3: SEREJkE29 ($847.28 in chips) 
Seat 4: pindrokk ($747.79 in chips) 
pindrokk: posts small blind $3
shevliak: posts big blind $6
*** HOLE CARDS ***
ALBERT910: folds 
SEREJkE29: folds 
pindrokk: raises $9 to $15
shevliak: folds 
Uncalled bet ($9) returned to pindrokk
pindrokk collected $12 from pot
pindrokk: doesn't show hand 
*** SUMMARY ***
Total pot $12 | Rake $0 
Seat 1: shevliak (big blind) folded before Flop
Seat 2: ALBERT910 folded before Flop (didn't bet)
Seat 3: SEREJkE29 (button) folded before Flop (didn't bet)
Seat 4: pindrokk (small blind) collected ($12)


PokerStars Game #102621894422:  Hold'em No Limit ($3/$6 USD) - 2013/08/11 15:57:46 ET
Table 'Tanete V 40-100 bb' 6-max Seat #4 is the button
Seat 1: shevliak ($284.74 in chips) 
Seat 2: ALBERT910 ($100.50 in chips) 
Seat 3: SEREJkE29 ($847.28 in chips) 
Seat 4: pindrokk ($753.79 in chips) 
shevliak: posts small blind $3
ALBERT910: posts big blind $6
*** HOLE CARDS ***
SEREJkE29: raises $9 to $15
pindrokk: folds 
shevliak: folds 
ALBERT910: folds 
Uncalled bet ($9) returned to SEREJkE29
SEREJkE29 collected $15 from pot
SEREJkE29: doesn't show hand 
*** SUMMARY ***
Total pot $15 | Rake $0 
Seat 1: shevliak (small blind) folded before Flop
Seat 2: ALBERT910 (big blind) folded before Flop
Seat 3: SEREJkE29 collected ($15)
Seat 4: pindrokk (button) folded before Flop (didn't bet)


PokerStars Game #102621901458:  Hold'em No Limit ($3/$6 USD) - 2013/08/11 15:57:59 ET
Table 'Tanete V 40-100 bb' 6-max Seat #1 is the button
Seat 1: shevliak ($281.74 in chips) 
Seat 2: ALBERT910 ($94.50 in chips) 
Seat 3: SEREJkE29 ($856.28 in chips) 
Seat 4: pindrokk ($753.79 in chips) 
ALBERT910: posts small blind $3
SEREJkE29: posts big blind $6
*** HOLE CARDS ***
pindrokk: raises $7.50 to $13.50
shevliak: folds 
ALBERT910: calls $10.50
SEREJkE29: folds 
*** FLOP *** [5h Ah Js]
ALBERT910: checks 
pindrokk: checks 
*** TURN *** [5h Ah Js] [6h]
ALBERT910: checks 
pindrokk: checks 
*** RIVER *** [5h Ah Js 6h] [Tc]
ALBERT910: bets $12
pindrokk: calls $12
*** SHOW DOWN ***
ALBERT910: shows [Jd Ac] (two pair, Aces and Jacks)
pindrokk: mucks hand 
ALBERT910 collected $55.50 from pot
*** SUMMARY ***
Total pot $57 | Rake $1.50 
Board [5h Ah Js 6h Tc]
Seat 1: shevliak (button) folded before Flop (didn't bet)
Seat 2: ALBERT910 (small blind) showed [Jd Ac] and won ($55.50) with two pair, Aces and Jacks
Seat 3: SEREJkE29 (big blind) folded before Flop
Seat 4: pindrokk mucked


PokerStars Game #102621926118:  Hold'em No Limit ($3/$6 USD) - 2013/08/11 15:58:43 ET
Table 'Tanete V 40-100 bb' 6-max Seat #2 is the button
Seat 1: shevliak ($281.74 in chips) 
Seat 2: ALBERT910 ($124.50 in chips) 
Seat 3: SEREJkE29 ($850.28 in chips) 
Seat 4: pindrokk ($728.29 in chips) 
SEREJkE29: posts small blind $3
pindrokk: posts big blind $6
*** HOLE CARDS ***
shevliak: raises $6.90 to $12.90
ALBERT910: calls $12.90
SEREJkE29: folds 
pindrokk: folds 
*** FLOP *** [As Js 6s]
shevliak: bets $21.31
ALBERT910: folds 
Uncalled bet ($21.31) returned to shevliak
shevliak collected $33.30 from pot
shevliak: doesn't show hand 
*** SUMMARY ***
Total pot $34.80 | Rake $1.50 
Board [As Js 6s]
Seat 1: shevliak collected ($33.30)
Seat 2: ALBERT910 (button) folded on the Flop
Seat 3: SEREJkE29 (small blind) folded before Flop
Seat 4: pindrokk (big blind) folded before Flop


PokerStars Game #102621944602:  Hold'em No Limit ($3/$6 USD) - 2013/08/11 15:59:17 ET
Table 'Tanete V 40-100 bb' 6-max Seat #3 is the button
Seat 1: shevliak ($302.14 in chips) 
Seat 2: ALBERT910 ($111.60 in chips) 
Seat 3: SEREJkE29 ($847.28 in chips) 
Seat 4: pindrokk ($722.29 in chips) 
Seat 5: GregAndrek ($746.20 in chips) 
pindrokk: posts small blind $3
GregAndrek: posts big blind $6
*** HOLE CARDS ***
shevliak: folds 
ALBERT910: folds 
SEREJkE29: folds 
pindrokk: folds 
Uncalled bet ($3) returned to GregAndrek
GregAndrek collected $6 from pot
GregAndrek: doesn't show hand 
*** SUMMARY ***
Total pot $6 | Rake $0 
Seat 1: shevliak folded before Flop (didn't bet)
Seat 2: ALBERT910 folded before Flop (didn't bet)
Seat 3: SEREJkE29 (button) folded before Flop (didn't bet)
Seat 4: pindrokk (small blind) folded before Flop
Seat 5: GregAndrek (big blind) collected ($6)


PokerStars Game #102621957817:  Hold'em No Limit ($3/$6 USD) - 2013/08/11 15:59:40 ET
Table 'Tanete V 40-100 bb' 6-max Seat #4 is the button
Seat 1: shevliak ($302.14 in chips) 
Seat 2: ALBERT910 ($111.60 in chips) 
Seat 3: SEREJkE29 ($847.28 in chips) 
Seat 4: pindrokk ($719.29 in chips) 
Seat 5: GregAndrek ($749.20 in chips) 
GregAndrek: posts small blind $3
shevliak: posts big blind $6
*** HOLE CARDS ***
ALBERT910 has timed out
ALBERT910: folds 
SEREJkE29: folds 
pindrokk: raises $6 to $12
GregAndrek: folds 
shevliak: folds 
Uncalled bet ($6) returned to pindrokk
pindrokk collected $15 from pot
pindrokk: doesn't show hand 
*** SUMMARY ***
Total pot $15 | Rake $0 
Seat 1: shevliak (big blind) folded before Flop
Seat 2: ALBERT910 folded before Flop (didn't bet)
Seat 3: SEREJkE29 folded before Flop (didn't bet)
Seat 4: pindrokk (button) collected ($15)
Seat 5: GregAndrek (small blind) folded before Flop


PokerStars Game #102621978305:  Hold'em No Limit ($3/$6 USD) - 2013/08/11 16:00:15 ET
Table 'Tanete V 40-100 bb' 6-max Seat #5 is the button
Seat 1: shevliak ($296.14 in chips) 
Seat 3: SEREJkE29 ($847.28 in chips) 
Seat 4: pindrokk ($728.29 in chips) 
Seat 5: GregAndrek ($746.20 in chips) 
shevliak: posts small blind $3
SEREJkE29: posts big blind $6
*** HOLE CARDS ***
pindrokk: folds 
GregAndrek: raises $6 to $12
shevliak: folds 
SEREJkE29: folds 
Uncalled bet ($6) returned to GregAndrek
GregAndrek collected $15 from pot
GregAndrek: doesn't show hand 
*** SUMMARY ***
Total pot $15 | Rake $0 
Seat 1: shevliak (small blind) folded before Flop
Seat 3: SEREJkE29 (big blind) folded before Flop
Seat 4: pindrokk folded before Flop (didn't bet)
Seat 5: GregAndrek (button) collected ($15)


PokerStars Game #102621995832:  Hold'em No Limit ($3/$6 USD) - 2013/08/11 16:00:42 ET
Table 'Tanete V 40-100 bb' 6-max Seat #1 is the button
Seat 1: shevliak ($293.14 in chips) 
Seat 3: SEREJkE29 ($841.28 in chips) 
Seat 4: pindrokk ($728.29 in chips) 
Seat 5: GregAndrek ($755.20 in chips) 
ALBERT910 will be allowed to play after the button
SEREJkE29: posts small blind $3
pindrokk: posts big blind $6
*** HOLE CARDS ***
GregAndrek: raises $9 to $15
shevliak: folds 
SEREJkE29: folds 
pindrokk: folds 
Uncalled bet ($9) returned to GregAndrek
GregAndrek collected $15 from pot
GregAndrek: doesn't show hand 
*** SUMMARY ***
Total pot $15 | Rake $0 
Seat 1: shevliak (button) folded before Flop (didn't bet)
Seat 3: SEREJkE29 (small blind) folded before Flop
Seat 4: pindrokk (big blind) folded before Flop
Seat 5: GregAndrek collected ($15)


PokerStars Game #102622006428:  Hold'em No Limit ($3/$6 USD) - 2013/08/11 16:00:58 ET
Table 'Tanete V 40-100 bb' 6-max Seat #3 is the button
Seat 1: shevliak ($293.14 in chips) 
Seat 2: ALBERT910 ($111.60 in chips) 
Seat 3: SEREJkE29 ($838.28 in chips) 
Seat 4: pindrokk ($722.29 in chips) 
Seat 5: GregAndrek ($764.20 in chips) 
pindrokk: posts small blind $3
GregAndrek: posts big blind $6
ALBERT910: posts small & big blinds $9
*** HOLE CARDS ***
shevliak: raises $15.81 to $21.81
ALBERT910: folds 
SEREJkE29: folds 
pindrokk: folds 
GregAndrek: folds 
Uncalled bet ($15.81) returned to shevliak
shevliak collected $24 from pot
shevliak: doesn't show hand 
*** SUMMARY ***
Total pot $24 | Rake $0 
Seat 1: shevliak collected ($24)
Seat 2: ALBERT910 folded before Flop
Seat 3: SEREJkE29 (button) folded before Flop (didn't bet)
Seat 4: pindrokk (small blind) folded before Flop
Seat 5: GregAndrek (big blind) folded before Flop


PokerStars Game #102622036204:  Hold'em No Limit ($3/$6 USD) - 2013/08/11 16:01:39 ET
Table 'Tanete V 40-100 bb' 6-max Seat #4 is the button
Seat 1: shevliak ($311.14 in chips) 
Seat 2: ALBERT910 ($102.60 in chips) 
Seat 3: SEREJkE29 ($838.28 in chips) 
Seat 4: pindrokk ($719.29 in chips) 
Seat 5: GregAndrek ($758.20 in chips) 
GregAndrek: posts small blind $3
shevliak: posts big blind $6
*** HOLE CARDS ***
ALBERT910: folds 
SEREJkE29: folds 
pindrokk: folds 
GregAndrek: folds 
Uncalled bet ($3) returned to shevliak
shevliak collected $6 from pot
shevliak: doesn't show hand 
*** SUMMARY ***
Total pot $6 | Rake $0 
Seat 1: shevliak (big blind) collected ($6)
Seat 2: ALBERT910 folded before Flop (didn't bet)
Seat 3: SEREJkE29 folded before Flop (didn't bet)
Seat 4: pindrokk (button) folded before Flop (didn't bet)
Seat 5: GregAndrek (small blind) folded before Flop


PokerStars Game #102622054984:  Hold'em No Limit ($3/$6 USD) - 2013/08/11 16:02:01 ET
Table 'Tanete V 40-100 bb' 6-max Seat #5 is the button
Seat 1: shevliak ($314.14 in chips) 
Seat 2: ALBERT910 ($102.60 in chips) 
Seat 3: SEREJkE29 ($838.28 in chips) 
Seat 4: pindrokk ($719.29 in chips) 
Seat 5: GregAndrek ($755.20 in chips) 
teunuss will be allowed to play after the button
teunuss was removed from the table for failing to post
shevliak: posts small blind $3
ALBERT910: posts big blind $6
*** HOLE CARDS ***
mikimiki88 joins the table at seat #6 
SEREJkE29: folds 
pindrokk: folds 
GregAndrek: raises $6 to $12
shevliak: folds 
ALBERT910: raises $12 to $24
GregAndrek: folds 
Uncalled bet ($12) returned to ALBERT910
ALBERT910 collected $27 from pot
ALBERT910: doesn't show hand 
*** SUMMARY ***
Total pot $27 | Rake $0 
Seat 1: shevliak (small blind) folded before Flop
Seat 2: ALBERT910 (big blind) collected ($27)
Seat 3: SEREJkE29 folded before Flop (didn't bet)
Seat 4: pindrokk folded before Flop (didn't bet)
Seat 5: GregAndrek (button) folded before Flop


PokerStars Game #102622074562:  Hold'em No Limit ($3/$6 USD) - 2013/08/11 16:02:26 ET
Table 'Tanete V 40-100 bb' 6-max Seat #1 is the button
Seat 1: shevliak ($311.14 in chips) 
Seat 2: ALBERT910 ($117.60 in chips) 
Seat 3: SEREJkE29 ($838.28 in chips) 
Seat 4: pindrokk ($719.29 in chips) 
Seat 5: GregAndrek ($743.20 in chips) 
ALBERT910: posts small blind $3
SEREJkE29: posts big blind $6
mikimiki88: sits out 
*** HOLE CARDS ***
pindrokk: folds 
GregAndrek: folds 
shevliak: folds 
ALBERT910: calls $3
SEREJkE29: raises $6 to $12
ALBERT910: calls $6
*** FLOP *** [9h 3d 6s]
ALBERT910: checks 
SEREJkE29: bets $15
ALBERT910: calls $15
*** TURN *** [9h 3d 6s] [Ac]
ALBERT910: checks 
SEREJkE29: checks 
*** RIVER *** [9h 3d 6s Ac] [Ad]
ALBERT910: bets $30
SEREJkE29: calls $30
*** SHOW DOWN ***
ALBERT910: shows [8h 4h] (a pair of Aces)
SEREJkE29: shows [Th Kh] (a pair of Aces - King kicker)
SEREJkE29 collected $111.20 from pot
*** SUMMARY ***
Total pot $114 | Rake $2.80 
Board [9h 3d 6s Ac Ad]
Seat 1: shevliak (button) folded before Flop (didn't bet)
Seat 2: ALBERT910 (small blind) showed [8h 4h] and lost with a pair of Aces
Seat 3: SEREJkE29 (big blind) showed [Th Kh] and won ($111.20) with a pair of Aces
Seat 4: pindrokk folded before Flop (didn't bet)
Seat 5: GregAndrek folded before Flop (didn't bet)


PokerStars Game #102622152739:  Hold'em No Limit ($3/$6 USD) - 2013/08/11 16:03:58 ET
Table 'Tanete V 40-100 bb' 6-max Seat #2 is the button
Seat 1: shevliak ($311.14 in chips) 
Seat 2: ALBERT910 ($60.60 in chips) 
Seat 3: SEREJkE29 ($892.48 in chips) 
Seat 4: pindrokk ($719.29 in chips) 
Seat 5: GregAndrek ($743.20 in chips) 
SEREJkE29: posts small blind $3
pindrokk: posts big blind $6
mikimiki88: sits out 
*** HOLE CARDS ***
GregAndrek: raises $12 to $18
shevliak: folds 
ALBERT910: folds 
SEREJkE29: folds 
pindrokk: folds 
Uncalled bet ($12) returned to GregAndrek
GregAndrek collected $15 from pot
GregAndrek: doesn't show hand 
*** SUMMARY ***
Total pot $15 | Rake $0 
Seat 1: shevliak folded before Flop (didn't bet)
Seat 2: ALBERT910 (button) folded before Flop (didn't bet)
Seat 3: SEREJkE29 (small blind) folded before Flop
Seat 4: pindrokk (big blind) folded before Flop
Seat 5: GregAndrek collected ($15)


PokerStars Game #102622176614:  Hold'em No Limit ($3/$6 USD) - 2013/08/11 16:04:25 ET
Table 'Tanete V 40-100 bb' 6-max Seat #3 is the button
Seat 1: shevliak ($311.14 in chips) 
Seat 2: ALBERT910 ($60.60 in chips) 
Seat 3: SEREJkE29 ($889.48 in chips) 
Seat 4: pindrokk ($713.29 in chips) 
Seat 5: GregAndrek ($752.20 in chips) 
pindrokk: posts small blind $3
GregAndrek: posts big blind $6
mikimiki88: sits out 
*** HOLE CARDS ***
shevliak: folds 
ALBERT910: folds 
SEREJkE29: raises $6 to $12
pindrokk: folds 
GregAndrek: folds 
Uncalled bet ($6) returned to SEREJkE29
SEREJkE29 collected $15 from pot
SEREJkE29: doesn't show hand 
*** SUMMARY ***
Total pot $15 | Rake $0 
Seat 1: shevliak folded before Flop (didn't bet)
Seat 2: ALBERT910 folded before Flop (didn't bet)
Seat 3: SEREJkE29 (button) collected ($15)
Seat 4: pindrokk (small blind) folded before Flop
Seat 5: GregAndrek (big blind) folded before Flop


PokerStars Game #102622195310:  Hold'em No Limit ($3/$6 USD) - 2013/08/11 16:04:47 ET
Table 'Tanete V 40-100 bb' 6-max Seat #4 is the button
Seat 1: shevliak ($311.14 in chips) 
Seat 2: ALBERT910 ($60.60 in chips) 
Seat 3: SEREJkE29 ($898.48 in chips) 
Seat 4: pindrokk ($710.29 in chips) 
Seat 5: GregAndrek ($746.20 in chips) 
Seat 6: mikimiki88 ($600 in chips) 
GregAndrek: posts small blind $3
mikimiki88: posts big blind $6
*** HOLE CARDS ***
shevliak: folds 
ALBERT910: folds 
SEREJkE29: folds 
pindrokk: folds 
GregAndrek: folds 
Uncalled bet ($3) returned to mikimiki88
mikimiki88 collected $6 from pot
mikimiki88: doesn't show hand 
*** SUMMARY ***
Total pot $6 | Rake $0 
Seat 1: shevliak folded before Flop (didn't bet)
Seat 2: ALBERT910 folded before Flop (didn't bet)
Seat 3: SEREJkE29 folded before Flop (didn't bet)
Seat 4: pindrokk (button) folded before Flop (didn't bet)
Seat 5: GregAndrek (small blind) folded before Flop
Seat 6: mikimiki88 (big blind) collected ($6)


PokerStars Game #102622999043:  Hold'em No Limit ($3/$6 USD) - 2013/08/11 16:20:05 ET
Table 'Tanete V 40-100 bb' 6-max Seat #1 is the button
Seat 1: shevliak ($305.52 in chips) 
Seat 2: ALBERT910 ($252.60 in chips) 
Seat 3: SEREJkE29 ($756.88 in chips) 
Seat 4: pindrokk ($728.49 in chips) 
Seat 5: GregAndrek ($631.40 in chips) 
Seat 6: mikimiki88 ($700.85 in chips) 
ALBERT910: posts small blind $3
SEREJkE29: posts big blind $6
*** HOLE CARDS ***
pindrokk: raises $12 to $18
GregAndrek: folds 
mikimiki88: folds 
shevliak: calls $18
ALBERT910: calls $15
SEREJkE29: folds 
*** FLOP *** [4h As Ts]
ALBERT910: checks 
pindrokk: bets $42
shevliak: folds 
ALBERT910: folds 
Uncalled bet ($42) returned to pindrokk
pindrokk collected $57.30 from pot
pindrokk: doesn't show hand 
*** SUMMARY ***
Total pot $60 | Rake $2.70 
Board [4h As Ts]
Seat 1: shevliak (button) folded on the Flop
Seat 2: ALBERT910 (small blind) folded on the Flop
Seat 3: SEREJkE29 (big blind) folded before Flop
Seat 4: pindrokk collected ($57.30)
Seat 5: GregAndrek folded before Flop (didn't bet)
Seat 6: mikimiki88 folded before Flop (didn't bet)


PokerStars Game #102623042982:  Hold'em No Limit ($3/$6 USD) - 2013/08/11 16:20:55 ET
Table 'Tanete V 40-100 bb' 6-max Seat #2 is the button
Seat 1: shevliak ($287.52 in chips) 
Seat 2: ALBERT910 ($234.60 in chips) 
Seat 3: SEREJkE29 ($750.88 in chips) 
Seat 4: pindrokk ($767.79 in chips) 
Seat 5: GregAndrek ($631.40 in chips) 
Seat 6: mikimiki88 ($700.85 in chips) 
SEREJkE29: posts small blind $3
pindrokk: posts big blind $6
*** HOLE CARDS ***
GregAndrek: folds 
mikimiki88: folds 
shevliak: raises $6.90 to $12.90
ALBERT910: calls $12.90
SEREJkE29: folds 
pindrokk: folds 
*** FLOP *** [Ah Qh Kh]
shevliak: bets $21.26
ALBERT910: folds 
Uncalled bet ($21.26) returned to shevliak
shevliak collected $33.23 from pot
shevliak: doesn't show hand 
*** SUMMARY ***
Total pot $34.80 | Rake $1.57 
Board [Ah Qh Kh]
Seat 1: shevliak collected ($33.23)
Seat 2: ALBERT910 (button) folded on the Flop
Seat 3: SEREJkE29 (small blind) folded before Flop
Seat 4: pindrokk (big blind) folded before Flop
Seat 5: GregAndrek folded before Flop (didn't bet)
Seat 6: mikimiki88 folded before Flop (didn't bet)


PokerStars Game #102623076614:  Hold'em No Limit ($3/$6 USD) - 2013/08/11 16:21:34 ET
Table 'Tanete V 40-100 bb' 6-max Seat #3 is the button
Seat 1: shevliak ($307.85 in chips) 
Seat 2: ALBERT910 ($221.70 in chips) 
Seat 3: SEREJkE29 ($747.88 in chips) 
Seat 4: pindrokk ($761.79 in chips) 
Seat 5: GregAndrek ($631.40 in chips) 
Seat 6: mikimiki88 ($700.85 in chips) 
pindrokk: posts small blind $3
GregAndrek: posts big blind $6
*** HOLE CARDS ***
mikimiki88: raises $12 to $18
shevliak: folds 
ALBERT910: folds 
ALBERT910 leaves the table
SEREJkE29: folds 
pindrokk: folds 
GregAndrek: folds 
Uncalled bet ($12) returned to mikimiki88
mikimiki88 collected $15 from pot
mikimiki88: doesn't show hand 
*** SUMMARY ***
Total pot $15 | Rake $0 
Seat 1: shevliak folded before Flop (didn't bet)
Seat 2: ALBERT910 folded before Flop (didn't bet)
Seat 3: SEREJkE29 (button) folded before Flop (didn't bet)
Seat 4: pindrokk (small blind) folded before Flop
Seat 5: GregAndrek (big blind) folded before Flop
Seat 6: mikimiki88 collected ($15)


PokerStars Game #102623100404:  Hold'em No Limit ($3/$6 USD) - 2013/08/11 16:22:02 ET
Table 'Tanete V 40-100 bb' 6-max Seat #4 is the button
Seat 1: shevliak ($307.85 in chips) 
Seat 3: SEREJkE29 ($747.88 in chips) 
Seat 4: pindrokk ($758.79 in chips) 
Seat 5: GregAndrek ($625.40 in chips) 
Seat 6: mikimiki88 ($709.85 in chips) 
GregAndrek: posts small blind $3
mikimiki88: posts big blind $6
*** HOLE CARDS ***
shevliak: folds 
SEREJkE29: folds 
pindrokk: folds 
GregAndrek: folds 
Uncalled bet ($3) returned to mikimiki88
mikimiki88 collected $6 from pot
mikimiki88: doesn't show hand 
*** SUMMARY ***
Total pot $6 | Rake $0 
Seat 1: shevliak folded before Flop (didn't bet)
Seat 3: SEREJkE29 folded before Flop (didn't bet)
Seat 4: pindrokk (button) folded before Flop (didn't bet)
Seat 5: GregAndrek (small blind) folded before Flop
Seat 6: mikimiki88 (big blind) collected ($6)


PokerStars Game #102623113264:  Hold'em No Limit ($3/$6 USD) - 2013/08/11 16:22:17 ET
Table 'Tanete V 40-100 bb' 6-max Seat #5 is the button
Seat 1: shevliak ($307.85 in chips) 
Seat 3: SEREJkE29 ($747.88 in chips) 
Seat 4: pindrokk ($758.79 in chips) 
Seat 5: GregAndrek ($622.40 in chips) 
Seat 6: mikimiki88 ($712.85 in chips) 
mikimiki88: posts small blind $3
shevliak: posts big blind $6
*** HOLE CARDS ***
SEREJkE29: folds 
pindrokk: folds 
GregAndrek: folds 
mikimiki88: raises $9 to $15
shevliak: raises $21 to $36
mikimiki88: folds 
Uncalled bet ($21) returned to shevliak
shevliak collected $30 from pot
shevliak: doesn't show hand 
*** SUMMARY ***
Total pot $30 | Rake $0 
Seat 1: shevliak (big blind) collected ($30)
Seat 3: SEREJkE29 folded before Flop (didn't bet)
Seat 4: pindrokk folded before Flop (didn't bet)
Seat 5: GregAndrek (button) folded before Flop (didn't bet)
Seat 6: mikimiki88 (small blind) folded before Flop


PokerStars Game #102623138102:  Hold'em No Limit ($3/$6 USD) - 2013/08/11 16:22:46 ET
Table 'Tanete V 40-100 bb' 6-max Seat #6 is the button
Seat 1: shevliak ($322.85 in chips) 
Seat 3: SEREJkE29 ($747.88 in chips) 
Seat 4: pindrokk ($758.79 in chips) 
Seat 5: GregAndrek ($622.40 in chips) 
Seat 6: mikimiki88 ($697.85 in chips) 
shevliak: posts small blind $3
SEREJkE29: posts big blind $6
*** HOLE CARDS ***
pindrokk: folds 
GregAndrek: raises $9 to $15
mikimiki88: folds 
shevliak: folds 
SEREJkE29: folds 
Uncalled bet ($9) returned to GregAndrek
GregAndrek collected $15 from pot
GregAndrek: doesn't show hand 
*** SUMMARY ***
Total pot $15 | Rake $0 
Seat 1: shevliak (small blind) folded before Flop
Seat 3: SEREJkE29 (big blind) folded before Flop
Seat 4: pindrokk folded before Flop (didn't bet)
Seat 5: GregAndrek collected ($15)
Seat 6: mikimiki88 (button) folded before Flop (didn't bet)


PokerStars Game #102623152623:  Hold'em No Limit ($3/$6 USD) - 2013/08/11 16:23:03 ET
Table 'Tanete V 40-100 bb' 6-max Seat #1 is the button
Seat 1: shevliak ($319.85 in chips) 
Seat 3: SEREJkE29 ($741.88 in chips) 
Seat 6: mikimiki88 ($697.85 in chips) 
SEREJkE29: posts small blind $3
pindrokk: is sitting out 
pindrokk leaves the table
GregAndrek: is sitting out 
mikimiki88: posts big blind $6
*** HOLE CARDS ***
shevliak: raises $6.90 to $12.90
SEREJkE29: folds 
GregAndrek leaves the table
mikimiki88: raises $17.10 to $30
shevliak: raises $24 to $54
mikimiki88: raises $643.85 to $697.85 and is all-in
LuckyBiitch joins the table at seat #2 
shevliak: calls $265.85 and is all-in
Uncalled bet ($378) returned to mikimiki88
*** FIRST FLOP *** [8c Ah Td]
*** FIRST TURN *** [8c Ah Td] [Jc]
*** FIRST RIVER *** [8c Ah Td Jc] [7c]
*** SECOND FLOP *** [Qs 6s Kd]
*** SECOND TURN *** [Qs 6s Kd] [8s]
*** SECOND RIVER *** [Qs 6s Kd 8s] [8h]
*** FIRST SHOW DOWN ***
mikimiki88: shows [6h 6d] (a pair of Sixes)
shevliak: shows [Ks Kh] (a pair of Kings)
shevliak collected $320.60 from pot
*** SECOND SHOW DOWN ***
mikimiki88: shows [6h 6d] (a full house, Sixes full of Eights)
shevliak: shows [Ks Kh] (a full house, Kings full of Eights)
shevliak collected $320.60 from pot
*** SUMMARY ***
Total pot $642.70 | Rake $1.50 
Hand was run twice
FIRST Board [8c Ah Td Jc 7c]
SECOND Board [Qs 6s Kd 8s 8h]
Seat 1: shevliak (button) showed [Ks Kh] and won ($320.60) with a pair of Kings, and won ($320.60) with a full house, Kings full of Eights
Seat 3: SEREJkE29 (small blind) folded before Flop
Seat 6: mikimiki88 (big blind) showed [6h 6d] and lost with a pair of Sixes, and lost with a full house, Sixes full of Eights


PokerStars Game #102623221993:  Hold'em No Limit ($3/$6 USD) - 2013/08/11 16:24:24 ET
Table 'Tanete V 40-100 bb' 6-max Seat #6 is the button
Seat 3: SEREJkE29 ($738.88 in chips) 
Seat 6: mikimiki88 ($600 in chips) 
mikimiki88: posts small blind $3
shevliak: is sitting out 
SEREJkE29: posts big blind $6
*** HOLE CARDS ***
shevliak leaves the table
mikimiki88: raises $6 to $12
SEREJkE29: folds 
Uncalled bet ($6) returned to mikimiki88
LuckyBiitch leaves the table
mikimiki88 collected $12 from pot
mikimiki88: doesn't show hand 
*** SUMMARY ***
Total pot $12 | Rake $0 
Seat 3: SEREJkE29 (big blind) folded before Flop
Seat 6: mikimiki88 (button) (small blind) collected ($12)
