

PokerStars Game #102592247780:  Hold'em No Limit ($3/$6 USD) - 2013/08/11 0:41:48 ET
Table 'Klemola 40-100 bb' 6-max Seat #2 is the button
Seat 2: mrienader ($600 in chips) 
Seat 5: king10clubs ($600 in chips) 
mrienader: posts small blind $3
king10clubs: posts big blind $6
*** HOLE CARDS ***
mrienader: raises $9 to $15
king10clubs: folds 
Uncalled bet ($9) returned to mrienader
mrienader collected $12 from pot
mrienader: doesn't show hand 
*** SUMMARY ***
Total pot $12 | Rake $0 
Seat 2: mrienader (button) (small blind) collected ($12)
Seat 5: king10clubs (big blind) folded before Flop


PokerStars Game #102592253927:  Hold'em No Limit ($3/$6 USD) - 2013/08/11 0:42:12 ET
Table 'Klemola 40-100 bb' 6-max Seat #5 is the button
Seat 2: mrienader ($606 in chips) 
Seat 5: king10clubs ($600 in chips) 
king10clubs: posts small blind $3
mrienader: posts big blind $6
*** HOLE CARDS ***
king10clubs said, "txs for helping bud"
king10clubs: raises $6 to $12
mrienader: folds 
Uncalled bet ($6) returned to king10clubs
king10clubs collected $12 from pot
king10clubs: doesn't show hand 
*** SUMMARY ***
Total pot $12 | Rake $0 
Seat 2: mrienader (big blind) folded before Flop
Seat 5: king10clubs (button) (small blind) collected ($12)


PokerStars Game #102592257203:  Hold'em No Limit ($3/$6 USD) - 2013/08/11 0:42:26 ET
Table 'Klemola 40-100 bb' 6-max Seat #2 is the button
Seat 2: mrienader ($600 in chips) 
Seat 5: king10clubs ($606 in chips) 
mrienader: posts small blind $3
mrienader said, "np"
king10clubs: posts big blind $6
*** HOLE CARDS ***
mrienader said, "thanks you"
mrienader said, ":)"
mrienader: folds 
Uncalled bet ($3) returned to king10clubs
king10clubs collected $6 from pot
king10clubs: doesn't show hand 
*** SUMMARY ***
Total pot $6 | Rake $0 
Seat 2: mrienader (button) (small blind) folded before Flop
Seat 5: king10clubs (big blind) collected ($6)


PokerStars Game #102592259623:  Hold'em No Limit ($3/$6 USD) - 2013/08/11 0:42:36 ET
Table 'Klemola 40-100 bb' 6-max Seat #5 is the button
Seat 2: mrienader ($600 in chips) 
Seat 5: king10clubs ($609 in chips) 
king10clubs: posts small blind $3
mrienader: posts big blind $6
*** HOLE CARDS ***
king10clubs: raises $6 to $12
mrienader: folds 
Uncalled bet ($6) returned to king10clubs
king10clubs collected $12 from pot
king10clubs: doesn't show hand 
*** SUMMARY ***
Total pot $12 | Rake $0 
Seat 2: mrienader (big blind) folded before Flop
Seat 5: king10clubs (button) (small blind) collected ($12)


PokerStars Game #102592262274:  Hold'em No Limit ($3/$6 USD) - 2013/08/11 0:42:47 ET
Table 'Klemola 40-100 bb' 6-max Seat #2 is the button
Seat 2: mrienader ($600 in chips) 
Seat 5: king10clubs ($615 in chips) 
mrienader: posts small blind $3
king10clubs: posts big blind $6
*** HOLE CARDS ***
mrienader: raises $9 to $15
king10clubs: calls $9
*** FLOP *** [5h 8s 3h]
king10clubs: checks 
mrienader: bets $18
king10clubs: calls $18
*** TURN *** [5h 8s 3h] [7s]
king10clubs: checks 
mrienader: checks 
*** RIVER *** [5h 8s 3h 7s] [Ad]
king10clubs: bets $53
mrienader: folds 
Uncalled bet ($53) returned to king10clubs
king10clubs collected $65.50 from pot
king10clubs: doesn't show hand 
*** SUMMARY ***
Total pot $66 | Rake $0.50 
Board [5h 8s 3h 7s Ad]
Seat 2: mrienader (button) (small blind) folded on the River
Seat 5: king10clubs (big blind) collected ($65.50)


PokerStars Game #102592281077:  Hold'em No Limit ($3/$6 USD) - 2013/08/11 0:44:05 ET
Table 'Klemola 40-100 bb' 6-max Seat #5 is the button
Seat 2: mrienader ($600 in chips) 
Seat 5: king10clubs ($647.50 in chips) 
king10clubs: posts small blind $3
mrienader: posts big blind $6
*** HOLE CARDS ***
king10clubs: raises $6 to $12
mrienader: calls $6
*** FLOP *** [Ac Tc 8h]
mrienader: checks 
king10clubs: checks 
*** TURN *** [Ac Tc 8h] [Qd]
mrienader: bets $18
king10clubs: folds 
Uncalled bet ($18) returned to mrienader
mrienader collected $23.50 from pot
mrienader: doesn't show hand 
*** SUMMARY ***
Total pot $24 | Rake $0.50 
Board [Ac Tc 8h Qd]
Seat 2: mrienader (big blind) collected ($23.50)
Seat 5: king10clubs (button) (small blind) folded on the Turn


PokerStars Game #102592290558:  Hold'em No Limit ($3/$6 USD) - 2013/08/11 0:44:45 ET
Table 'Klemola 40-100 bb' 6-max Seat #2 is the button
Seat 2: mrienader ($611.50 in chips) 
Seat 5: king10clubs ($635.50 in chips) 
mrienader: posts small blind $3
king10clubs: posts big blind $6
*** HOLE CARDS ***
mrienader: raises $9 to $15
king10clubs: raises $37 to $52
mrienader: folds 
Uncalled bet ($37) returned to king10clubs
king10clubs collected $30 from pot
king10clubs: doesn't show hand 
*** SUMMARY ***
Total pot $30 | Rake $0 
Seat 2: mrienader (button) (small blind) folded before Flop
Seat 5: king10clubs (big blind) collected ($30)


PokerStars Game #102592369130:  Hold'em No Limit ($3/$6 USD) - 2013/08/11 0:50:12 ET
Table 'Klemola 40-100 bb' 6-max Seat #5 is the button
Seat 2: mrienader ($600 in chips) 
Seat 5: king10clubs ($784 in chips) 
king10clubs: posts small blind $3
mrienader: posts big blind $6
*** HOLE CARDS ***
king10clubs: raises $6 to $12
mrienader: folds 
Uncalled bet ($6) returned to king10clubs
king10clubs collected $12 from pot
king10clubs: doesn't show hand 
*** SUMMARY ***
Total pot $12 | Rake $0 
Seat 2: mrienader (big blind) folded before Flop
Seat 5: king10clubs (button) (small blind) collected ($12)


PokerStars Game #102592375190:  Hold'em No Limit ($3/$6 USD) - 2013/08/11 0:50:37 ET
Table 'Klemola 40-100 bb' 6-max Seat #2 is the button
Seat 2: mrienader ($600 in chips) 
Seat 5: king10clubs ($790 in chips) 
mrienader: posts small blind $3
king10clubs: posts big blind $6
*** HOLE CARDS ***
mrienader: raises $9 to $15
king10clubs: calls $9
*** FLOP *** [6c 2s Ts]
king10clubs: checks 
mrienader: bets $18
king10clubs: folds 
Uncalled bet ($18) returned to mrienader
mrienader collected $29.50 from pot
mrienader: doesn't show hand 
*** SUMMARY ***
Total pot $30 | Rake $0.50 
Board [6c 2s Ts]
Seat 2: mrienader (button) (small blind) collected ($29.50)
Seat 5: king10clubs (big blind) folded on the Flop


PokerStars Game #102592382322:  Hold'em No Limit ($3/$6 USD) - 2013/08/11 0:51:07 ET
Table 'Klemola 40-100 bb' 6-max Seat #5 is the button
Seat 2: mrienader ($614.50 in chips) 
Seat 5: king10clubs ($775 in chips) 
king10clubs: posts small blind $3
mrienader: posts big blind $6
*** HOLE CARDS ***
king10clubs: raises $6 to $12
mrienader: folds 
Uncalled bet ($6) returned to king10clubs
king10clubs collected $12 from pot
king10clubs: doesn't show hand 
*** SUMMARY ***
Total pot $12 | Rake $0 
Seat 2: mrienader (big blind) folded before Flop
Seat 5: king10clubs (button) (small blind) collected ($12)


PokerStars Game #102592385042:  Hold'em No Limit ($3/$6 USD) - 2013/08/11 0:51:18 ET
Table 'Klemola 40-100 bb' 6-max Seat #2 is the button
Seat 2: mrienader ($608.50 in chips) 
Seat 5: king10clubs ($781 in chips) 
mrienader: posts small blind $3
king10clubs: posts big blind $6
*** HOLE CARDS ***
mrienader: raises $9 to $15
king10clubs: folds 
Uncalled bet ($9) returned to mrienader
mrienader collected $12 from pot
mrienader: doesn't show hand 
*** SUMMARY ***
Total pot $12 | Rake $0 
Seat 2: mrienader (button) (small blind) collected ($12)
Seat 5: king10clubs (big blind) folded before Flop


PokerStars Game #102592389344:  Hold'em No Limit ($3/$6 USD) - 2013/08/11 0:51:36 ET
Table 'Klemola 40-100 bb' 6-max Seat #5 is the button
Seat 2: mrienader ($614.50 in chips) 
Seat 5: king10clubs ($775 in chips) 
king10clubs: posts small blind $3
mrienader: posts big blind $6
*** HOLE CARDS ***
king10clubs: raises $6 to $12
mrienader: calls $6
*** FLOP *** [9h 6c 5c]
mrienader: checks 
king10clubs: bets $16
mrienader: folds 
Uncalled bet ($16) returned to king10clubs
king10clubs collected $23.50 from pot
king10clubs: doesn't show hand 
*** SUMMARY ***
Total pot $24 | Rake $0.50 
Board [9h 6c 5c]
Seat 2: mrienader (big blind) folded on the Flop
Seat 5: king10clubs (button) (small blind) collected ($23.50)


PokerStars Game #102592396989:  Hold'em No Limit ($3/$6 USD) - 2013/08/11 0:52:08 ET
Table 'Klemola 40-100 bb' 6-max Seat #2 is the button
Seat 2: mrienader ($602.50 in chips) 
Seat 5: king10clubs ($786.50 in chips) 
mrienader: posts small blind $3
king10clubs: posts big blind $6
*** HOLE CARDS ***
mrienader: raises $9 to $15
king10clubs: folds 
Uncalled bet ($9) returned to mrienader
mrienader collected $12 from pot
mrienader: doesn't show hand 
*** SUMMARY ***
Total pot $12 | Rake $0 
Seat 2: mrienader (button) (small blind) collected ($12)
Seat 5: king10clubs (big blind) folded before Flop


PokerStars Game #102592399832:  Hold'em No Limit ($3/$6 USD) - 2013/08/11 0:52:20 ET
Table 'Klemola 40-100 bb' 6-max Seat #5 is the button
Seat 2: mrienader ($608.50 in chips) 
Seat 5: king10clubs ($780.50 in chips) 
king10clubs: posts small blind $3
mrienader: posts big blind $6
*** HOLE CARDS ***
king10clubs: raises $6 to $12
mrienader: folds 
Uncalled bet ($6) returned to king10clubs
king10clubs collected $12 from pot
king10clubs: doesn't show hand 
*** SUMMARY ***
Total pot $12 | Rake $0 
Seat 2: mrienader (big blind) folded before Flop
Seat 5: king10clubs (button) (small blind) collected ($12)


PokerStars Game #102592403062:  Hold'em No Limit ($3/$6 USD) - 2013/08/11 0:52:34 ET
Table 'Klemola 40-100 bb' 6-max Seat #2 is the button
Seat 2: mrienader ($602.50 in chips) 
Seat 5: king10clubs ($786.50 in chips) 
mrienader: posts small blind $3
king10clubs: posts big blind $6
*** HOLE CARDS ***
mrienader: raises $9 to $15
king10clubs: folds 
Uncalled bet ($9) returned to mrienader
mrienader collected $12 from pot
mrienader: doesn't show hand 
*** SUMMARY ***
Total pot $12 | Rake $0 
Seat 2: mrienader (button) (small blind) collected ($12)
Seat 5: king10clubs (big blind) folded before Flop


PokerStars Game #102592405924:  Hold'em No Limit ($3/$6 USD) - 2013/08/11 0:52:46 ET
Table 'Klemola 40-100 bb' 6-max Seat #5 is the button
Seat 2: mrienader ($608.50 in chips) 
Seat 5: king10clubs ($780.50 in chips) 
king10clubs: posts small blind $3
mrienader: posts big blind $6
*** HOLE CARDS ***
king10clubs: raises $6 to $12
mrienader: folds 
Uncalled bet ($6) returned to king10clubs
king10clubs collected $12 from pot
king10clubs: doesn't show hand 
*** SUMMARY ***
Total pot $12 | Rake $0 
Seat 2: mrienader (big blind) folded before Flop
Seat 5: king10clubs (button) (small blind) collected ($12)


PokerStars Game #102592410052:  Hold'em No Limit ($3/$6 USD) - 2013/08/11 0:53:04 ET
Table 'Klemola 40-100 bb' 6-max Seat #2 is the button
Seat 2: mrienader ($602.50 in chips) 
Seat 5: king10clubs ($786.50 in chips) 
mrienader: posts small blind $3
king10clubs: posts big blind $6
*** HOLE CARDS ***
mrienader: raises $9 to $15
king10clubs: calls $9
*** FLOP *** [As 9d Qh]
king10clubs: checks 
mrienader: bets $18
king10clubs: folds 
Uncalled bet ($18) returned to mrienader
mrienader collected $29.50 from pot
mrienader: doesn't show hand 
*** SUMMARY ***
Total pot $30 | Rake $0.50 
Board [As 9d Qh]
Seat 2: mrienader (button) (small blind) collected ($29.50)
Seat 5: king10clubs (big blind) folded on the Flop


PokerStars Game #102592416365:  Hold'em No Limit ($3/$6 USD) - 2013/08/11 0:53:30 ET
Table 'Klemola 40-100 bb' 6-max Seat #5 is the button
Seat 2: mrienader ($617 in chips) 
Seat 5: king10clubs ($771.50 in chips) 
king10clubs: posts small blind $3
mrienader: posts big blind $6
*** HOLE CARDS ***
king10clubs: raises $6 to $12
mrienader: folds 
Uncalled bet ($6) returned to king10clubs
king10clubs collected $12 from pot
king10clubs: doesn't show hand 
*** SUMMARY ***
Total pot $12 | Rake $0 
Seat 2: mrienader (big blind) folded before Flop
Seat 5: king10clubs (button) (small blind) collected ($12)


PokerStars Game #102592420391:  Hold'em No Limit ($3/$6 USD) - 2013/08/11 0:53:47 ET
Table 'Klemola 40-100 bb' 6-max Seat #2 is the button
Seat 2: mrienader ($611 in chips) 
Seat 5: king10clubs ($777.50 in chips) 
mrienader: posts small blind $3
king10clubs: posts big blind $6
*** HOLE CARDS ***
mrienader: raises $9 to $15
king10clubs: calls $9
*** FLOP *** [Ks 6c 3c]
king10clubs: checks 
mrienader: bets $18
king10clubs: calls $18
*** TURN *** [Ks 6c 3c] [2s]
king10clubs: checks 
mrienader: checks 
*** RIVER *** [Ks 6c 3c 2s] [9s]
king10clubs: bets $50
mrienader: folds 
Uncalled bet ($50) returned to king10clubs
king10clubs collected $65.50 from pot
king10clubs: doesn't show hand 
*** SUMMARY ***
Total pot $66 | Rake $0.50 
Board [Ks 6c 3c 2s 9s]
Seat 2: mrienader (button) (small blind) folded on the River
Seat 5: king10clubs (big blind) collected ($65.50)


PokerStars Game #102592436196:  Hold'em No Limit ($3/$6 USD) - 2013/08/11 0:54:55 ET
Table 'Klemola 40-100 bb' 6-max Seat #5 is the button
Seat 2: mrienader ($600 in chips) 
Seat 5: king10clubs ($810 in chips) 
king10clubs: posts small blind $3
mrienader: posts big blind $6
*** HOLE CARDS ***
king10clubs: raises $6 to $12
mrienader: folds 
Uncalled bet ($6) returned to king10clubs
king10clubs collected $12 from pot
king10clubs: doesn't show hand 
*** SUMMARY ***
Total pot $12 | Rake $0 
Seat 2: mrienader (big blind) folded before Flop
Seat 5: king10clubs (button) (small blind) collected ($12)


PokerStars Game #102592296772:  Hold'em No Limit ($3/$6 USD) - 2013/08/11 0:45:11 ET
Table 'Klemola 40-100 bb' 6-max Seat #5 is the button
Seat 2: mrienader ($600 in chips) 
Seat 5: king10clubs ($650.50 in chips) 
king10clubs: posts small blind $3
mrienader: posts big blind $6
*** HOLE CARDS ***
king10clubs: raises $6 to $12
mrienader: raises $36 to $48
king10clubs: calls $36
*** FLOP *** [Ts As Kd]
mrienader: checks 
king10clubs: checks 
*** TURN *** [Ts As Kd] [Ks]
mrienader: bets $66
king10clubs: calls $66
*** RIVER *** [Ts As Kd Ks] [9h]
mrienader: checks 
king10clubs: bets $156
mrienader: folds 
Uncalled bet ($156) returned to king10clubs
king10clubs collected $227.50 from pot
king10clubs: doesn't show hand 
*** SUMMARY ***
Total pot $228 | Rake $0.50 
Board [Ts As Kd Ks 9h]
Seat 2: mrienader (big blind) folded on the River
Seat 5: king10clubs (button) (small blind) collected ($227.50)


PokerStars Game #102592333732:  Hold'em No Limit ($3/$6 USD) - 2013/08/11 0:47:45 ET
Table 'Klemola 40-100 bb' 6-max Seat #2 is the button
Seat 2: mrienader ($600 in chips) 
Seat 5: king10clubs ($764 in chips) 
mrienader: posts small blind $3
king10clubs: posts big blind $6
*** HOLE CARDS ***
mrienader: raises $9 to $15
king10clubs: folds 
Uncalled bet ($9) returned to mrienader
mrienader collected $12 from pot
mrienader: doesn't show hand 
*** SUMMARY ***
Total pot $12 | Rake $0 
Seat 2: mrienader (button) (small blind) collected ($12)
Seat 5: king10clubs (big blind) folded before Flop


PokerStars Game #102592336192:  Hold'em No Limit ($3/$6 USD) - 2013/08/11 0:47:55 ET
Table 'Klemola 40-100 bb' 6-max Seat #5 is the button
Seat 2: mrienader ($606 in chips) 
Seat 5: king10clubs ($758 in chips) 
king10clubs: posts small blind $3
mrienader: posts big blind $6
*** HOLE CARDS ***
king10clubs: raises $6 to $12
mrienader: calls $6
*** FLOP *** [Kc 7h As]
mrienader: checks 
king10clubs: checks 
*** TURN *** [Kc 7h As] [Kh]
mrienader: checks 
king10clubs: bets $17
mrienader: folds 
Uncalled bet ($17) returned to king10clubs
king10clubs collected $23.50 from pot
king10clubs: doesn't show hand 
*** SUMMARY ***
Total pot $24 | Rake $0.50 
Board [Kc 7h As Kh]
Seat 2: mrienader (big blind) folded on the Turn
Seat 5: king10clubs (button) (small blind) collected ($23.50)


PokerStars Game #102592351497:  Hold'em No Limit ($3/$6 USD) - 2013/08/11 0:48:59 ET
Table 'Klemola 40-100 bb' 6-max Seat #2 is the button
Seat 2: mrienader ($600 in chips) 
Seat 5: king10clubs ($769.50 in chips) 
mrienader: posts small blind $3
king10clubs: posts big blind $6
*** HOLE CARDS ***
mrienader: raises $9 to $15
king10clubs: calls $9
*** FLOP *** [5c 3d 9s]
king10clubs: checks 
mrienader: checks 
*** TURN *** [5c 3d 9s] [3c]
king10clubs: checks 
mrienader: checks 
*** RIVER *** [5c 3d 9s 3c] [Td]
king10clubs: checks 
mrienader: checks 
*** SHOW DOWN ***
king10clubs: shows [4h Th] (two pair, Tens and Threes)
mrienader: mucks hand 
king10clubs collected $29.50 from pot
*** SUMMARY ***
Total pot $30 | Rake $0.50 
Board [5c 3d 9s 3c Td]
Seat 2: mrienader (button) (small blind) mucked
Seat 5: king10clubs (big blind) showed [4h Th] and won ($29.50) with two pair, Tens and Threes


PokerStars Game #102592569036:  Hold'em No Limit ($3/$6 USD) - 2013/08/11 1:05:03 ET
Table 'Klemola 40-100 bb' 6-max Seat #5 is the button
Seat 2: mrienader ($685 in chips) 
Seat 5: king10clubs ($760 in chips) 
king10clubs: posts small blind $3
mrienader: posts big blind $6
*** HOLE CARDS ***
king10clubs: folds 
Uncalled bet ($3) returned to mrienader
mrienader collected $6 from pot
mrienader: doesn't show hand 
*** SUMMARY ***
Total pot $6 | Rake $0 
Seat 2: mrienader (big blind) collected ($6)
Seat 5: king10clubs (button) (small blind) folded before Flop


PokerStars Game #102592570605:  Hold'em No Limit ($3/$6 USD) - 2013/08/11 1:05:09 ET
Table 'Klemola 40-100 bb' 6-max Seat #2 is the button
Seat 2: mrienader ($688 in chips) 
Seat 5: king10clubs ($757 in chips) 
mrienader: posts small blind $3
king10clubs: posts big blind $6
*** HOLE CARDS ***
mrienader: raises $9 to $15
king10clubs: calls $9
*** FLOP *** [2s 6d Js]
king10clubs: checks 
mrienader: checks 
*** TURN *** [2s 6d Js] [8s]
king10clubs: checks 
mrienader: checks 
*** RIVER *** [2s 6d Js 8s] [Qs]
king10clubs: checks 
mrienader: checks 
*** SHOW DOWN ***
king10clubs: shows [Kd Qc] (a pair of Queens)
mrienader: shows [Kc Qh] (a pair of Queens)
king10clubs collected $14.75 from pot
mrienader collected $14.75 from pot
*** SUMMARY ***
Total pot $30 | Rake $0.50 
Board [2s 6d Js 8s Qs]
Seat 2: mrienader (button) (small blind) showed [Kc Qh] and won ($14.75) with a pair of Queens
Seat 5: king10clubs (big blind) showed [Kd Qc] and won ($14.75) with a pair of Queens


PokerStars Game #102592583774:  Hold'em No Limit ($3/$6 USD) - 2013/08/11 1:06:03 ET
Table 'Klemola 40-100 bb' 6-max Seat #5 is the button
Seat 2: mrienader ($687.75 in chips) 
Seat 5: king10clubs ($756.75 in chips) 
king10clubs: posts small blind $3
mrienader: posts big blind $6
*** HOLE CARDS ***
king10clubs: raises $6 to $12
mrienader: raises $36 to $48
king10clubs: folds 
Uncalled bet ($36) returned to mrienader
mrienader collected $24 from pot
mrienader: doesn't show hand 
*** SUMMARY ***
Total pot $24 | Rake $0 
Seat 2: mrienader (big blind) collected ($24)
Seat 5: king10clubs (button) (small blind) folded before Flop


PokerStars Game #102592587684:  Hold'em No Limit ($3/$6 USD) - 2013/08/11 1:06:19 ET
Table 'Klemola 40-100 bb' 6-max Seat #2 is the button
Seat 2: mrienader ($699.75 in chips) 
Seat 5: king10clubs ($744.75 in chips) 
mrienader: posts small blind $3
king10clubs: posts big blind $6
*** HOLE CARDS ***
mrienader: raises $9 to $15
king10clubs: folds 
Uncalled bet ($9) returned to mrienader
mrienader collected $12 from pot
mrienader: doesn't show hand 
*** SUMMARY ***
Total pot $12 | Rake $0 
Seat 2: mrienader (button) (small blind) collected ($12)
Seat 5: king10clubs (big blind) folded before Flop


PokerStars Game #102592590731:  Hold'em No Limit ($3/$6 USD) - 2013/08/11 1:06:31 ET
Table 'Klemola 40-100 bb' 6-max Seat #5 is the button
Seat 2: mrienader ($705.75 in chips) 
Seat 5: king10clubs ($738.75 in chips) 
king10clubs: posts small blind $3
mrienader: posts big blind $6
*** HOLE CARDS ***
king10clubs: raises $6 to $12
mrienader: calls $6
*** FLOP *** [2s 4d Js]
mrienader: checks 
king10clubs: bets $6
mrienader: raises $18 to $24
king10clubs: folds 
Uncalled bet ($18) returned to mrienader
mrienader collected $35.50 from pot
mrienader: doesn't show hand 
*** SUMMARY ***
Total pot $36 | Rake $0.50 
Board [2s 4d Js]
Seat 2: mrienader (big blind) collected ($35.50)
Seat 5: king10clubs (button) (small blind) folded on the Flop


PokerStars Game #102592598819:  Hold'em No Limit ($3/$6 USD) - 2013/08/11 1:07:04 ET
Table 'Klemola 40-100 bb' 6-max Seat #2 is the button
Seat 2: mrienader ($723.25 in chips) 
Seat 5: king10clubs ($720.75 in chips) 
mrienader: posts small blind $3
king10clubs: posts big blind $6
*** HOLE CARDS ***
mrienader: raises $9 to $15
king10clubs: calls $9
*** FLOP *** [2s 4c Qs]
king10clubs: checks 
mrienader: checks 
*** TURN *** [2s 4c Qs] [Ts]
king10clubs: bets $20.60
mrienader: folds 
Uncalled bet ($20.60) returned to king10clubs
king10clubs collected $29.50 from pot
king10clubs: doesn't show hand 
*** SUMMARY ***
Total pot $30 | Rake $0.50 
Board [2s 4c Qs Ts]
Seat 2: mrienader (button) (small blind) folded on the Turn
Seat 5: king10clubs (big blind) collected ($29.50)


PokerStars Game #102592613775:  Hold'em No Limit ($3/$6 USD) - 2013/08/11 1:08:04 ET
Table 'Klemola 40-100 bb' 6-max Seat #5 is the button
Seat 2: mrienader ($708.25 in chips) 
Seat 5: king10clubs ($735.25 in chips) 
king10clubs: posts small blind $3
mrienader: posts big blind $6
*** HOLE CARDS ***
king10clubs: raises $6 to $12
mrienader: folds 
Uncalled bet ($6) returned to king10clubs
king10clubs collected $12 from pot
king10clubs: doesn't show hand 
*** SUMMARY ***
Total pot $12 | Rake $0 
Seat 2: mrienader (big blind) folded before Flop
Seat 5: king10clubs (button) (small blind) collected ($12)


PokerStars Game #102592618247:  Hold'em No Limit ($3/$6 USD) - 2013/08/11 1:08:23 ET
Table 'Klemola 40-100 bb' 6-max Seat #2 is the button
Seat 2: mrienader ($702.25 in chips) 
Seat 5: king10clubs ($741.25 in chips) 
mrienader: posts small blind $3
king10clubs: posts big blind $6
*** HOLE CARDS ***
mrienader: raises $9 to $15
king10clubs: folds 
Uncalled bet ($9) returned to mrienader
mrienader collected $12 from pot
mrienader: doesn't show hand 
*** SUMMARY ***
Total pot $12 | Rake $0 
Seat 2: mrienader (button) (small blind) collected ($12)
Seat 5: king10clubs (big blind) folded before Flop


PokerStars Game #102592621375:  Hold'em No Limit ($3/$6 USD) - 2013/08/11 1:08:35 ET
Table 'Klemola 40-100 bb' 6-max Seat #5 is the button
Seat 2: mrienader ($708.25 in chips) 
Seat 5: king10clubs ($735.25 in chips) 
king10clubs: posts small blind $3
mrienader: posts big blind $6
*** HOLE CARDS ***
king10clubs: raises $6 to $12
mrienader: raises $36 to $48
king10clubs: folds 
Uncalled bet ($36) returned to mrienader
mrienader collected $24 from pot
mrienader: doesn't show hand 
*** SUMMARY ***
Total pot $24 | Rake $0 
Seat 2: mrienader (big blind) collected ($24)
Seat 5: king10clubs (button) (small blind) folded before Flop


PokerStars Game #102592627224:  Hold'em No Limit ($3/$6 USD) - 2013/08/11 1:08:59 ET
Table 'Klemola 40-100 bb' 6-max Seat #2 is the button
Seat 2: mrienader ($720.25 in chips) 
Seat 5: king10clubs ($723.25 in chips) 
mrienader: posts small blind $3
king10clubs: posts big blind $6
*** HOLE CARDS ***
mrienader: raises $9 to $15
king10clubs: folds 
Uncalled bet ($9) returned to mrienader
mrienader collected $12 from pot
mrienader: doesn't show hand 
*** SUMMARY ***
Total pot $12 | Rake $0 
Seat 2: mrienader (button) (small blind) collected ($12)
Seat 5: king10clubs (big blind) folded before Flop


PokerStars Game #102592630143:  Hold'em No Limit ($3/$6 USD) - 2013/08/11 1:09:11 ET
Table 'Klemola 40-100 bb' 6-max Seat #5 is the button
Seat 2: mrienader ($726.25 in chips) 
Seat 5: king10clubs ($717.25 in chips) 
king10clubs: posts small blind $3
mrienader: posts big blind $6
*** HOLE CARDS ***
king10clubs: raises $6 to $12
mrienader: folds 
Uncalled bet ($6) returned to king10clubs
king10clubs collected $12 from pot
king10clubs: doesn't show hand 
*** SUMMARY ***
Total pot $12 | Rake $0 
Seat 2: mrienader (big blind) folded before Flop
Seat 5: king10clubs (button) (small blind) collected ($12)


PokerStars Game #102592633625:  Hold'em No Limit ($3/$6 USD) - 2013/08/11 1:09:25 ET
Table 'Klemola 40-100 bb' 6-max Seat #2 is the button
Seat 2: mrienader ($720.25 in chips) 
Seat 5: king10clubs ($723.25 in chips) 
mrienader: posts small blind $3
king10clubs: posts big blind $6
*** HOLE CARDS ***
mrienader: raises $9 to $15
king10clubs: folds 
Uncalled bet ($9) returned to mrienader
mrienader collected $12 from pot
mrienader: doesn't show hand 
*** SUMMARY ***
Total pot $12 | Rake $0 
Seat 2: mrienader (button) (small blind) collected ($12)
Seat 5: king10clubs (big blind) folded before Flop


PokerStars Game #102592636243:  Hold'em No Limit ($3/$6 USD) - 2013/08/11 1:09:36 ET
Table 'Klemola 40-100 bb' 6-max Seat #5 is the button
Seat 2: mrienader ($726.25 in chips) 
Seat 5: king10clubs ($717.25 in chips) 
king10clubs: posts small blind $3
mrienader: posts big blind $6
*** HOLE CARDS ***
king10clubs: raises $6 to $12
mrienader: calls $6
*** FLOP *** [Jc 5h Ah]
mrienader: checks 
king10clubs: bets $16
mrienader: calls $16
*** TURN *** [Jc 5h Ah] [6s]
mrienader: checks 
king10clubs: bets $45
mrienader: calls $45
*** RIVER *** [Jc 5h Ah 6s] [6d]
mrienader: checks 
king10clubs: bets $114
mrienader: calls $114
*** SHOW DOWN ***
king10clubs: shows [6h Kh] (three of a kind, Sixes)
mrienader: mucks hand 
king10clubs collected $373.50 from pot
*** SUMMARY ***
Total pot $374 | Rake $0.50 
Board [Jc 5h Ah 6s 6d]
Seat 2: mrienader (big blind) mucked
Seat 5: king10clubs (button) (small blind) showed [6h Kh] and won ($373.50) with three of a kind, Sixes


PokerStars Game #102592440818:  Hold'em No Limit ($3/$6 USD) - 2013/08/11 0:55:15 ET
Table 'Klemola 40-100 bb' 6-max Seat #2 is the button
Seat 2: mrienader ($600 in chips) 
Seat 5: king10clubs ($816 in chips) 
mrienader: posts small blind $3
king10clubs: posts big blind $6
*** HOLE CARDS ***
mrienader: raises $9 to $15
king10clubs: calls $9
*** FLOP *** [5h 6c 2c]
king10clubs: checks 
mrienader: bets $18
king10clubs: calls $18
*** TURN *** [5h 6c 2c] [3s]
king10clubs: checks 
mrienader: checks 
*** RIVER *** [5h 6c 2c 3s] [2s]
king10clubs: checks 
mrienader: checks 
*** SHOW DOWN ***
king10clubs: shows [3d Kd] (two pair, Threes and Deuces)
mrienader: mucks hand 
king10clubs collected $65.50 from pot
*** SUMMARY ***
Total pot $66 | Rake $0.50 
Board [5h 6c 2c 3s 2s]
Seat 2: mrienader (button) (small blind) mucked
Seat 5: king10clubs (big blind) showed [3d Kd] and won ($65.50) with two pair, Threes and Deuces


PokerStars Game #102592454179:  Hold'em No Limit ($3/$6 USD) - 2013/08/11 0:56:25 ET
Table 'Klemola 40-100 bb' 6-max Seat #5 is the button
Seat 2: mrienader ($600 in chips) 
Seat 5: king10clubs ($848.50 in chips) 
king10clubs: posts small blind $3
mrienader: posts big blind $6
*** HOLE CARDS ***
king10clubs: raises $6 to $12
mrienader: raises $36 to $48
king10clubs: calls $36
*** FLOP *** [6d Ah Jc]
mrienader: bets $54
king10clubs: calls $54
*** TURN *** [6d Ah Jc] [Kc]
mrienader: bets $102
king10clubs: folds 
Uncalled bet ($102) returned to mrienader
mrienader collected $203.50 from pot
mrienader: doesn't show hand 
*** SUMMARY ***
Total pot $204 | Rake $0.50 
Board [6d Ah Jc Kc]
Seat 2: mrienader (big blind) collected ($203.50)
Seat 5: king10clubs (button) (small blind) folded on the Turn


PokerStars Game #102592471663:  Hold'em No Limit ($3/$6 USD) - 2013/08/11 0:57:56 ET
Table 'Klemola 40-100 bb' 6-max Seat #2 is the button
Seat 2: mrienader ($701.50 in chips) 
Seat 5: king10clubs ($746.50 in chips) 
mrienader: posts small blind $3
king10clubs: posts big blind $6
*** HOLE CARDS ***
mrienader: raises $9 to $15
king10clubs: folds 
Uncalled bet ($9) returned to mrienader
mrienader collected $12 from pot
mrienader: doesn't show hand 
*** SUMMARY ***
Total pot $12 | Rake $0 
Seat 2: mrienader (button) (small blind) collected ($12)
Seat 5: king10clubs (big blind) folded before Flop


PokerStars Game #102592473444:  Hold'em No Limit ($3/$6 USD) - 2013/08/11 0:58:05 ET
Table 'Klemola 40-100 bb' 6-max Seat #5 is the button
Seat 2: mrienader ($707.50 in chips) 
Seat 5: king10clubs ($740.50 in chips) 
king10clubs: posts small blind $3
mrienader: posts big blind $6
*** HOLE CARDS ***
king10clubs: raises $6 to $12
mrienader: calls $6
*** FLOP *** [2d 9s Td]
mrienader: checks 
king10clubs: bets $16
mrienader: folds 
Uncalled bet ($16) returned to king10clubs
king10clubs collected $23.50 from pot
king10clubs: doesn't show hand 
*** SUMMARY ***
Total pot $24 | Rake $0.50 
Board [2d 9s Td]
Seat 2: mrienader (big blind) folded on the Flop
Seat 5: king10clubs (button) (small blind) collected ($23.50)


PokerStars Game #102592482769:  Hold'em No Limit ($3/$6 USD) - 2013/08/11 0:58:54 ET
Table 'Klemola 40-100 bb' 6-max Seat #2 is the button
Seat 2: mrienader ($695.50 in chips) 
Seat 5: king10clubs ($752 in chips) 
mrienader: posts small blind $3
king10clubs: posts big blind $6
*** HOLE CARDS ***
mrienader: raises $9 to $15
king10clubs: folds 
Uncalled bet ($9) returned to mrienader
mrienader collected $12 from pot
mrienader: doesn't show hand 
*** SUMMARY ***
Total pot $12 | Rake $0 
Seat 2: mrienader (button) (small blind) collected ($12)
Seat 5: king10clubs (big blind) folded before Flop


PokerStars Game #102592486224:  Hold'em No Limit ($3/$6 USD) - 2013/08/11 0:59:12 ET
Table 'Klemola 40-100 bb' 6-max Seat #5 is the button
Seat 2: mrienader ($701.50 in chips) 
Seat 5: king10clubs ($746 in chips) 
king10clubs: posts small blind $3
mrienader: posts big blind $6
*** HOLE CARDS ***
king10clubs: raises $6 to $12
mrienader: folds 
Uncalled bet ($6) returned to king10clubs
king10clubs collected $12 from pot
king10clubs: doesn't show hand 
*** SUMMARY ***
Total pot $12 | Rake $0 
Seat 2: mrienader (big blind) folded before Flop
Seat 5: king10clubs (button) (small blind) collected ($12)


PokerStars Game #102592487998:  Hold'em No Limit ($3/$6 USD) - 2013/08/11 0:59:21 ET
Table 'Klemola 40-100 bb' 6-max Seat #2 is the button
Seat 2: mrienader ($695.50 in chips) 
Seat 5: king10clubs ($752 in chips) 
mrienader: posts small blind $3
king10clubs: posts big blind $6
*** HOLE CARDS ***
mrienader: raises $9 to $15
king10clubs: calls $9
*** FLOP *** [4s 6c 2s]
king10clubs: checks 
mrienader: checks 
*** TURN *** [4s 6c 2s] [9h]
king10clubs: checks 
mrienader: checks 
*** RIVER *** [4s 6c 2s 9h] [Ad]
king10clubs: checks 
mrienader: bets $18
king10clubs: folds 
Uncalled bet ($18) returned to mrienader
mrienader collected $29.50 from pot
mrienader: doesn't show hand 
*** SUMMARY ***
Total pot $30 | Rake $0.50 
Board [4s 6c 2s 9h Ad]
Seat 2: mrienader (button) (small blind) collected ($29.50)
Seat 5: king10clubs (big blind) folded on the River


PokerStars Game #102592499334:  Hold'em No Limit ($3/$6 USD) - 2013/08/11 1:00:14 ET
Table 'Klemola 40-100 bb' 6-max Seat #5 is the button
Seat 2: mrienader ($710 in chips) 
Seat 5: king10clubs ($737 in chips) 
king10clubs: posts small blind $3
mrienader: posts big blind $6
*** HOLE CARDS ***
king10clubs: raises $6 to $12
mrienader: calls $6
*** FLOP *** [2c 4s Ah]
mrienader: checks 
king10clubs: bets $15
mrienader: calls $15
*** TURN *** [2c 4s Ah] [8d]
mrienader: checks 
king10clubs: checks 
*** RIVER *** [2c 4s Ah 8d] [Jh]
mrienader: bets $36
king10clubs: folds 
Uncalled bet ($36) returned to mrienader
mrienader collected $53.50 from pot
mrienader: doesn't show hand 
*** SUMMARY ***
Total pot $54 | Rake $0.50 
Board [2c 4s Ah 8d Jh]
Seat 2: mrienader (big blind) collected ($53.50)
Seat 5: king10clubs (button) (small blind) folded on the River


PokerStars Game #102592515000:  Hold'em No Limit ($3/$6 USD) - 2013/08/11 1:01:26 ET
Table 'Klemola 40-100 bb' 6-max Seat #2 is the button
Seat 2: mrienader ($736.50 in chips) 
Seat 5: king10clubs ($710 in chips) 
mrienader: posts small blind $3
king10clubs: posts big blind $6
*** HOLE CARDS ***
mrienader: raises $9 to $15
king10clubs: calls $9
*** FLOP *** [6s Kh 3c]
king10clubs: checks 
mrienader: bets $18
king10clubs: folds 
Uncalled bet ($18) returned to mrienader
mrienader collected $29.50 from pot
mrienader: doesn't show hand 
*** SUMMARY ***
Total pot $30 | Rake $0.50 
Board [6s Kh 3c]
Seat 2: mrienader (button) (small blind) collected ($29.50)
Seat 5: king10clubs (big blind) folded on the Flop


PokerStars Game #102592523203:  Hold'em No Limit ($3/$6 USD) - 2013/08/11 1:01:59 ET
Table 'Klemola 40-100 bb' 6-max Seat #5 is the button
Seat 2: mrienader ($751 in chips) 
Seat 5: king10clubs ($695 in chips) 
king10clubs: posts small blind $3
mrienader: posts big blind $6
*** HOLE CARDS ***
king10clubs: raises $6 to $12
mrienader: folds 
Uncalled bet ($6) returned to king10clubs
king10clubs collected $12 from pot
king10clubs: doesn't show hand 
*** SUMMARY ***
Total pot $12 | Rake $0 
Seat 2: mrienader (big blind) folded before Flop
Seat 5: king10clubs (button) (small blind) collected ($12)


PokerStars Game #102592527867:  Hold'em No Limit ($3/$6 USD) - 2013/08/11 1:02:18 ET
Table 'Klemola 40-100 bb' 6-max Seat #2 is the button
Seat 2: mrienader ($745 in chips) 
Seat 5: king10clubs ($701 in chips) 
mrienader: posts small blind $3
king10clubs: posts big blind $6
*** HOLE CARDS ***
mrienader: raises $9 to $15
king10clubs: folds 
Uncalled bet ($9) returned to mrienader
mrienader collected $12 from pot
mrienader: doesn't show hand 
*** SUMMARY ***
Total pot $12 | Rake $0 
Seat 2: mrienader (button) (small blind) collected ($12)
Seat 5: king10clubs (big blind) folded before Flop


PokerStars Game #102592530932:  Hold'em No Limit ($3/$6 USD) - 2013/08/11 1:02:31 ET
Table 'Klemola 40-100 bb' 6-max Seat #5 is the button
Seat 2: mrienader ($751 in chips) 
Seat 5: king10clubs ($695 in chips) 
king10clubs: posts small blind $3
mrienader: posts big blind $6
*** HOLE CARDS ***
king10clubs: raises $6 to $12
mrienader: calls $6
*** FLOP *** [Qd 3h 5d]
mrienader: checks 
king10clubs: bets $15
mrienader: folds 
Uncalled bet ($15) returned to king10clubs
king10clubs collected $23.50 from pot
king10clubs: doesn't show hand 
*** SUMMARY ***
Total pot $24 | Rake $0.50 
Board [Qd 3h 5d]
Seat 2: mrienader (big blind) folded on the Flop
Seat 5: king10clubs (button) (small blind) collected ($23.50)


PokerStars Game #102592543435:  Hold'em No Limit ($3/$6 USD) - 2013/08/11 1:03:21 ET
Table 'Klemola 40-100 bb' 6-max Seat #2 is the button
Seat 2: mrienader ($739 in chips) 
Seat 5: king10clubs ($706.50 in chips) 
mrienader: posts small blind $3
king10clubs: posts big blind $6
*** HOLE CARDS ***
mrienader: raises $9 to $15
king10clubs: raises $37 to $52
mrienader: folds 
Uncalled bet ($37) returned to king10clubs
king10clubs collected $30 from pot
king10clubs: doesn't show hand 
*** SUMMARY ***
Total pot $30 | Rake $0 
Seat 2: mrienader (button) (small blind) folded before Flop
Seat 5: king10clubs (big blind) collected ($30)


PokerStars Game #102592553269:  Hold'em No Limit ($3/$6 USD) - 2013/08/11 1:04:00 ET
Table 'Klemola 40-100 bb' 6-max Seat #5 is the button
Seat 2: mrienader ($724 in chips) 
Seat 5: king10clubs ($721.50 in chips) 
king10clubs: posts small blind $3
mrienader: posts big blind $6
*** HOLE CARDS ***
king10clubs: raises $6 to $12
mrienader: folds 
Uncalled bet ($6) returned to king10clubs
king10clubs collected $12 from pot
king10clubs: doesn't show hand 
*** SUMMARY ***
Total pot $12 | Rake $0 
Seat 2: mrienader (big blind) folded before Flop
Seat 5: king10clubs (button) (small blind) collected ($12)


PokerStars Game #102592556784:  Hold'em No Limit ($3/$6 USD) - 2013/08/11 1:04:14 ET
Table 'Klemola 40-100 bb' 6-max Seat #2 is the button
Seat 2: mrienader ($718 in chips) 
Seat 5: king10clubs ($727.50 in chips) 
mrienader: posts small blind $3
king10clubs: posts big blind $6
*** HOLE CARDS ***
mrienader: raises $9 to $15
king10clubs: calls $9
*** FLOP *** [Qs 2d 6c]
king10clubs: checks 
mrienader: bets $18
king10clubs: raises $39 to $57
mrienader: folds 
Uncalled bet ($39) returned to king10clubs
king10clubs collected $65.50 from pot
king10clubs: doesn't show hand 
*** SUMMARY ***
Total pot $66 | Rake $0.50 
Board [Qs 2d 6c]
Seat 2: mrienader (button) (small blind) folded on the Flop
Seat 5: king10clubs (big blind) collected ($65.50)


PokerStars Game #102592779400:  Hold'em No Limit ($3/$6 USD) - 2013/08/11 1:19:30 ET
Table 'Klemola 40-100 bb' 6-max Seat #2 is the button
Seat 1: Kies123 ($300 in chips) 
Seat 2: mrienader ($623.50 in chips) 
Seat 5: king10clubs ($997.75 in chips) 
king10clubs: posts small blind $3
Kies123: posts big blind $6
*** HOLE CARDS ***
mrienader: raises $6 to $12
king10clubs: folds 
Kies123: calls $6
*** FLOP *** [6c 4h 8s]
Naebushkin joins the table at seat #4 
Kies123: checks 
mrienader: checks 
*** TURN *** [6c 4h 8s] [9d]
HoldenUte03 joins the table at seat #3 
Kies123: bets $24
Ner4zzurri joins the table at seat #6 
mrienader: folds 
Uncalled bet ($24) returned to Kies123
Kies123 collected $25.78 from pot
*** SUMMARY ***
Total pot $27 | Rake $1.22 
Board [6c 4h 8s 9d]
Seat 1: Kies123 (big blind) collected ($25.78)
Seat 2: mrienader (button) folded on the Turn
Seat 5: king10clubs (small blind) folded before Flop


PokerStars Game #102592721824:  Hold'em No Limit ($3/$6 USD) - 2013/08/11 1:15:28 ET
Table 'Klemola 40-100 bb' 6-max Seat #5 is the button
Seat 2: mrienader ($632.50 in chips) 
Seat 5: king10clubs ($932.75 in chips) 
king10clubs: posts small blind $3
mrienader: posts big blind $6
*** HOLE CARDS ***
king10clubs: raises $6 to $12
mrienader: folds 
Uncalled bet ($6) returned to king10clubs
king10clubs collected $12 from pot
king10clubs: doesn't show hand 
*** SUMMARY ***
Total pot $12 | Rake $0 
Seat 2: mrienader (big blind) folded before Flop
Seat 5: king10clubs (button) (small blind) collected ($12)


PokerStars Game #102592723761:  Hold'em No Limit ($3/$6 USD) - 2013/08/11 1:15:36 ET
Table 'Klemola 40-100 bb' 6-max Seat #2 is the button
Seat 2: mrienader ($626.50 in chips) 
Seat 5: king10clubs ($938.75 in chips) 
mrienader: posts small blind $3
king10clubs: posts big blind $6
*** HOLE CARDS ***
mrienader said, "probably its the hour"
mrienader: raises $9 to $15
king10clubs: calls $9
*** FLOP *** [8s Ad 5d]
king10clubs: checks 
king10clubs said, "ya"
mrienader: checks 
*** TURN *** [8s Ad 5d] [Jh]
king10clubs: bets $21
mrienader: calls $21
*** RIVER *** [8s Ad 5d Jh] [9c]
king10clubs: bets $60
mrienader: folds 
Uncalled bet ($60) returned to king10clubs
king10clubs collected $71.50 from pot
king10clubs: doesn't show hand 
*** SUMMARY ***
Total pot $72 | Rake $0.50 
Board [8s Ad 5d Jh 9c]
Seat 2: mrienader (button) (small blind) folded on the River
Seat 5: king10clubs (big blind) collected ($71.50)


PokerStars Game #102592741482:  Hold'em No Limit ($3/$6 USD) - 2013/08/11 1:16:50 ET
Table 'Klemola 40-100 bb' 6-max Seat #5 is the button
Seat 2: mrienader ($600 in chips) 
Seat 5: king10clubs ($974.25 in chips) 
king10clubs: posts small blind $3
mrienader: posts big blind $6
*** HOLE CARDS ***
king10clubs: raises $6 to $12
mrienader: raises $36 to $48
king10clubs: calls $36
*** FLOP *** [8h Qc 5h]
mrienader: checks 
king10clubs: bets $54
mrienader: folds 
Uncalled bet ($54) returned to king10clubs
king10clubs collected $95.50 from pot
king10clubs: doesn't show hand 
*** SUMMARY ***
Total pot $96 | Rake $0.50 
Board [8h Qc 5h]
Seat 2: mrienader (big blind) folded on the Flop
Seat 5: king10clubs (button) (small blind) collected ($95.50)


PokerStars Game #102592756290:  Hold'em No Limit ($3/$6 USD) - 2013/08/11 1:17:52 ET
Table 'Klemola 40-100 bb' 6-max Seat #2 is the button
Seat 2: mrienader ($600 in chips) 
Seat 5: king10clubs ($1021.75 in chips) 
mrienader: posts small blind $3
king10clubs: posts big blind $6
*** HOLE CARDS ***
mrienader: raises $9 to $15
king10clubs: folds 
Uncalled bet ($9) returned to mrienader
mrienader collected $12 from pot
mrienader: doesn't show hand 
*** SUMMARY ***
Total pot $12 | Rake $0 
Seat 2: mrienader (button) (small blind) collected ($12)
Seat 5: king10clubs (big blind) folded before Flop


PokerStars Game #102592758847:  Hold'em No Limit ($3/$6 USD) - 2013/08/11 1:18:03 ET
Table 'Klemola 40-100 bb' 6-max Seat #5 is the button
Seat 2: mrienader ($606 in chips) 
Seat 5: king10clubs ($1015.75 in chips) 
king10clubs: posts small blind $3
mrienader: posts big blind $6
*** HOLE CARDS ***
king10clubs: raises $6 to $12
mrienader: folds 
Uncalled bet ($6) returned to king10clubs
king10clubs collected $12 from pot
king10clubs: doesn't show hand 
*** SUMMARY ***
Total pot $12 | Rake $0 
Seat 2: mrienader (big blind) folded before Flop
Seat 5: king10clubs (button) (small blind) collected ($12)


PokerStars Game #102592762482:  Hold'em No Limit ($3/$6 USD) - 2013/08/11 1:18:19 ET
Table 'Klemola 40-100 bb' 6-max Seat #2 is the button
Seat 2: mrienader ($600 in chips) 
Seat 5: king10clubs ($1021.75 in chips) 
mrienader: posts small blind $3
king10clubs: posts big blind $6
*** HOLE CARDS ***
mrienader: raises $9 to $15
king10clubs: folds 
Uncalled bet ($9) returned to mrienader
mrienader collected $12 from pot
mrienader: doesn't show hand 
*** SUMMARY ***
Total pot $12 | Rake $0 
Seat 2: mrienader (button) (small blind) collected ($12)
Seat 5: king10clubs (big blind) folded before Flop


PokerStars Game #102592765986:  Hold'em No Limit ($3/$6 USD) - 2013/08/11 1:18:33 ET
Table 'Klemola 40-100 bb' 6-max Seat #5 is the button
Seat 2: mrienader ($606 in chips) 
Seat 5: king10clubs ($1015.75 in chips) 
king10clubs: posts small blind $3
mrienader: posts big blind $6
*** HOLE CARDS ***
king10clubs: raises $6 to $12
mrienader: calls $6
*** FLOP *** [9d Kh 2s]
mrienader: checks 
king10clubs: checks 
*** TURN *** [9d Kh 2s] [Ad]
mrienader: checks 
king10clubs: checks 
*** RIVER *** [9d Kh 2s Ad] [Qs]
Kies123 joins the table at seat #1 
mrienader: checks 
king10clubs: checks 
*** SHOW DOWN ***
mrienader: shows [6c 9h] (a pair of Nines)
king10clubs: mucks hand 
mrienader collected $23.50 from pot
*** SUMMARY ***
Total pot $24 | Rake $0.50 
Board [9d Kh 2s Ad Qs]
Seat 2: mrienader (big blind) showed [6c 9h] and won ($23.50) with a pair of Nines
Seat 5: king10clubs (button) (small blind) mucked


PokerStars Game #102592776979:  Hold'em No Limit ($3/$6 USD) - 2013/08/11 1:19:20 ET
Table 'Klemola 40-100 bb' 6-max Seat #2 is the button
Seat 2: mrienader ($617.50 in chips) 
Seat 5: king10clubs ($1003.75 in chips) 
mrienader: posts small blind $3
king10clubs: posts big blind $6
*** HOLE CARDS ***
mrienader: raises $9 to $15
king10clubs: folds 
Uncalled bet ($9) returned to mrienader
mrienader collected $12 from pot
mrienader: doesn't show hand 
*** SUMMARY ***
Total pot $12 | Rake $0 
Seat 2: mrienader (button) (small blind) collected ($12)
Seat 5: king10clubs (big blind) folded before Flop


PokerStars Game #102592660962:  Hold'em No Limit ($3/$6 USD) - 2013/08/11 1:11:16 ET
Table 'Klemola 40-100 bb' 6-max Seat #2 is the button
Seat 2: mrienader ($600 in chips) 
Seat 5: king10clubs ($903.75 in chips) 
mrienader: posts small blind $3
king10clubs: posts big blind $6
*** HOLE CARDS ***
mrienader: raises $9 to $15
king10clubs: folds 
Uncalled bet ($9) returned to mrienader
mrienader collected $12 from pot
mrienader: doesn't show hand 
*** SUMMARY ***
Total pot $12 | Rake $0 
Seat 2: mrienader (button) (small blind) collected ($12)
Seat 5: king10clubs (big blind) folded before Flop


PokerStars Game #102592663553:  Hold'em No Limit ($3/$6 USD) - 2013/08/11 1:11:27 ET
Table 'Klemola 40-100 bb' 6-max Seat #5 is the button
Seat 2: mrienader ($606 in chips) 
Seat 5: king10clubs ($897.75 in chips) 
king10clubs: posts small blind $3
mrienader: posts big blind $6
*** HOLE CARDS ***
king10clubs: raises $6 to $12
mrienader: raises $36 to $48
king10clubs: folds 
Uncalled bet ($36) returned to mrienader
mrienader collected $24 from pot
mrienader: doesn't show hand 
*** SUMMARY ***
Total pot $24 | Rake $0 
Seat 2: mrienader (big blind) collected ($24)
Seat 5: king10clubs (button) (small blind) folded before Flop


PokerStars Game #102592669038:  Hold'em No Limit ($3/$6 USD) - 2013/08/11 1:11:49 ET
Table 'Klemola 40-100 bb' 6-max Seat #2 is the button
Seat 2: mrienader ($618 in chips) 
Seat 5: king10clubs ($885.75 in chips) 
mrienader: posts small blind $3
king10clubs: posts big blind $6
*** HOLE CARDS ***
mrienader: raises $9 to $15
king10clubs: calls $9
*** FLOP *** [8d As 5h]
king10clubs: checks 
mrienader: checks 
*** TURN *** [8d As 5h] [Kh]
king10clubs: bets $21
mrienader: calls $21
*** RIVER *** [8d As 5h Kh] [9d]
king10clubs: checks 
mrienader: checks 
*** SHOW DOWN ***
king10clubs: shows [Kd Td] (a pair of Kings)
mrienader: mucks hand 
king10clubs collected $71.50 from pot
*** SUMMARY ***
Total pot $72 | Rake $0.50 
Board [8d As 5h Kh 9d]
Seat 2: mrienader (button) (small blind) mucked
Seat 5: king10clubs (big blind) showed [Kd Td] and won ($71.50) with a pair of Kings


PokerStars Game #102592689139:  Hold'em No Limit ($3/$6 USD) - 2013/08/11 1:13:12 ET
Table 'Klemola 40-100 bb' 6-max Seat #5 is the button
Seat 2: mrienader ($600 in chips) 
Seat 5: king10clubs ($921.25 in chips) 
king10clubs: posts small blind $3
mrienader: posts big blind $6
*** HOLE CARDS ***
king10clubs: raises $6 to $12
mrienader: folds 
Uncalled bet ($6) returned to king10clubs
king10clubs collected $12 from pot
king10clubs: doesn't show hand 
*** SUMMARY ***
Total pot $12 | Rake $0 
Seat 2: mrienader (big blind) folded before Flop
Seat 5: king10clubs (button) (small blind) collected ($12)


PokerStars Game #102592691243:  Hold'em No Limit ($3/$6 USD) - 2013/08/11 1:13:20 ET
Table 'Klemola 40-100 bb' 6-max Seat #2 is the button
Seat 2: mrienader ($600 in chips) 
Seat 5: king10clubs ($927.25 in chips) 
mrienader: posts small blind $3
king10clubs: posts big blind $6
*** HOLE CARDS ***
mrienader: raises $9 to $15
king10clubs: calls $9
*** FLOP *** [Td Ks 6d]
king10clubs: checks 
mrienader: bets $18
king10clubs: calls $18
*** TURN *** [Td Ks 6d] [7h]
king10clubs: bets $45
king10clubs said, "doesnt usually take this long"
mrienader: folds 
Uncalled bet ($45) returned to king10clubs
king10clubs collected $65.50 from pot
king10clubs: doesn't show hand 
*** SUMMARY ***
Total pot $66 | Rake $0.50 
Board [Td Ks 6d 7h]
Seat 2: mrienader (button) (small blind) folded on the Turn
Seat 5: king10clubs (big blind) collected ($65.50)


PokerStars Game #102592704066:  Hold'em No Limit ($3/$6 USD) - 2013/08/11 1:14:13 ET
Table 'Klemola 40-100 bb' 6-max Seat #5 is the button
Seat 2: mrienader ($600 in chips) 
Seat 5: king10clubs ($959.75 in chips) 
king10clubs: posts small blind $3
mrienader: posts big blind $6
*** HOLE CARDS ***
king10clubs: raises $6 to $12
mrienader: folds 
Uncalled bet ($6) returned to king10clubs
king10clubs collected $12 from pot
king10clubs: doesn't show hand 
*** SUMMARY ***
Total pot $12 | Rake $0 
Seat 2: mrienader (big blind) folded before Flop
Seat 5: king10clubs (button) (small blind) collected ($12)


PokerStars Game #102592710921:  Hold'em No Limit ($3/$6 USD) - 2013/08/11 1:14:42 ET
Table 'Klemola 40-100 bb' 6-max Seat #2 is the button
Seat 2: mrienader ($600 in chips) 
Seat 5: king10clubs ($965.75 in chips) 
mrienader: posts small blind $3
king10clubs: posts big blind $6
*** HOLE CARDS ***
mrienader: raises $9 to $15
king10clubs: calls $9
*** FLOP *** [2d Th 7s]
king10clubs: checks 
mrienader: bets $18
king10clubs: calls $18
*** TURN *** [2d Th 7s] [5d]
king10clubs: checks 
mrienader: checks 
*** RIVER *** [2d Th 7s 5d] [9d]
king10clubs: checks 
mrienader: checks 
*** SHOW DOWN ***
king10clubs: shows [Ah 5h] (a pair of Fives)
mrienader: shows [Kh 7d] (a pair of Sevens)
mrienader collected $65.50 from pot
*** SUMMARY ***
Total pot $66 | Rake $0.50 
Board [2d Th 7s 5d 9d]
Seat 2: mrienader (button) (small blind) showed [Kh 7d] and won ($65.50) with a pair of Sevens
Seat 5: king10clubs (big blind) showed [Ah 5h] and lost with a pair of Fives


PokerStars Game #102592952349:  Hold'em No Limit ($3/$6 USD) - 2013/08/11 1:31:47 ET
Table 'Klemola 40-100 bb' 6-max Seat #6 is the button
Seat 3: HoldenUte03 ($282.28 in chips) 
Seat 4: Naebushkin ($600 in chips) 
Seat 5: king10clubs ($1370.65 in chips) 
Seat 6: Ner4zzurri ($600 in chips) 
mustanggino will be allowed to play after the button
HoldenUte03: posts small blind $3
Naebushkin: posts big blind $6
*** HOLE CARDS ***
king10clubs: raises $9 to $15
Ner4zzurri: folds 
HoldenUte03: folds 
Naebushkin: calls $9
*** FLOP *** [9d Jh Kc]
Naebushkin: checks 
king10clubs: bets $21
Naebushkin: folds 
Uncalled bet ($21) returned to king10clubs
king10clubs collected $31.52 from pot
king10clubs: doesn't show hand 
*** SUMMARY ***
Total pot $33 | Rake $1.48 
Board [9d Jh Kc]
Seat 3: HoldenUte03 (small blind) folded before Flop
Seat 4: Naebushkin (big blind) folded on the Flop
Seat 5: king10clubs collected ($31.52)
Seat 6: Ner4zzurri (button) folded before Flop (didn't bet)


PokerStars Game #102592959449:  Hold'em No Limit ($3/$6 USD) - 2013/08/11 1:32:18 ET
Table 'Klemola 40-100 bb' 6-max Seat #3 is the button
Seat 3: HoldenUte03 ($279.28 in chips) 
Seat 4: Naebushkin ($600 in chips) 
Seat 5: king10clubs ($1387.17 in chips) 
Seat 6: Ner4zzurri ($600 in chips) 
Naebushkin: posts small blind $3
king10clubs: posts big blind $6
mustanggino: sits out 
*** HOLE CARDS ***
Ner4zzurri: folds 
HoldenUte03: calls $6
Naebushkin: raises $24 to $30
king10clubs: folds 
HoldenUte03: folds 
Uncalled bet ($24) returned to Naebushkin
Naebushkin collected $18 from pot
Naebushkin: doesn't show hand 
*** SUMMARY ***
Total pot $18 | Rake $0 
Seat 3: HoldenUte03 (button) folded before Flop
Seat 4: Naebushkin (small blind) collected ($18)
Seat 5: king10clubs (big blind) folded before Flop
Seat 6: Ner4zzurri folded before Flop (didn't bet)


PokerStars Game #102592967875:  Hold'em No Limit ($3/$6 USD) - 2013/08/11 1:32:54 ET
Table 'Klemola 40-100 bb' 6-max Seat #4 is the button
Seat 3: HoldenUte03 ($273.28 in chips) 
Seat 4: Naebushkin ($612 in chips) 
Seat 5: king10clubs ($1381.17 in chips) 
Seat 6: Ner4zzurri ($600 in chips) 
king10clubs: posts small blind $3
Ner4zzurri: posts big blind $6
mustanggino: sits out 
*** HOLE CARDS ***
HoldenUte03: folds 
Naebushkin: folds 
king10clubs: folds 
Uncalled bet ($3) returned to Ner4zzurri
Ner4zzurri collected $6 from pot
Ner4zzurri: doesn't show hand 
*** SUMMARY ***
Total pot $6 | Rake $0 
Seat 3: HoldenUte03 folded before Flop (didn't bet)
Seat 4: Naebushkin (button) folded before Flop (didn't bet)
Seat 5: king10clubs (small blind) folded before Flop
Seat 6: Ner4zzurri (big blind) collected ($6)


PokerStars Game #102592970176:  Hold'em No Limit ($3/$6 USD) - 2013/08/11 1:33:04 ET
Table 'Klemola 40-100 bb' 6-max Seat #5 is the button
Seat 1: mustanggino ($450 in chips) 
Seat 3: HoldenUte03 ($273.28 in chips) 
Seat 4: Naebushkin ($612 in chips) 
Seat 5: king10clubs ($1378.17 in chips) 
Seat 6: Ner4zzurri ($603 in chips) 
Ner4zzurri: posts small blind $3
mustanggino: posts big blind $6
*** HOLE CARDS ***
HoldenUte03: folds 
Naebushkin: raises $12 to $18
king10clubs: calls $18
Ner4zzurri: folds 
mustanggino: folds 
*** FLOP *** [3h 4s Qc]
Naebushkin: bets $27
king10clubs: calls $27
*** TURN *** [3h 4s Qc] [9d]
Naebushkin: bets $72
king10clubs: folds 
Uncalled bet ($72) returned to Naebushkin
Naebushkin collected $96.20 from pot
Naebushkin: doesn't show hand 
*** SUMMARY ***
Total pot $99 | Rake $2.80 
Board [3h 4s Qc 9d]
Seat 1: mustanggino (big blind) folded before Flop
Seat 3: HoldenUte03 folded before Flop (didn't bet)
Seat 4: Naebushkin collected ($96.20)
Seat 5: king10clubs (button) folded on the Turn
Seat 6: Ner4zzurri (small blind) folded before Flop


PokerStars Game #102592990494:  Hold'em No Limit ($3/$6 USD) - 2013/08/11 1:34:30 ET
Table 'Klemola 40-100 bb' 6-max Seat #6 is the button
Seat 1: mustanggino ($450 in chips) 
Seat 3: HoldenUte03 ($273.28 in chips) 
Seat 4: Naebushkin ($663.20 in chips) 
Seat 5: king10clubs ($1333.17 in chips) 
Seat 6: Ner4zzurri ($600 in chips) 
mustanggino: posts small blind $3
HoldenUte03: posts big blind $6
*** HOLE CARDS ***
Naebushkin: folds 
king10clubs: raises $9 to $15
Ner4zzurri: folds 
mustanggino: folds 
HoldenUte03: calls $9
*** FLOP *** [9h Jc 3d]
HoldenUte03: checks 
king10clubs: checks 
*** TURN *** [9h Jc 3d] [3h]
HoldenUte03: bets $18
king10clubs: folds 
Uncalled bet ($18) returned to HoldenUte03
HoldenUte03 collected $31.52 from pot
*** SUMMARY ***
Total pot $33 | Rake $1.48 
Board [9h Jc 3d 3h]
Seat 1: mustanggino (small blind) folded before Flop
Seat 3: HoldenUte03 (big blind) collected ($31.52)
Seat 4: Naebushkin folded before Flop (didn't bet)
Seat 5: king10clubs folded on the Turn
Seat 6: Ner4zzurri (button) folded before Flop (didn't bet)


PokerStars Game #102592862723:  Hold'em No Limit ($3/$6 USD) - 2013/08/11 1:25:25 ET
Table 'Klemola 40-100 bb' 6-max Seat #2 is the button
Seat 1: Kies123 ($157.30 in chips) 
Seat 2: mrienader ($622.28 in chips) 
Seat 3: HoldenUte03 ($282.28 in chips) 
Seat 4: Naebushkin ($600 in chips) 
Seat 5: king10clubs ($1116.95 in chips) 
Seat 6: Ner4zzurri ($600 in chips) 
HoldenUte03: posts small blind $3
Naebushkin: posts big blind $6
*** HOLE CARDS ***
king10clubs: folds 
Ner4zzurri: folds 
Kies123: folds 
mrienader: raises $6 to $12
HoldenUte03: folds 
Naebushkin: folds 
Uncalled bet ($6) returned to mrienader
mrienader collected $15 from pot
mrienader: doesn't show hand 
*** SUMMARY ***
Total pot $15 | Rake $0 
Seat 1: Kies123 folded before Flop (didn't bet)
Seat 2: mrienader (button) collected ($15)
Seat 3: HoldenUte03 (small blind) folded before Flop
Seat 4: Naebushkin (big blind) folded before Flop
Seat 5: king10clubs folded before Flop (didn't bet)
Seat 6: Ner4zzurri folded before Flop (didn't bet)


PokerStars Game #102592867272:  Hold'em No Limit ($3/$6 USD) - 2013/08/11 1:25:44 ET
Table 'Klemola 40-100 bb' 6-max Seat #3 is the button
Seat 1: Kies123 ($157.30 in chips) 
Seat 2: mrienader ($631.28 in chips) 
Seat 3: HoldenUte03 ($279.28 in chips) 
Seat 4: Naebushkin ($600 in chips) 
Seat 5: king10clubs ($1116.95 in chips) 
Seat 6: Ner4zzurri ($600 in chips) 
Naebushkin: posts small blind $3
king10clubs: posts big blind $6
*** HOLE CARDS ***
Ner4zzurri: folds 
Kies123: folds 
mrienader: folds 
HoldenUte03: raises $6 to $12
Naebushkin: calls $9
king10clubs: raises $40 to $52
HoldenUte03: folds 
Naebushkin: folds 
Uncalled bet ($40) returned to king10clubs
king10clubs collected $36 from pot
king10clubs: doesn't show hand 
*** SUMMARY ***
Total pot $36 | Rake $0 
Seat 1: Kies123 folded before Flop (didn't bet)
Seat 2: mrienader folded before Flop (didn't bet)
Seat 3: HoldenUte03 (button) folded before Flop
Seat 4: Naebushkin (small blind) folded before Flop
Seat 5: king10clubs (big blind) collected ($36)
Seat 6: Ner4zzurri folded before Flop (didn't bet)


PokerStars Game #102592875908:  Hold'em No Limit ($3/$6 USD) - 2013/08/11 1:26:21 ET
Table 'Klemola 40-100 bb' 6-max Seat #4 is the button
Seat 1: Kies123 ($157.30 in chips) 
Seat 2: mrienader ($631.28 in chips) 
Seat 3: HoldenUte03 ($267.28 in chips) 
Seat 4: Naebushkin ($600 in chips) 
Seat 5: king10clubs ($1140.95 in chips) 
Seat 6: Ner4zzurri ($600 in chips) 
king10clubs: posts small blind $3
Ner4zzurri: posts big blind $6
*** HOLE CARDS ***
Kies123: folds 
mrienader: raises $12 to $18
HoldenUte03: folds 
Naebushkin: folds 
king10clubs: folds 
Ner4zzurri: folds 
Uncalled bet ($12) returned to mrienader
mrienader collected $15 from pot
mrienader: doesn't show hand 
*** SUMMARY ***
Total pot $15 | Rake $0 
Seat 1: Kies123 folded before Flop (didn't bet)
Seat 2: mrienader collected ($15)
Seat 3: HoldenUte03 folded before Flop (didn't bet)
Seat 4: Naebushkin (button) folded before Flop (didn't bet)
Seat 5: king10clubs (small blind) folded before Flop
Seat 6: Ner4zzurri (big blind) folded before Flop


PokerStars Game #102592883230:  Hold'em No Limit ($3/$6 USD) - 2013/08/11 1:26:52 ET
Table 'Klemola 40-100 bb' 6-max Seat #5 is the button
Seat 1: Kies123 ($157.30 in chips) 
Seat 2: mrienader ($640.28 in chips) 
Seat 3: HoldenUte03 ($267.28 in chips) 
Seat 4: Naebushkin ($600 in chips) 
Seat 5: king10clubs ($1137.95 in chips) 
Seat 6: Ner4zzurri ($600 in chips) 
Ner4zzurri: posts small blind $3
Kies123: posts big blind $6
*** HOLE CARDS ***
mrienader: folds 
HoldenUte03: folds 
Naebushkin: folds 
king10clubs: raises $6 to $12
Ner4zzurri: folds 
Kies123: calls $6
*** FLOP *** [Jd 2c 9d]
Kies123: checks 
king10clubs: checks 
*** TURN *** [Jd 2c 9d] [7d]
Kies123: checks 
king10clubs: bets $18
Kies123: calls $18
*** RIVER *** [Jd 2c 9d 7d] [5d]
Kies123: bets $30
king10clubs: calls $30
*** SHOW DOWN ***
Kies123: shows [As 4s] (high card Ace)
king10clubs: shows [9s 7s] (two pair, Nines and Sevens)
king10clubs collected $120.20 from pot
*** SUMMARY ***
Total pot $123 | Rake $2.80 
Board [Jd 2c 9d 7d 5d]
Seat 1: Kies123 (big blind) showed [As 4s] and lost with high card Ace
Seat 2: mrienader folded before Flop (didn't bet)
Seat 3: HoldenUte03 folded before Flop (didn't bet)
Seat 4: Naebushkin folded before Flop (didn't bet)
Seat 5: king10clubs (button) showed [9s 7s] and won ($120.20) with two pair, Nines and Sevens
Seat 6: Ner4zzurri (small blind) folded before Flop


PokerStars Game #102592896468:  Hold'em No Limit ($3/$6 USD) - 2013/08/11 1:27:49 ET
Table 'Klemola 40-100 bb' 6-max Seat #6 is the button
Seat 1: Kies123 ($97.30 in chips) 
Seat 2: mrienader ($640.28 in chips) 
Seat 3: HoldenUte03 ($267.28 in chips) 
Seat 4: Naebushkin ($600 in chips) 
Seat 5: king10clubs ($1198.15 in chips) 
Seat 6: Ner4zzurri ($600 in chips) 
Kies123: posts small blind $3
mrienader: posts big blind $6
*** HOLE CARDS ***
HoldenUte03: raises $6 to $12
Naebushkin: folds 
king10clubs: folds 
Ner4zzurri: folds 
Kies123: folds 
mrienader: folds 
Uncalled bet ($6) returned to HoldenUte03
HoldenUte03 collected $15 from pot
*** SUMMARY ***
Total pot $15 | Rake $0 
Seat 1: Kies123 (small blind) folded before Flop
Seat 2: mrienader (big blind) folded before Flop
Seat 3: HoldenUte03 collected ($15)
Seat 4: Naebushkin folded before Flop (didn't bet)
Seat 5: king10clubs folded before Flop (didn't bet)
Seat 6: Ner4zzurri (button) folded before Flop (didn't bet)


PokerStars Game #102592900955:  Hold'em No Limit ($3/$6 USD) - 2013/08/11 1:28:08 ET
Table 'Klemola 40-100 bb' 6-max Seat #1 is the button
Seat 1: Kies123 ($94.30 in chips) 
Seat 2: mrienader ($634.28 in chips) 
Seat 3: HoldenUte03 ($276.28 in chips) 
Seat 4: Naebushkin ($600 in chips) 
Seat 5: king10clubs ($1198.15 in chips) 
Seat 6: Ner4zzurri ($600 in chips) 
mrienader: posts small blind $3
HoldenUte03: posts big blind $6
*** HOLE CARDS ***
Naebushkin: folds 
king10clubs: folds 
Ner4zzurri: raises $9 to $15
Kies123: folds 
mrienader: folds 
HoldenUte03: folds 
Uncalled bet ($9) returned to Ner4zzurri
Ner4zzurri collected $15 from pot
*** SUMMARY ***
Total pot $15 | Rake $0 
Seat 1: Kies123 (button) folded before Flop (didn't bet)
Seat 2: mrienader (small blind) folded before Flop
Seat 3: HoldenUte03 (big blind) folded before Flop
Seat 4: Naebushkin folded before Flop (didn't bet)
Seat 5: king10clubs folded before Flop (didn't bet)
Seat 6: Ner4zzurri collected ($15)


PokerStars Game #102592906632:  Hold'em No Limit ($3/$6 USD) - 2013/08/11 1:28:33 ET
Table 'Klemola 40-100 bb' 6-max Seat #2 is the button
Seat 1: Kies123 ($94.30 in chips) 
Seat 2: mrienader ($631.28 in chips) 
Seat 3: HoldenUte03 ($270.28 in chips) 
Seat 4: Naebushkin ($600 in chips) 
Seat 5: king10clubs ($1198.15 in chips) 
Seat 6: Ner4zzurri ($609 in chips) 
HoldenUte03: posts small blind $3
Naebushkin: posts big blind $6
*** HOLE CARDS ***
king10clubs: folds 
Ner4zzurri: folds 
Kies123: folds 
mrienader: raises $6 to $12
HoldenUte03: raises $258.28 to $270.28 and is all-in
Naebushkin: folds 
mrienader: folds 
Uncalled bet ($258.28) returned to HoldenUte03
HoldenUte03 collected $30 from pot
*** SUMMARY ***
Total pot $30 | Rake $0 
Seat 1: Kies123 folded before Flop (didn't bet)
Seat 2: mrienader (button) folded before Flop
Seat 3: HoldenUte03 (small blind) collected ($30)
Seat 4: Naebushkin (big blind) folded before Flop
Seat 5: king10clubs folded before Flop (didn't bet)
Seat 6: Ner4zzurri folded before Flop (didn't bet)


PokerStars Game #102592913633:  Hold'em No Limit ($3/$6 USD) - 2013/08/11 1:29:03 ET
Table 'Klemola 40-100 bb' 6-max Seat #3 is the button
Seat 1: Kies123 ($94.30 in chips) 
Seat 2: mrienader ($619.28 in chips) 
Seat 3: HoldenUte03 ($288.28 in chips) 
Seat 4: Naebushkin ($600 in chips) 
Seat 5: king10clubs ($1198.15 in chips) 
Seat 6: Ner4zzurri ($609 in chips) 
Naebushkin: posts small blind $3
king10clubs: posts big blind $6
*** HOLE CARDS ***
Ner4zzurri: folds 
Kies123: folds 
mrienader: folds 
HoldenUte03: folds 
Naebushkin: folds 
Uncalled bet ($3) returned to king10clubs
king10clubs collected $6 from pot
king10clubs: doesn't show hand 
*** SUMMARY ***
Total pot $6 | Rake $0 
Seat 1: Kies123 folded before Flop (didn't bet)
Seat 2: mrienader folded before Flop (didn't bet)
Seat 3: HoldenUte03 (button) folded before Flop (didn't bet)
Seat 4: Naebushkin (small blind) folded before Flop
Seat 5: king10clubs (big blind) collected ($6)
Seat 6: Ner4zzurri folded before Flop (didn't bet)


PokerStars Game #102592918312:  Hold'em No Limit ($3/$6 USD) - 2013/08/11 1:29:23 ET
Table 'Klemola 40-100 bb' 6-max Seat #4 is the button
Seat 1: Kies123 ($94.30 in chips) 
Seat 2: mrienader ($619.28 in chips) 
Seat 3: HoldenUte03 ($288.28 in chips) 
Seat 4: Naebushkin ($600 in chips) 
Seat 5: king10clubs ($1201.15 in chips) 
Seat 6: Ner4zzurri ($609 in chips) 
king10clubs: posts small blind $3
Ner4zzurri: posts big blind $6
*** HOLE CARDS ***
Kies123: folds 
Kies123 leaves the table
mrienader: folds 
HoldenUte03: folds 
Naebushkin: folds 
king10clubs: raises $9 to $15
Ner4zzurri: folds 
Uncalled bet ($9) returned to king10clubs
king10clubs collected $12 from pot
king10clubs: doesn't show hand 
*** SUMMARY ***
Total pot $12 | Rake $0 
Seat 1: Kies123 folded before Flop (didn't bet)
Seat 2: mrienader folded before Flop (didn't bet)
Seat 3: HoldenUte03 folded before Flop (didn't bet)
Seat 4: Naebushkin (button) folded before Flop (didn't bet)
Seat 5: king10clubs (small blind) collected ($12)
Seat 6: Ner4zzurri (big blind) folded before Flop


PokerStars Game #102592925295:  Hold'em No Limit ($3/$6 USD) - 2013/08/11 1:29:53 ET
Table 'Klemola 40-100 bb' 6-max Seat #5 is the button
Seat 3: HoldenUte03 ($288.28 in chips) 
Seat 4: Naebushkin ($600 in chips) 
Seat 5: king10clubs ($1207.15 in chips) 
Seat 6: Ner4zzurri ($603 in chips) 
Ner4zzurri: posts small blind $3
mrienader: is sitting out 
HoldenUte03: posts big blind $6
*** HOLE CARDS ***
Naebushkin: raises $9 to $15
king10clubs: calls $15
Ner4zzurri: folds 
HoldenUte03: folds 
*** FLOP *** [8c 6h Ad]
Naebushkin: bets $21
king10clubs: raises $48 to $69
Naebushkin: raises $72 to $141
mustanggino joins the table at seat #1 
king10clubs: calls $72
*** TURN *** [8c 6h Ad] [Qd]
Naebushkin: checks 
king10clubs: bets $138
Naebushkin: folds 
Uncalled bet ($138) returned to king10clubs
king10clubs collected $319.50 from pot
king10clubs: doesn't show hand 
*** SUMMARY ***
Total pot $321 | Rake $1.50 
Board [8c 6h Ad Qd]
Seat 3: HoldenUte03 (big blind) folded before Flop
Seat 4: Naebushkin folded on the Turn
Seat 5: king10clubs (button) collected ($319.50)
Seat 6: Ner4zzurri (small blind) folded before Flop


PokerStars Game #102592789201:  Hold'em No Limit ($3/$6 USD) - 2013/08/11 1:20:12 ET
Table 'Klemola 40-100 bb' 6-max Seat #5 is the button
Seat 1: Kies123 ($313.78 in chips) 
Seat 2: mrienader ($611.50 in chips) 
Seat 5: king10clubs ($994.75 in chips) 
Ner4zzurri will be allowed to play after the button
Kies123: posts small blind $3
mrienader: posts big blind $6
HoldenUte03: sits out 
Naebushkin: sits out 
*** HOLE CARDS ***
king10clubs: raises $6 to $12
Kies123: folds 
mrienader: calls $6
*** FLOP *** [Td Kd 4c]
mrienader: checks 
king10clubs: checks 
*** TURN *** [Td Kd 4c] [Ac]
mrienader: checks 
king10clubs: checks 
*** RIVER *** [Td Kd 4c Ac] [7s]
mrienader: checks 
king10clubs: checks 
*** SHOW DOWN ***
mrienader: shows [Ks 8c] (a pair of Kings)
king10clubs: mucks hand 
mrienader collected $25.78 from pot
*** SUMMARY ***
Total pot $27 | Rake $1.22 
Board [Td Kd 4c Ac 7s]
Seat 1: Kies123 (small blind) folded before Flop
Seat 2: mrienader (big blind) showed [Ks 8c] and won ($25.78) with a pair of Kings
Seat 5: king10clubs (button) mucked


PokerStars Game #102592800393:  Hold'em No Limit ($3/$6 USD) - 2013/08/11 1:20:59 ET
Table 'Klemola 40-100 bb' 6-max Seat #1 is the button
Seat 1: Kies123 ($310.78 in chips) 
Seat 2: mrienader ($625.28 in chips) 
Seat 3: HoldenUte03 ($240 in chips) 
Seat 5: king10clubs ($982.75 in chips) 
mrienader: posts small blind $3
HoldenUte03: posts big blind $6
Naebushkin: sits out 
Ner4zzurri: sits out 
*** HOLE CARDS ***
king10clubs: folds 
Kies123: raises $6 to $12
mrienader: folds 
HoldenUte03: calls $6
*** FLOP *** [As 8s 2h]
HoldenUte03: checks 
Kies123: bets $12
HoldenUte03: calls $12
*** TURN *** [As 8s 2h] [5s]
HoldenUte03: checks 
Kies123: bets $18
HoldenUte03: raises $36 to $54
Kies123: folds 
Uncalled bet ($36) returned to HoldenUte03
HoldenUte03 collected $85.50 from pot
*** SUMMARY ***
Total pot $87 | Rake $1.50 
Board [As 8s 2h 5s]
Seat 1: Kies123 (button) folded on the Turn
Seat 2: mrienader (small blind) folded before Flop
Seat 3: HoldenUte03 (big blind) collected ($85.50)
Seat 5: king10clubs folded before Flop (didn't bet)


PokerStars Game #102592811856:  Hold'em No Limit ($3/$6 USD) - 2013/08/11 1:21:48 ET
Table 'Klemola 40-100 bb' 6-max Seat #2 is the button
Seat 1: Kies123 ($268.78 in chips) 
Seat 2: mrienader ($622.28 in chips) 
Seat 3: HoldenUte03 ($283.50 in chips) 
Seat 4: Naebushkin ($600 in chips) 
Seat 5: king10clubs ($982.75 in chips) 
HoldenUte03: posts small blind $3
Naebushkin: posts big blind $6
Ner4zzurri: sits out 
*** HOLE CARDS ***
king10clubs: raises $9 to $15
Kies123: folds 
mrienader: folds 
HoldenUte03: folds 
Naebushkin: folds 
Uncalled bet ($9) returned to king10clubs
king10clubs collected $15 from pot
king10clubs: doesn't show hand 
*** SUMMARY ***
Total pot $15 | Rake $0 
Seat 1: Kies123 folded before Flop (didn't bet)
Seat 2: mrienader (button) folded before Flop (didn't bet)
Seat 3: HoldenUte03 (small blind) folded before Flop
Seat 4: Naebushkin (big blind) folded before Flop
Seat 5: king10clubs collected ($15)


PokerStars Game #102592814471:  Hold'em No Limit ($3/$6 USD) - 2013/08/11 1:21:59 ET
Table 'Klemola 40-100 bb' 6-max Seat #3 is the button
Seat 1: Kies123 ($268.78 in chips) 
Seat 2: mrienader ($622.28 in chips) 
Seat 3: HoldenUte03 ($280.50 in chips) 
Seat 4: Naebushkin ($600 in chips) 
Seat 5: king10clubs ($991.75 in chips) 
Naebushkin: posts small blind $3
king10clubs: posts big blind $6
Ner4zzurri: sits out 
*** HOLE CARDS ***
Kies123: raises $6 to $12
mrienader: folds 
HoldenUte03: calls $12
Naebushkin: folds 
king10clubs: folds 
*** FLOP *** [6d 2c 7d]
Kies123: checks 
HoldenUte03: checks 
*** TURN *** [6d 2c 7d] [5s]
Kies123: bets $18
HoldenUte03: folds 
Uncalled bet ($18) returned to Kies123
Kies123 collected $31.52 from pot
*** SUMMARY ***
Total pot $33 | Rake $1.48 
Board [6d 2c 7d 5s]
Seat 1: Kies123 collected ($31.52)
Seat 2: mrienader folded before Flop (didn't bet)
Seat 3: HoldenUte03 (button) folded on the Turn
Seat 4: Naebushkin (small blind) folded before Flop
Seat 5: king10clubs (big blind) folded before Flop


PokerStars Game #102592822248:  Hold'em No Limit ($3/$6 USD) - 2013/08/11 1:22:32 ET
Table 'Klemola 40-100 bb' 6-max Seat #4 is the button
Seat 1: Kies123 ($288.30 in chips) 
Seat 2: mrienader ($622.28 in chips) 
Seat 3: HoldenUte03 ($268.50 in chips) 
Seat 4: Naebushkin ($600 in chips) 
Seat 5: king10clubs ($985.75 in chips) 
Seat 6: Ner4zzurri ($600 in chips) 
king10clubs: posts small blind $3
Ner4zzurri: posts big blind $6
*** HOLE CARDS ***
Kies123: raises $6 to $12
mrienader: folds 
HoldenUte03: folds 
Naebushkin: folds 
king10clubs: folds 
Ner4zzurri: folds 
Uncalled bet ($6) returned to Kies123
Kies123 collected $15 from pot
*** SUMMARY ***
Total pot $15 | Rake $0 
Seat 1: Kies123 collected ($15)
Seat 2: mrienader folded before Flop (didn't bet)
Seat 3: HoldenUte03 folded before Flop (didn't bet)
Seat 4: Naebushkin (button) folded before Flop (didn't bet)
Seat 5: king10clubs (small blind) folded before Flop
Seat 6: Ner4zzurri (big blind) folded before Flop


PokerStars Game #102592826281:  Hold'em No Limit ($3/$6 USD) - 2013/08/11 1:22:49 ET
Table 'Klemola 40-100 bb' 6-max Seat #5 is the button
Seat 1: Kies123 ($297.30 in chips) 
Seat 2: mrienader ($622.28 in chips) 
Seat 3: HoldenUte03 ($268.50 in chips) 
Seat 4: Naebushkin ($600 in chips) 
Seat 5: king10clubs ($982.75 in chips) 
Seat 6: Ner4zzurri ($600 in chips) 
Ner4zzurri: posts small blind $3
Kies123: posts big blind $6
*** HOLE CARDS ***
mrienader: folds 
HoldenUte03: folds 
Naebushkin: folds 
king10clubs: raises $6 to $12
Ner4zzurri: calls $9
Kies123: calls $6
*** FLOP *** [6h 7d 7c]
Ner4zzurri: checks 
Kies123: checks 
king10clubs: bets $23
Ner4zzurri: folds 
Kies123: calls $23
*** TURN *** [6h 7d 7c] [8d]
Kies123: bets $30
king10clubs: calls $30
*** RIVER *** [6h 7d 7c 8d] [Kh]
Kies123: bets $60
king10clubs: calls $60
*** SHOW DOWN ***
Kies123: shows [Tc Kc] (two pair, Kings and Sevens)
king10clubs: shows [As Ah] (two pair, Aces and Sevens)
king10clubs collected $259.20 from pot
*** SUMMARY ***
Total pot $262 | Rake $2.80 
Board [6h 7d 7c 8d Kh]
Seat 1: Kies123 (big blind) showed [Tc Kc] and lost with two pair, Kings and Sevens
Seat 2: mrienader folded before Flop (didn't bet)
Seat 3: HoldenUte03 folded before Flop (didn't bet)
Seat 4: Naebushkin folded before Flop (didn't bet)
Seat 5: king10clubs (button) showed [As Ah] and won ($259.20) with two pair, Aces and Sevens
Seat 6: Ner4zzurri (small blind) folded on the Flop


PokerStars Game #102592844064:  Hold'em No Limit ($3/$6 USD) - 2013/08/11 1:24:05 ET
Table 'Klemola 40-100 bb' 6-max Seat #6 is the button
Seat 1: Kies123 ($172.30 in chips) 
Seat 2: mrienader ($622.28 in chips) 
Seat 3: HoldenUte03 ($268.50 in chips) 
Seat 4: Naebushkin ($600 in chips) 
Seat 5: king10clubs ($1116.95 in chips) 
Seat 6: Ner4zzurri ($600 in chips) 
Kies123: posts small blind $3
mrienader: posts big blind $6
*** HOLE CARDS ***
HoldenUte03: folds 
Naebushkin: folds 
king10clubs: folds 
Ner4zzurri: folds 
Kies123: folds 
Uncalled bet ($3) returned to mrienader
mrienader collected $6 from pot
mrienader: doesn't show hand 
*** SUMMARY ***
Total pot $6 | Rake $0 
Seat 1: Kies123 (small blind) folded before Flop
Seat 2: mrienader (big blind) collected ($6)
Seat 3: HoldenUte03 folded before Flop (didn't bet)
Seat 4: Naebushkin folded before Flop (didn't bet)
Seat 5: king10clubs folded before Flop (didn't bet)
Seat 6: Ner4zzurri (button) folded before Flop (didn't bet)


PokerStars Game #102592847994:  Hold'em No Limit ($3/$6 USD) - 2013/08/11 1:24:22 ET
Table 'Klemola 40-100 bb' 6-max Seat #1 is the button
Seat 1: Kies123 ($169.30 in chips) 
Seat 2: mrienader ($625.28 in chips) 
Seat 3: HoldenUte03 ($268.50 in chips) 
Seat 4: Naebushkin ($600 in chips) 
Seat 5: king10clubs ($1116.95 in chips) 
Seat 6: Ner4zzurri ($600 in chips) 
mrienader: posts small blind $3
HoldenUte03: posts big blind $6
*** HOLE CARDS ***
Naebushkin: folds 
king10clubs: folds 
Ner4zzurri: folds 
Kies123: raises $6 to $12
mrienader: folds 
HoldenUte03: calls $6
*** FLOP *** [8c Tc 5c]
HoldenUte03: checks 
Kies123: checks 
*** TURN *** [8c Tc 5c] [4s]
HoldenUte03: bets $24
Kies123: folds 
Uncalled bet ($24) returned to HoldenUte03
HoldenUte03 collected $25.78 from pot
*** SUMMARY ***
Total pot $27 | Rake $1.22 
Board [8c Tc 5c 4s]
Seat 1: Kies123 (button) folded on the Turn
Seat 2: mrienader (small blind) folded before Flop
Seat 3: HoldenUte03 (big blind) collected ($25.78)
Seat 4: Naebushkin folded before Flop (didn't bet)
Seat 5: king10clubs folded before Flop (didn't bet)
Seat 6: Ner4zzurri folded before Flop (didn't bet)


PokerStars Game #102593069458:  Hold'em No Limit ($3/$6 USD) - 2013/08/11 1:40:13 ET
Table 'Klemola 40-100 bb' 6-max Seat #5 is the button
Seat 1: mustanggino ($490.50 in chips) 
Seat 3: HoldenUte03 ($253.80 in chips) 
Seat 4: Naebushkin ($1323.60 in chips) 
Seat 5: king10clubs ($679.17 in chips) 
Shad2y`wow will be allowed to play after the button
mustanggino: posts small blind $3
HoldenUte03: posts big blind $6
*** HOLE CARDS ***
Naebushkin: folds 
king10clubs: folds 
mustanggino: raises $6 to $12
HoldenUte03: folds 
Uncalled bet ($6) returned to mustanggino
mustanggino collected $12 from pot
mustanggino: doesn't show hand 
*** SUMMARY ***
Total pot $12 | Rake $0 
Seat 1: mustanggino (small blind) collected ($12)
Seat 3: HoldenUte03 (big blind) folded before Flop
Seat 4: Naebushkin folded before Flop (didn't bet)
Seat 5: king10clubs (button) folded before Flop (didn't bet)


PokerStars Game #102593073309:  Hold'em No Limit ($3/$6 USD) - 2013/08/11 1:40:30 ET
Table 'Klemola 40-100 bb' 6-max Seat #1 is the button
Seat 1: mustanggino ($496.50 in chips) 
Seat 3: HoldenUte03 ($247.80 in chips) 
Seat 4: Naebushkin ($1323.60 in chips) 
Seat 5: king10clubs ($679.17 in chips) 
HoldenUte03: posts small blind $3
Naebushkin: posts big blind $6
Shad2y`wow: sits out 
*** HOLE CARDS ***
king10clubs: raises $9 to $15
mustanggino: folds 
HoldenUte03: folds 
Naebushkin: folds 
Uncalled bet ($9) returned to king10clubs
king10clubs collected $15 from pot
king10clubs: doesn't show hand 
*** SUMMARY ***
Total pot $15 | Rake $0 
Seat 1: mustanggino (button) folded before Flop (didn't bet)
Seat 3: HoldenUte03 (small blind) folded before Flop
Seat 4: Naebushkin (big blind) folded before Flop
Seat 5: king10clubs collected ($15)


PokerStars Game #102593077151:  Hold'em No Limit ($3/$6 USD) - 2013/08/11 1:40:46 ET
Table 'Klemola 40-100 bb' 6-max Seat #3 is the button
Seat 1: mustanggino ($496.50 in chips) 
Seat 3: HoldenUte03 ($244.80 in chips) 
Seat 4: Naebushkin ($1317.60 in chips) 
Seat 5: king10clubs ($688.17 in chips) 
Naebushkin: posts small blind $3
king10clubs: posts big blind $6
Shad2y`wow: sits out 
*** HOLE CARDS ***
mustanggino: folds 
HoldenUte03: folds 
Shad2y`wow leaves the table
Naebushkin: raises $9 to $15
king10clubs: calls $9
*** FLOP *** [6s 3s Ts]
Naebushkin: checks 
king10clubs: checks 
*** TURN *** [6s 3s Ts] [3c]
Naebushkin: checks 
king10clubs: checks 
*** RIVER *** [6s 3s Ts 3c] [7s]
Naebushkin: checks 
king10clubs: checks 
*** SHOW DOWN ***
Naebushkin: shows [Qh Ad] (a pair of Threes)
king10clubs: mucks hand 
Naebushkin collected $28.65 from pot
*** SUMMARY ***
Total pot $30 | Rake $1.35 
Board [6s 3s Ts 3c 7s]
Seat 1: mustanggino folded before Flop (didn't bet)
Seat 3: HoldenUte03 (button) folded before Flop (didn't bet)
Seat 4: Naebushkin (small blind) showed [Qh Ad] and won ($28.65) with a pair of Threes
Seat 5: king10clubs (big blind) mucked


PokerStars Game #102593092722:  Hold'em No Limit ($3/$6 USD) - 2013/08/11 1:41:54 ET
Table 'Klemola 40-100 bb' 6-max Seat #4 is the button
Seat 1: mustanggino ($496.50 in chips) 
Seat 3: HoldenUte03 ($244.80 in chips) 
Seat 4: Naebushkin ($1331.25 in chips) 
Seat 5: king10clubs ($673.17 in chips) 
king10clubs: posts small blind $3
mustanggino: posts big blind $6
*** HOLE CARDS ***
HoldenUte03: folds 
Naebushkin: raises $9 to $15
NutPopper joins the table at seat #6 
king10clubs: raises $38 to $53
mustanggino: raises $55 to $108
Naebushkin: folds 
king10clubs: calls $55
*** FLOP *** [3d 4d Qh]
king10clubs: bets $565.17 and is all-in
mustanggino: folds 
Uncalled bet ($565.17) returned to king10clubs
king10clubs collected $229.50 from pot
king10clubs: doesn't show hand 
*** SUMMARY ***
Total pot $231 | Rake $1.50 
Board [3d 4d Qh]
Seat 1: mustanggino (big blind) folded on the Flop
Seat 3: HoldenUte03 folded before Flop (didn't bet)
Seat 4: Naebushkin (button) folded before Flop
Seat 5: king10clubs (small blind) collected ($229.50)


PokerStars Game #102593111506:  Hold'em No Limit ($3/$6 USD) - 2013/08/11 1:43:14 ET
Table 'Klemola 40-100 bb' 6-max Seat #5 is the button
Seat 1: mustanggino ($450 in chips) 
Seat 3: HoldenUte03 ($244.80 in chips) 
Seat 4: Naebushkin ($1316.25 in chips) 
Seat 5: king10clubs ($794.67 in chips) 
NutPopper will be allowed to play after the button
mustanggino: posts small blind $3
HoldenUte03: posts big blind $6
*** HOLE CARDS ***
Naebushkin: folds 
king10clubs: raises $6 to $12
mustanggino: folds 
HoldenUte03: calls $6
*** FLOP *** [5s Qh 9s]
HoldenUte03: checks 
king10clubs: bets $18
HoldenUte03: calls $18
*** TURN *** [5s Qh 9s] [4c]
HoldenUte03: checks 
king10clubs: checks 
*** RIVER *** [5s Qh 9s 4c] [7s]
HoldenUte03: bets $30
king10clubs: folds 
Uncalled bet ($30) returned to HoldenUte03
HoldenUte03 collected $61.50 from pot
*** SUMMARY ***
Total pot $63 | Rake $1.50 
Board [5s Qh 9s 4c 7s]
Seat 1: mustanggino (small blind) folded before Flop
Seat 3: HoldenUte03 (big blind) collected ($61.50)
Seat 4: Naebushkin folded before Flop (didn't bet)
Seat 5: king10clubs (button) folded on the River


PokerStars Game #102593126226:  Hold'em No Limit ($3/$6 USD) - 2013/08/11 1:44:17 ET
Table 'Klemola 40-100 bb' 6-max Seat #1 is the button
Seat 1: mustanggino ($450 in chips) 
Seat 3: HoldenUte03 ($276.30 in chips) 
Seat 4: Naebushkin ($1316.25 in chips) 
Seat 5: king10clubs ($764.67 in chips) 
HoldenUte03: posts small blind $3
Naebushkin: posts big blind $6
NutPopper: sits out 
*** HOLE CARDS ***
king10clubs: folds 
mustanggino: raises $6 to $12
HoldenUte03: calls $9
Naebushkin: folds 
*** FLOP *** [6h Jh 4c]
HoldenUte03: checks 
mustanggino: checks 
*** TURN *** [6h Jh 4c] [Jc]
HoldenUte03: checks 
mustanggino: checks 
*** RIVER *** [6h Jh 4c Jc] [4d]
HoldenUte03: bets $30
mustanggino: calls $30
*** SHOW DOWN ***
HoldenUte03: shows [Js Kd] (a full house, Jacks full of Fours)
mustanggino: mucks hand 
HoldenUte03 collected $88.50 from pot
*** SUMMARY ***
Total pot $90 | Rake $1.50 
Board [6h Jh 4c Jc 4d]
Seat 1: mustanggino (button) mucked
Seat 3: HoldenUte03 (small blind) showed [Js Kd] and won ($88.50) with a full house, Jacks full of Fours
Seat 4: Naebushkin (big blind) folded before Flop
Seat 5: king10clubs folded before Flop (didn't bet)


PokerStars Game #102593002548:  Hold'em No Limit ($3/$6 USD) - 2013/08/11 1:35:22 ET
Table 'Klemola 40-100 bb' 6-max Seat #1 is the button
Seat 1: mustanggino ($450 in chips) 
Seat 3: HoldenUte03 ($289.80 in chips) 
Seat 4: Naebushkin ($663.20 in chips) 
Seat 5: king10clubs ($1318.17 in chips) 
Seat 6: Ner4zzurri ($600 in chips) 
HoldenUte03: posts small blind $3
Naebushkin: posts big blind $6
*** HOLE CARDS ***
king10clubs: raises $9 to $15
Ner4zzurri: folds 
mustanggino: folds 
HoldenUte03 is disconnected 
HoldenUte03 is connected 
HoldenUte03: folds 
Naebushkin: raises $36 to $51
king10clubs: calls $36
*** FLOP *** [5s 6h 2c]
Naebushkin: bets $60
king10clubs: calls $60
*** TURN *** [5s 6h 2c] [Ac]
Naebushkin: bets $141
king10clubs: calls $141
*** RIVER *** [5s 6h 2c Ac] [8h]
Naebushkin: bets $411.20 and is all-in
king10clubs: calls $411.20
*** SHOW DOWN ***
Naebushkin: shows [Ad As] (three of a kind, Aces)
king10clubs: shows [2d 2h] (three of a kind, Deuces)
Naebushkin collected $1326.60 from pot
*** SUMMARY ***
Total pot $1329.40 | Rake $2.80 
Board [5s 6h 2c Ac 8h]
Seat 1: mustanggino (button) folded before Flop (didn't bet)
Seat 3: HoldenUte03 (small blind) folded before Flop
Seat 4: Naebushkin (big blind) showed [Ad As] and won ($1326.60) with three of a kind, Aces
Seat 5: king10clubs showed [2d 2h] and lost with three of a kind, Deuces
Seat 6: Ner4zzurri folded before Flop (didn't bet)


PokerStars Game #102593037049:  Hold'em No Limit ($3/$6 USD) - 2013/08/11 1:37:52 ET
Table 'Klemola 40-100 bb' 6-max Seat #3 is the button
Seat 1: mustanggino ($450 in chips) 
Seat 3: HoldenUte03 ($286.80 in chips) 
Seat 4: Naebushkin ($1326.60 in chips) 
Seat 5: king10clubs ($654.97 in chips) 
Seat 6: Ner4zzurri ($600 in chips) 
Naebushkin: posts small blind $3
king10clubs: posts big blind $6
*** HOLE CARDS ***
Ner4zzurri: folds 
mustanggino: raises $6 to $12
HoldenUte03: calls $12
Naebushkin: folds 
king10clubs: calls $6
*** FLOP *** [9h 8c 8s]
king10clubs: checks 
mustanggino: bets $21
HoldenUte03: calls $21
king10clubs: raises $45 to $66
mustanggino: folds 
HoldenUte03: folds 
Uncalled bet ($45) returned to king10clubs
king10clubs collected $99.20 from pot
king10clubs: doesn't show hand 
*** SUMMARY ***
Total pot $102 | Rake $2.80 
Board [9h 8c 8s]
Seat 1: mustanggino folded on the Flop
Seat 3: HoldenUte03 (button) folded on the Flop
Seat 4: Naebushkin (small blind) folded before Flop
Seat 5: king10clubs (big blind) collected ($99.20)
Seat 6: Ner4zzurri folded before Flop (didn't bet)


PokerStars Game #102593052449:  Hold'em No Limit ($3/$6 USD) - 2013/08/11 1:38:59 ET
Table 'Klemola 40-100 bb' 6-max Seat #4 is the button
Seat 1: mustanggino ($450 in chips) 
Seat 3: HoldenUte03 ($253.80 in chips) 
Seat 4: Naebushkin ($1323.60 in chips) 
Seat 5: king10clubs ($721.17 in chips) 
king10clubs: posts small blind $3
Ner4zzurri: is sitting out 
mustanggino: posts big blind $6
*** HOLE CARDS ***
HoldenUte03: folds 
Ner4zzurri leaves the table
Naebushkin: folds 
king10clubs: raises $6 to $12
Shad2y`wow joins the table at seat #6 
mustanggino: raises $30 to $42
king10clubs: calls $30
*** FLOP *** [Qs Tc 8d]
king10clubs: checks 
mustanggino: bets $60
king10clubs: folds 
Uncalled bet ($60) returned to mustanggino
mustanggino collected $82.50 from pot
mustanggino: doesn't show hand 
*** SUMMARY ***
Total pot $84 | Rake $1.50 
Board [Qs Tc 8d]
Seat 1: mustanggino (big blind) collected ($82.50)
Seat 3: HoldenUte03 folded before Flop (didn't bet)
Seat 4: Naebushkin (button) folded before Flop (didn't bet)
Seat 5: king10clubs (small blind) folded on the Flop


PokerStars Game #102593206592:  Hold'em No Limit ($3/$6 USD) - 2013/08/11 1:50:06 ET
Table 'Klemola 40-100 bb' 6-max Seat #3 is the button
Seat 3: garougary ($158.50 in chips) 
Seat 5: king10clubs ($826.67 in chips) 
garougary: posts small blind $3
king10clubs: posts big blind $6
*** HOLE CARDS ***
garougary: raises $6 to $12
king10clubs: calls $6
*** FLOP *** [3c 8c As]
king10clubs: checks 
garougary: bets $12
king10clubs: folds 
Uncalled bet ($12) returned to garougary
garougary collected $23.50 from pot
garougary: doesn't show hand 
*** SUMMARY ***
Total pot $24 | Rake $0.50 
Board [3c 8c As]
Seat 3: garougary (button) (small blind) collected ($23.50)
Seat 5: king10clubs (big blind) folded on the Flop


PokerStars Game #102593211753:  Hold'em No Limit ($3/$6 USD) - 2013/08/11 1:50:29 ET
Table 'Klemola 40-100 bb' 6-max Seat #5 is the button
Seat 3: garougary ($170 in chips) 
Seat 5: king10clubs ($814.67 in chips) 
king10clubs: posts small blind $3
garougary: posts big blind $6
*** HOLE CARDS ***
king10clubs: raises $6 to $12
garougary: folds 
Uncalled bet ($6) returned to king10clubs
king10clubs collected $12 from pot
king10clubs: doesn't show hand 
*** SUMMARY ***
Total pot $12 | Rake $0 
Seat 3: garougary (big blind) folded before Flop
Seat 5: king10clubs (button) (small blind) collected ($12)


PokerStars Game #102593215084:  Hold'em No Limit ($3/$6 USD) - 2013/08/11 1:50:44 ET
Table 'Klemola 40-100 bb' 6-max Seat #3 is the button
Seat 3: garougary ($164 in chips) 
Seat 5: king10clubs ($820.67 in chips) 
garougary: posts small blind $3
king10clubs: posts big blind $6
*** HOLE CARDS ***
garougary: raises $12 to $18
king10clubs: folds 
Uncalled bet ($12) returned to garougary
garougary collected $12 from pot
garougary: doesn't show hand 
*** SUMMARY ***
Total pot $12 | Rake $0 
Seat 3: garougary (button) (small blind) collected ($12)
Seat 5: king10clubs (big blind) folded before Flop


PokerStars Game #102593216901:  Hold'em No Limit ($3/$6 USD) - 2013/08/11 1:50:52 ET
Table 'Klemola 40-100 bb' 6-max Seat #5 is the button
Seat 3: garougary ($170 in chips) 
Seat 5: king10clubs ($814.67 in chips) 
king10clubs: posts small blind $3
garougary: posts big blind $6
*** HOLE CARDS ***
king10clubs: raises $6 to $12
garougary: folds 
Uncalled bet ($6) returned to king10clubs
king10clubs collected $12 from pot
king10clubs: doesn't show hand 
*** SUMMARY ***
Total pot $12 | Rake $0 
Seat 3: garougary (big blind) folded before Flop
Seat 5: king10clubs (button) (small blind) collected ($12)


PokerStars Game #102593218876:  Hold'em No Limit ($3/$6 USD) - 2013/08/11 1:51:00 ET
Table 'Klemola 40-100 bb' 6-max Seat #3 is the button
Seat 3: garougary ($164 in chips) 
Seat 5: king10clubs ($820.67 in chips) 
garougary: posts small blind $3
king10clubs: posts big blind $6
*** HOLE CARDS ***
garougary: raises $6 to $12
king10clubs: folds 
Uncalled bet ($6) returned to garougary
garougary collected $12 from pot
garougary: doesn't show hand 
*** SUMMARY ***
Total pot $12 | Rake $0 
Seat 3: garougary (button) (small blind) collected ($12)
Seat 5: king10clubs (big blind) folded before Flop


PokerStars Game #102593220872:  Hold'em No Limit ($3/$6 USD) - 2013/08/11 1:51:09 ET
Table 'Klemola 40-100 bb' 6-max Seat #5 is the button
Seat 3: garougary ($170 in chips) 
Seat 5: king10clubs ($814.67 in chips) 
king10clubs: posts small blind $3
garougary: posts big blind $6
*** HOLE CARDS ***
king10clubs: raises $6 to $12
garougary: folds 
Uncalled bet ($6) returned to king10clubs
king10clubs collected $12 from pot
king10clubs: doesn't show hand 
*** SUMMARY ***
Total pot $12 | Rake $0 
Seat 3: garougary (big blind) folded before Flop
Seat 5: king10clubs (button) (small blind) collected ($12)


PokerStars Game #102593222970:  Hold'em No Limit ($3/$6 USD) - 2013/08/11 1:51:18 ET
Table 'Klemola 40-100 bb' 6-max Seat #3 is the button
Seat 3: garougary ($164 in chips) 
Seat 5: king10clubs ($820.67 in chips) 
garougary: posts small blind $3
king10clubs: posts big blind $6
*** HOLE CARDS ***
garougary: folds 
Uncalled bet ($3) returned to king10clubs
king10clubs collected $6 from pot
king10clubs: doesn't show hand 
*** SUMMARY ***
Total pot $6 | Rake $0 
Seat 3: garougary (button) (small blind) folded before Flop
Seat 5: king10clubs (big blind) collected ($6)


PokerStars Game #102593224272:  Hold'em No Limit ($3/$6 USD) - 2013/08/11 1:51:24 ET
Table 'Klemola 40-100 bb' 6-max Seat #5 is the button
Seat 3: garougary ($161 in chips) 
Seat 5: king10clubs ($823.67 in chips) 
king10clubs: posts small blind $3
garougary: posts big blind $6
*** HOLE CARDS ***
king10clubs: raises $6 to $12
garougary: calls $6
*** FLOP *** [6c Kc 8h]
garougary: checks 
king10clubs: checks 
*** TURN *** [6c Kc 8h] [Th]
garougary: checks 
king10clubs: checks 
*** RIVER *** [6c Kc 8h Th] [9d]
garougary: bets $12
king10clubs: folds 
Uncalled bet ($12) returned to garougary
garougary collected $23.50 from pot
garougary: doesn't show hand 
*** SUMMARY ***
Total pot $24 | Rake $0.50 
Board [6c Kc 8h Th 9d]
Seat 3: garougary (big blind) collected ($23.50)
Seat 5: king10clubs (button) (small blind) folded on the River


PokerStars Game #102593232860:  Hold'em No Limit ($3/$6 USD) - 2013/08/11 1:52:01 ET
Table 'Klemola 40-100 bb' 6-max Seat #3 is the button
Seat 3: garougary ($172.50 in chips) 
Seat 5: king10clubs ($811.67 in chips) 
garougary: posts small blind $3
king10clubs: posts big blind $6
*** HOLE CARDS ***
garougary: raises $6 to $12
king10clubs: calls $6
*** FLOP *** [7s 5c 6h]
king10clubs: checks 
garougary: checks 
*** TURN *** [7s 5c 6h] [Kh]
king10clubs: checks 
garougary: checks 
*** RIVER *** [7s 5c 6h Kh] [8d]
king10clubs: checks 
garougary: bets $12
king10clubs: folds 
Uncalled bet ($12) returned to garougary
garougary collected $23.50 from pot
garougary: doesn't show hand 
*** SUMMARY ***
Total pot $24 | Rake $0.50 
Board [7s 5c 6h Kh 8d]
Seat 3: garougary (button) (small blind) collected ($23.50)
Seat 5: king10clubs (big blind) folded on the River


PokerStars Game #102593242344:  Hold'em No Limit ($3/$6 USD) - 2013/08/11 1:52:41 ET
Table 'Klemola 40-100 bb' 6-max Seat #5 is the button
Seat 3: garougary ($184 in chips) 
Seat 5: king10clubs ($799.67 in chips) 
king10clubs: posts small blind $3
garougary: posts big blind $6
*** HOLE CARDS ***
king10clubs: raises $6 to $12
garougary: folds 
Uncalled bet ($6) returned to king10clubs
king10clubs collected $12 from pot
king10clubs: doesn't show hand 
*** SUMMARY ***
Total pot $12 | Rake $0 
Seat 3: garougary (big blind) folded before Flop
Seat 5: king10clubs (button) (small blind) collected ($12)


PokerStars Game #102593244297:  Hold'em No Limit ($3/$6 USD) - 2013/08/11 1:52:50 ET
Table 'Klemola 40-100 bb' 6-max Seat #3 is the button
Seat 3: garougary ($178 in chips) 
Seat 5: king10clubs ($805.67 in chips) 
garougary: posts small blind $3
king10clubs: posts big blind $6
*** HOLE CARDS ***
garougary: raises $6 to $12
king10clubs: calls $6
*** FLOP *** [5h 3h 6s]
king10clubs: bets $17
garougary: calls $17
*** TURN *** [5h 3h 6s] [Ts]
king10clubs: bets $40
garougary: folds 
Uncalled bet ($40) returned to king10clubs
king10clubs collected $57.50 from pot
king10clubs: doesn't show hand 
*** SUMMARY ***
Total pot $58 | Rake $0.50 
Board [5h 3h 6s Ts]
Seat 3: garougary (button) (small blind) folded on the Turn
Seat 5: king10clubs (big blind) collected ($57.50)


PokerStars Game #102593250205:  Hold'em No Limit ($3/$6 USD) - 2013/08/11 1:53:15 ET
Table 'Klemola 40-100 bb' 6-max Seat #5 is the button
Seat 3: garougary ($149 in chips) 
Seat 5: king10clubs ($834.17 in chips) 
king10clubs: posts small blind $3
garougary: posts big blind $6
*** HOLE CARDS ***
king10clubs: raises $6 to $12
garougary: folds 
Uncalled bet ($6) returned to king10clubs
king10clubs collected $12 from pot
king10clubs: doesn't show hand 
*** SUMMARY ***
Total pot $12 | Rake $0 
Seat 3: garougary (big blind) folded before Flop
Seat 5: king10clubs (button) (small blind) collected ($12)


PokerStars Game #102593251969:  Hold'em No Limit ($3/$6 USD) - 2013/08/11 1:53:23 ET
Table 'Klemola 40-100 bb' 6-max Seat #3 is the button
Seat 3: garougary ($143 in chips) 
Seat 5: king10clubs ($840.17 in chips) 
garougary: posts small blind $3
king10clubs: posts big blind $6
*** HOLE CARDS ***
garougary: raises $6 to $12
king10clubs: folds 
Uncalled bet ($6) returned to garougary
garougary collected $12 from pot
garougary: doesn't show hand 
*** SUMMARY ***
Total pot $12 | Rake $0 
Seat 3: garougary (button) (small blind) collected ($12)
Seat 5: king10clubs (big blind) folded before Flop


PokerStars Game #102593254006:  Hold'em No Limit ($3/$6 USD) - 2013/08/11 1:53:31 ET
Table 'Klemola 40-100 bb' 6-max Seat #5 is the button
Seat 3: garougary ($149 in chips) 
Seat 5: king10clubs ($834.17 in chips) 
king10clubs: posts small blind $3
garougary: posts big blind $6
*** HOLE CARDS ***
king10clubs: raises $6 to $12
garougary: raises $6 to $18
king10clubs: calls $6
*** FLOP *** [Ah Ts Ad]
garougary: bets $18
king10clubs: calls $18
*** TURN *** [Ah Ts Ad] [4h]
garougary: checks 
king10clubs: checks 
*** RIVER *** [Ah Ts Ad 4h] [Ac]
garougary: checks 
king10clubs: checks 
*** SHOW DOWN ***
garougary: shows [9d 7d] (three of a kind, Aces)
king10clubs: shows [5h Th] (a full house, Aces full of Tens)
king10clubs collected $71.50 from pot
*** SUMMARY ***
Total pot $72 | Rake $0.50 
Board [Ah Ts Ad 4h Ac]
Seat 3: garougary (big blind) showed [9d 7d] and lost with three of a kind, Aces
Seat 5: king10clubs (button) (small blind) showed [5h Th] and won ($71.50) with a full house, Aces full of Tens


PokerStars Game #102593264454:  Hold'em No Limit ($3/$6 USD) - 2013/08/11 1:54:16 ET
Table 'Klemola 40-100 bb' 6-max Seat #3 is the button
Seat 3: garougary ($113 in chips) 
Seat 5: king10clubs ($869.67 in chips) 
garougary: posts small blind $3
king10clubs: posts big blind $6
*** HOLE CARDS ***
garougary: folds 
Uncalled bet ($3) returned to king10clubs
king10clubs collected $6 from pot
king10clubs: doesn't show hand 
*** SUMMARY ***
Total pot $6 | Rake $0 
Seat 3: garougary (button) (small blind) folded before Flop
Seat 5: king10clubs (big blind) collected ($6)


PokerStars Game #102593265798:  Hold'em No Limit ($3/$6 USD) - 2013/08/11 1:54:22 ET
Table 'Klemola 40-100 bb' 6-max Seat #5 is the button
Seat 3: garougary ($110 in chips) 
Seat 5: king10clubs ($872.67 in chips) 
king10clubs: posts small blind $3
garougary: posts big blind $6
*** HOLE CARDS ***
king10clubs: raises $6 to $12
garougary: folds 
Uncalled bet ($6) returned to king10clubs
king10clubs collected $12 from pot
king10clubs: doesn't show hand 
*** SUMMARY ***
Total pot $12 | Rake $0 
Seat 3: garougary (big blind) folded before Flop
Seat 5: king10clubs (button) (small blind) collected ($12)


PokerStars Game #102593267651:  Hold'em No Limit ($3/$6 USD) - 2013/08/11 1:54:30 ET
Table 'Klemola 40-100 bb' 6-max Seat #3 is the button
Seat 3: garougary ($104 in chips) 
Seat 5: king10clubs ($878.67 in chips) 
garougary: posts small blind $3
king10clubs: posts big blind $6
*** HOLE CARDS ***
garougary: raises $6 to $12
king10clubs: folds 
Uncalled bet ($6) returned to garougary
garougary collected $12 from pot
garougary: doesn't show hand 
*** SUMMARY ***
Total pot $12 | Rake $0 
Seat 3: garougary (button) (small blind) collected ($12)
Seat 5: king10clubs (big blind) folded before Flop


PokerStars Game #102593269164:  Hold'em No Limit ($3/$6 USD) - 2013/08/11 1:54:36 ET
Table 'Klemola 40-100 bb' 6-max Seat #5 is the button
Seat 3: garougary ($110 in chips) 
Seat 5: king10clubs ($872.67 in chips) 
king10clubs: posts small blind $3
garougary: posts big blind $6
*** HOLE CARDS ***
king10clubs: raises $6 to $12
garougary: calls $6
*** FLOP *** [Qd Kd 5c]
garougary: checks 
king10clubs: bets $15
garougary: folds 
Uncalled bet ($15) returned to king10clubs
king10clubs collected $23.50 from pot
king10clubs: doesn't show hand 
*** SUMMARY ***
Total pot $24 | Rake $0.50 
Board [Qd Kd 5c]
Seat 3: garougary (big blind) folded on the Flop
Seat 5: king10clubs (button) (small blind) collected ($23.50)


PokerStars Game #102593273375:  Hold'em No Limit ($3/$6 USD) - 2013/08/11 1:54:54 ET
Table 'Klemola 40-100 bb' 6-max Seat #3 is the button
Seat 3: garougary ($98 in chips) 
Seat 5: king10clubs ($884.17 in chips) 
garougary: posts small blind $3
king10clubs: posts big blind $6
*** HOLE CARDS ***
garougary: raises $6 to $12
king10clubs: calls $6
*** FLOP *** [Kd 2d 9d]
king10clubs: checks 
garougary: bets $12
king10clubs: calls $12
*** TURN *** [Kd 2d 9d] [Tc]
king10clubs: checks 
garougary: checks 
*** RIVER *** [Kd 2d 9d Tc] [4s]
king10clubs: checks 
garougary: bets $24
king10clubs: folds 
Uncalled bet ($24) returned to garougary
garougary collected $47.50 from pot
garougary: doesn't show hand 
*** SUMMARY ***
Total pot $48 | Rake $0.50 
Board [Kd 2d 9d Tc 4s]
Seat 3: garougary (button) (small blind) collected ($47.50)
Seat 5: king10clubs (big blind) folded on the River


PokerStars Game #102593139991:  Hold'em No Limit ($3/$6 USD) - 2013/08/11 1:45:17 ET
Table 'Klemola 40-100 bb' 6-max Seat #4 is the button
Seat 1: mustanggino ($450 in chips) 
Seat 4: Naebushkin ($1310.25 in chips) 
Seat 5: king10clubs ($764.67 in chips) 
Seat 6: NutPopper ($240 in chips) 
king10clubs: posts small blind $3
NutPopper: posts big blind $6
*** HOLE CARDS ***
HoldenUte03 leaves the table
mustanggino: raises $6 to $12
Naebushkin: folds 
king10clubs: folds 
NutPopper: folds 
Uncalled bet ($6) returned to mustanggino
mustanggino collected $15 from pot
mustanggino: doesn't show hand 
*** SUMMARY ***
Total pot $15 | Rake $0 
Seat 1: mustanggino collected ($15)
Seat 4: Naebushkin (button) folded before Flop (didn't bet)
Seat 5: king10clubs (small blind) folded before Flop
Seat 6: NutPopper (big blind) folded before Flop


PokerStars Game #102593143771:  Hold'em No Limit ($3/$6 USD) - 2013/08/11 1:45:33 ET
Table 'Klemola 40-100 bb' 6-max Seat #5 is the button
Seat 1: mustanggino ($459 in chips) 
Seat 4: Naebushkin ($1310.25 in chips) 
Seat 5: king10clubs ($761.67 in chips) 
Seat 6: NutPopper ($234 in chips) 
NutPopper: posts small blind $3
mustanggino: posts big blind $6
*** HOLE CARDS ***
Naebushkin: folds 
king10clubs: raises $6 to $12
NutPopper: folds 
mustanggino: folds 
Uncalled bet ($6) returned to king10clubs
king10clubs collected $15 from pot
king10clubs: doesn't show hand 
*** SUMMARY ***
Total pot $15 | Rake $0 
Seat 1: mustanggino (big blind) folded before Flop
Seat 4: Naebushkin folded before Flop (didn't bet)
Seat 5: king10clubs (button) collected ($15)
Seat 6: NutPopper (small blind) folded before Flop


PokerStars Game #102593149313:  Hold'em No Limit ($3/$6 USD) - 2013/08/11 1:45:57 ET
Table 'Klemola 40-100 bb' 6-max Seat #6 is the button
Seat 1: mustanggino ($453 in chips) 
Seat 5: king10clubs ($770.67 in chips) 
Seat 6: NutPopper ($231 in chips) 
mustanggino: posts small blind $3
Naebushkin: is sitting out 
king10clubs: posts big blind $6
*** HOLE CARDS ***
NutPopper: raises $6 to $12
Naebushkin leaves the table
mustanggino: folds 
king10clubs: calls $6
*** FLOP *** [5c 9s Qd]
king10clubs: checks 
NutPopper: bets $12
king10clubs: calls $12
*** TURN *** [5c 9s Qd] [2c]
mrienader leaves the table
king10clubs: checks 
garougary joins the table at seat #3 
NutPopper: bets $30
king10clubs: folds 
Uncalled bet ($30) returned to NutPopper
NutPopper collected $49.50 from pot
NutPopper: doesn't show hand 
*** SUMMARY ***
Total pot $51 | Rake $1.50 
Board [5c 9s Qd 2c]
Seat 1: mustanggino (small blind) folded before Flop
Seat 5: king10clubs (big blind) folded on the Turn
Seat 6: NutPopper (button) collected ($49.50)


PokerStars Game #102593167733:  Hold'em No Limit ($3/$6 USD) - 2013/08/11 1:47:17 ET
Table 'Klemola 40-100 bb' 6-max Seat #5 is the button
Seat 3: garougary ($240 in chips) 
Seat 5: king10clubs ($746.67 in chips) 
king10clubs: posts small blind $3
garougary: posts big blind $6
*** HOLE CARDS ***
king10clubs: raises $6 to $12
garougary: calls $6
*** FLOP *** [2d Jc Qh]
garougary: checks 
king10clubs: checks 
*** TURN *** [2d Jc Qh] [7d]
garougary: bets $12
king10clubs: calls $12
*** RIVER *** [2d Jc Qh 7d] [6c]
garougary: bets $24
king10clubs: raises $48 to $72
garougary: folds 
Uncalled bet ($48) returned to king10clubs
king10clubs collected $95.50 from pot
king10clubs: doesn't show hand 
*** SUMMARY ***
Total pot $96 | Rake $0.50 
Board [2d Jc Qh 7d 6c]
Seat 3: garougary (big blind) folded on the River
Seat 5: king10clubs (button) (small blind) collected ($95.50)


PokerStars Game #102593178838:  Hold'em No Limit ($3/$6 USD) - 2013/08/11 1:48:06 ET
Table 'Klemola 40-100 bb' 6-max Seat #3 is the button
Seat 3: garougary ($192 in chips) 
Seat 5: king10clubs ($794.17 in chips) 
garougary: posts small blind $3
king10clubs: posts big blind $6
*** HOLE CARDS ***
garougary: raises $6 to $12
king10clubs: folds 
Uncalled bet ($6) returned to garougary
garougary collected $12 from pot
garougary: doesn't show hand 
*** SUMMARY ***
Total pot $12 | Rake $0 
Seat 3: garougary (button) (small blind) collected ($12)
Seat 5: king10clubs (big blind) folded before Flop


PokerStars Game #102593181072:  Hold'em No Limit ($3/$6 USD) - 2013/08/11 1:48:16 ET
Table 'Klemola 40-100 bb' 6-max Seat #5 is the button
Seat 3: garougary ($198 in chips) 
Seat 5: king10clubs ($788.17 in chips) 
king10clubs: posts small blind $3
garougary: posts big blind $6
*** HOLE CARDS ***
king10clubs: raises $6 to $12
garougary: raises $12 to $24
king10clubs: calls $12
*** FLOP *** [9h 2c Td]
garougary: bets $24
king10clubs: calls $24
*** TURN *** [9h 2c Td] [Jh]
garougary: checks 
king10clubs: checks 
*** RIVER *** [9h 2c Td Jh] [5s]
garougary: checks 
king10clubs: checks 
*** SHOW DOWN ***
garougary: shows [3s Ac] (high card Ace)
king10clubs: shows [Ad 9s] (a pair of Nines)
king10clubs collected $95.50 from pot
*** SUMMARY ***
Total pot $96 | Rake $0.50 
Board [9h 2c Td Jh 5s]
Seat 3: garougary (big blind) showed [3s Ac] and lost with high card Ace
Seat 5: king10clubs (button) (small blind) showed [Ad 9s] and won ($95.50) with a pair of Nines


PokerStars Game #102593190657:  Hold'em No Limit ($3/$6 USD) - 2013/08/11 1:48:57 ET
Table 'Klemola 40-100 bb' 6-max Seat #3 is the button
Seat 3: garougary ($150 in chips) 
Seat 5: king10clubs ($835.67 in chips) 
garougary: posts small blind $3
king10clubs: posts big blind $6
*** HOLE CARDS ***
garougary: raises $6 to $12
king10clubs: folds 
Uncalled bet ($6) returned to garougary
garougary collected $12 from pot
garougary: doesn't show hand 
*** SUMMARY ***
Total pot $12 | Rake $0 
Seat 3: garougary (button) (small blind) collected ($12)
Seat 5: king10clubs (big blind) folded before Flop


PokerStars Game #102593192648:  Hold'em No Limit ($3/$6 USD) - 2013/08/11 1:49:06 ET
Table 'Klemola 40-100 bb' 6-max Seat #5 is the button
Seat 3: garougary ($156 in chips) 
Seat 5: king10clubs ($829.67 in chips) 
king10clubs: posts small blind $3
garougary: posts big blind $6
*** HOLE CARDS ***
king10clubs: raises $6 to $12
garougary: folds 
Uncalled bet ($6) returned to king10clubs
king10clubs collected $12 from pot
king10clubs: doesn't show hand 
*** SUMMARY ***
Total pot $12 | Rake $0 
Seat 3: garougary (big blind) folded before Flop
Seat 5: king10clubs (button) (small blind) collected ($12)


PokerStars Game #102593194593:  Hold'em No Limit ($3/$6 USD) - 2013/08/11 1:49:14 ET
Table 'Klemola 40-100 bb' 6-max Seat #3 is the button
Seat 3: garougary ($150 in chips) 
Seat 5: king10clubs ($835.67 in chips) 
garougary: posts small blind $3
king10clubs: posts big blind $6
*** HOLE CARDS ***
garougary: raises $6 to $12
king10clubs: folds 
Uncalled bet ($6) returned to garougary
garougary collected $12 from pot
garougary: doesn't show hand 
*** SUMMARY ***
Total pot $12 | Rake $0 
Seat 3: garougary (button) (small blind) collected ($12)
Seat 5: king10clubs (big blind) folded before Flop


PokerStars Game #102593196206:  Hold'em No Limit ($3/$6 USD) - 2013/08/11 1:49:21 ET
Table 'Klemola 40-100 bb' 6-max Seat #5 is the button
Seat 3: garougary ($156 in chips) 
Seat 5: king10clubs ($829.67 in chips) 
king10clubs: posts small blind $3
garougary: posts big blind $6
*** HOLE CARDS ***
king10clubs: raises $6 to $12
garougary: folds 
Uncalled bet ($6) returned to king10clubs
king10clubs collected $12 from pot
king10clubs: doesn't show hand 
*** SUMMARY ***
Total pot $12 | Rake $0 
Seat 3: garougary (big blind) folded before Flop
Seat 5: king10clubs (button) (small blind) collected ($12)


PokerStars Game #102593198153:  Hold'em No Limit ($3/$6 USD) - 2013/08/11 1:49:30 ET
Table 'Klemola 40-100 bb' 6-max Seat #3 is the button
Seat 3: garougary ($150 in chips) 
Seat 5: king10clubs ($835.67 in chips) 
garougary: posts small blind $3
king10clubs: posts big blind $6
*** HOLE CARDS ***
garougary: folds 
Uncalled bet ($3) returned to king10clubs
king10clubs collected $6 from pot
king10clubs: doesn't show hand 
*** SUMMARY ***
Total pot $6 | Rake $0 
Seat 3: garougary (button) (small blind) folded before Flop
Seat 5: king10clubs (big blind) collected ($6)


PokerStars Game #102593199340:  Hold'em No Limit ($3/$6 USD) - 2013/08/11 1:49:35 ET
Table 'Klemola 40-100 bb' 6-max Seat #5 is the button
Seat 3: garougary ($147 in chips) 
Seat 5: king10clubs ($838.67 in chips) 
king10clubs: posts small blind $3
garougary: posts big blind $6
*** HOLE CARDS ***
king10clubs: raises $6 to $12
garougary: calls $6
*** FLOP *** [Tc 8d Qh]
garougary: checks 
king10clubs: checks 
*** TURN *** [Tc 8d Qh] [3c]
garougary: checks 
king10clubs: checks 
*** RIVER *** [Tc 8d Qh 3c] [6s]
garougary: bets $24
king10clubs: folds 
Uncalled bet ($24) returned to garougary
garougary collected $23.50 from pot
garougary: doesn't show hand 
*** SUMMARY ***
Total pot $24 | Rake $0.50 
Board [Tc 8d Qh 3c 6s]
Seat 3: garougary (big blind) collected ($23.50)
Seat 5: king10clubs (button) (small blind) folded on the River


PokerStars Game #102593408519:  Hold'em No Limit ($3/$6 USD) - 2013/08/11 2:05:46 ET
Table 'Klemola 40-100 bb' 6-max Seat #6 is the button
Seat 1: rusdronenv ($744.20 in chips) 
Seat 2: Taimuraz63 ($480 in chips) 
Seat 3: garougary ($101.26 in chips) 
Seat 4: onez69 ($301.39 in chips) 
Seat 5: king10clubs ($721.17 in chips) 
Seat 6: mustanggino ($450 in chips) 
rusdronenv: posts small blind $3
Taimuraz63: posts big blind $6
*** HOLE CARDS ***
garougary: folds 
onez69: raises $9 to $15
king10clubs: folds 
mustanggino: folds 
rusdronenv: folds 
Taimuraz63: calls $9
*** FLOP *** [Kd 4h 4d]
Taimuraz63: checks 
onez69: bets $15
Taimuraz63: folds 
Uncalled bet ($15) returned to onez69
onez69 collected $31.52 from pot
onez69: doesn't show hand 
*** SUMMARY ***
Total pot $33 | Rake $1.48 
Board [Kd 4h 4d]
Seat 1: rusdronenv (small blind) folded before Flop
Seat 2: Taimuraz63 (big blind) folded on the Flop
Seat 3: garougary folded before Flop (didn't bet)
Seat 4: onez69 collected ($31.52)
Seat 5: king10clubs folded before Flop (didn't bet)
Seat 6: mustanggino (button) folded before Flop (didn't bet)


PokerStars Game #102593417646:  Hold'em No Limit ($3/$6 USD) - 2013/08/11 2:06:25 ET
Table 'Klemola 40-100 bb' 6-max Seat #1 is the button
Seat 1: rusdronenv ($741.20 in chips) 
Seat 2: Taimuraz63 ($465 in chips) 
Seat 3: garougary ($101.26 in chips) 
Seat 4: onez69 ($317.91 in chips) 
Seat 5: king10clubs ($721.17 in chips) 
Seat 6: mustanggino ($450 in chips) 
Taimuraz63: posts small blind $3
garougary: posts big blind $6
*** HOLE CARDS ***
onez69: raises $6 to $12
king10clubs: folds 
mustanggino: folds 
rusdronenv: folds 
Taimuraz63: calls $9
garougary: folds 
*** FLOP *** [6h 4h 3c]
Taimuraz63: checks 
onez69: checks 
*** TURN *** [6h 4h 3c] [8d]
Taimuraz63: bets $12
onez69: calls $12
*** RIVER *** [6h 4h 3c 8d] [Qd]
Taimuraz63: bets $12
onez69: raises $36 to $48
Taimuraz63: calls $36
*** SHOW DOWN ***
onez69: shows [Ts Ac] (high card Ace)
Taimuraz63: shows [Qs 9s] (a pair of Queens)
Taimuraz63 collected $147.20 from pot
*** SUMMARY ***
Total pot $150 | Rake $2.80 
Board [6h 4h 3c 8d Qd]
Seat 1: rusdronenv (button) folded before Flop (didn't bet)
Seat 2: Taimuraz63 (small blind) showed [Qs 9s] and won ($147.20) with a pair of Queens
Seat 3: garougary (big blind) folded before Flop
Seat 4: onez69 showed [Ts Ac] and lost with high card Ace
Seat 5: king10clubs folded before Flop (didn't bet)
Seat 6: mustanggino folded before Flop (didn't bet)


PokerStars Game #102593431810:  Hold'em No Limit ($3/$6 USD) - 2013/08/11 2:07:24 ET
Table 'Klemola 40-100 bb' 6-max Seat #2 is the button
Seat 1: rusdronenv ($741.20 in chips) 
Seat 2: Taimuraz63 ($540.20 in chips) 
Seat 3: garougary ($95.26 in chips) 
Seat 4: onez69 ($245.91 in chips) 
Seat 5: king10clubs ($721.17 in chips) 
Seat 6: mustanggino ($450 in chips) 
garougary: posts small blind $3
onez69: posts big blind $6
*** HOLE CARDS ***
king10clubs: folds 
mustanggino: folds 
rusdronenv: raises $12 to $18
Taimuraz63: calls $18
garougary: calls $15
onez69: folds 
*** FLOP *** [2d 7h Kh]
garougary: checks 
rusdronenv: checks 
Taimuraz63: bets $18
garougary: folds 
rusdronenv: folds 
Uncalled bet ($18) returned to Taimuraz63
Taimuraz63 collected $57.30 from pot
*** SUMMARY ***
Total pot $60 | Rake $2.70 
Board [2d 7h Kh]
Seat 1: rusdronenv folded on the Flop
Seat 2: Taimuraz63 (button) collected ($57.30)
Seat 3: garougary (small blind) folded on the Flop
Seat 4: onez69 (big blind) folded before Flop
Seat 5: king10clubs folded before Flop (didn't bet)
Seat 6: mustanggino folded before Flop (didn't bet)


PokerStars Game #102593442302:  Hold'em No Limit ($3/$6 USD) - 2013/08/11 2:08:09 ET
Table 'Klemola 40-100 bb' 6-max Seat #3 is the button
Seat 1: rusdronenv ($723.20 in chips) 
Seat 2: Taimuraz63 ($579.50 in chips) 
Seat 3: garougary ($77.26 in chips) 
Seat 4: onez69 ($239.91 in chips) 
Seat 5: king10clubs ($721.17 in chips) 
Seat 6: mustanggino ($450 in chips) 
onez69: posts small blind $3
king10clubs: posts big blind $6
*** HOLE CARDS ***
mustanggino: folds 
rusdronenv: folds 
Taimuraz63: folds 
garougary: raises $6 to $12
onez69: calls $9
king10clubs: calls $6
*** FLOP *** [Ac 5s Kh]
onez69: checks 
king10clubs: checks 
garougary: bets $6
onez69: calls $6
king10clubs: calls $6
*** TURN *** [Ac 5s Kh] [Ah]
onez69: checks 
king10clubs: checks 
garougary: checks 
*** RIVER *** [Ac 5s Kh Ah] [3c]
onez69: checks 
king10clubs: checks 
garougary: bets $59.26 and is all-in
onez69: folds 
king10clubs: folds 
Uncalled bet ($59.26) returned to garougary
garougary collected $51.57 from pot
garougary: doesn't show hand 
*** SUMMARY ***
Total pot $54 | Rake $2.43 
Board [Ac 5s Kh Ah 3c]
Seat 1: rusdronenv folded before Flop (didn't bet)
Seat 2: Taimuraz63 folded before Flop (didn't bet)
Seat 3: garougary (button) collected ($51.57)
Seat 4: onez69 (small blind) folded on the River
Seat 5: king10clubs (big blind) folded on the River
Seat 6: mustanggino folded before Flop (didn't bet)


PokerStars Game #102593460903:  Hold'em No Limit ($3/$6 USD) - 2013/08/11 2:09:28 ET
Table 'Klemola 40-100 bb' 6-max Seat #4 is the button
Seat 1: rusdronenv ($723.20 in chips) 
Seat 2: Taimuraz63 ($579.50 in chips) 
Seat 3: garougary ($110.83 in chips) 
Seat 4: onez69 ($221.91 in chips) 
Seat 5: king10clubs ($703.17 in chips) 
king10clubs: posts small blind $3
mustanggino: is sitting out 
rusdronenv: posts big blind $6
*** HOLE CARDS ***
Taimuraz63: raises $6 to $12
garougary: folds 
onez69: folds 
king10clubs: folds 
rusdronenv: folds 
Uncalled bet ($6) returned to Taimuraz63
Taimuraz63 collected $15 from pot
*** SUMMARY ***
Total pot $15 | Rake $0 
Seat 1: rusdronenv (big blind) folded before Flop
Seat 2: Taimuraz63 collected ($15)
Seat 3: garougary folded before Flop (didn't bet)
Seat 4: onez69 (button) folded before Flop (didn't bet)
Seat 5: king10clubs (small blind) folded before Flop


PokerStars Game #102593464571:  Hold'em No Limit ($3/$6 USD) - 2013/08/11 2:09:44 ET
Table 'Klemola 40-100 bb' 6-max Seat #5 is the button
Seat 1: rusdronenv ($717.20 in chips) 
Seat 2: Taimuraz63 ($588.50 in chips) 
Seat 3: garougary ($110.83 in chips) 
Seat 4: onez69 ($221.91 in chips) 
Seat 5: king10clubs ($700.17 in chips) 
rusdronenv: posts small blind $3
Taimuraz63: posts big blind $6
*** HOLE CARDS ***
garougary: raises $6 to $12
onez69: folds 
king10clubs: folds 
rusdronenv: folds 
Taimuraz63: calls $6
*** FLOP *** [9d Td 3s]
Taimuraz63: checks 
garougary: bets $12
Taimuraz63: folds 
Uncalled bet ($12) returned to garougary
garougary collected $25.78 from pot
garougary: doesn't show hand 
*** SUMMARY ***
Total pot $27 | Rake $1.22 
Board [9d Td 3s]
Seat 1: rusdronenv (small blind) folded before Flop
Seat 2: Taimuraz63 (big blind) folded on the Flop
Seat 3: garougary collected ($25.78)
Seat 4: onez69 folded before Flop (didn't bet)
Seat 5: king10clubs (button) folded before Flop (didn't bet)


PokerStars Game #102593306245:  Hold'em No Limit ($3/$6 USD) - 2013/08/11 1:57:43 ET
Table 'Klemola 40-100 bb' 6-max Seat #3 is the button
Seat 1: rusdronenv ($600 in chips) 
Seat 3: garougary ($70 in chips) 
Seat 5: king10clubs ($910.17 in chips) 
king10clubs: posts small blind $3
rusdronenv: posts big blind $6
*** HOLE CARDS ***
garougary: folds 
king10clubs: raises $9 to $15
rusdronenv: folds 
Uncalled bet ($9) returned to king10clubs
king10clubs collected $12 from pot
king10clubs: doesn't show hand 
*** SUMMARY ***
Total pot $12 | Rake $0 
Seat 1: rusdronenv (big blind) folded before Flop
Seat 3: garougary (button) folded before Flop (didn't bet)
Seat 5: king10clubs (small blind) collected ($12)


PokerStars Game #102593310211:  Hold'em No Limit ($3/$6 USD) - 2013/08/11 1:58:05 ET
Table 'Klemola 40-100 bb' 6-max Seat #5 is the button
Seat 1: rusdronenv ($600 in chips) 
Seat 3: garougary ($70 in chips) 
Seat 5: king10clubs ($916.17 in chips) 
rusdronenv: posts small blind $3
garougary: posts big blind $6
*** HOLE CARDS ***
king10clubs: raises $6 to $12
rusdronenv: folds 
garougary: calls $6
*** FLOP *** [9s Tc 7c]
garougary: checks 
king10clubs: checks 
*** TURN *** [9s Tc 7c] [3d]
garougary: checks 
king10clubs: checks 
*** RIVER *** [9s Tc 7c 3d] [Th]
garougary: checks 
king10clubs: checks 
*** SHOW DOWN ***
garougary: shows [7s 5s] (two pair, Tens and Sevens)
king10clubs: mucks hand 
garougary collected $25.78 from pot
*** SUMMARY ***
Total pot $27 | Rake $1.22 
Board [9s Tc 7c 3d Th]
Seat 1: rusdronenv (small blind) folded before Flop
Seat 3: garougary (big blind) showed [7s 5s] and won ($25.78) with two pair, Tens and Sevens
Seat 5: king10clubs (button) mucked


PokerStars Game #102593316938:  Hold'em No Limit ($3/$6 USD) - 2013/08/11 1:58:41 ET
Table 'Klemola 40-100 bb' 6-max Seat #1 is the button
Seat 1: rusdronenv ($600 in chips) 
Seat 3: garougary ($83.78 in chips) 
Seat 5: king10clubs ($904.17 in chips) 
garougary: posts small blind $3
king10clubs: posts big blind $6
*** HOLE CARDS ***
rusdronenv: folds 
garougary: raises $6 to $12
king10clubs: folds 
Uncalled bet ($6) returned to garougary
garougary collected $12 from pot
garougary: doesn't show hand 
*** SUMMARY ***
Total pot $12 | Rake $0 
Seat 1: rusdronenv (button) folded before Flop (didn't bet)
Seat 3: garougary (small blind) collected ($12)
Seat 5: king10clubs (big blind) folded before Flop


PokerStars Game #102593319065:  Hold'em No Limit ($3/$6 USD) - 2013/08/11 1:58:53 ET
Table 'Klemola 40-100 bb' 6-max Seat #3 is the button
Seat 1: rusdronenv ($600 in chips) 
Seat 3: garougary ($89.78 in chips) 
Seat 5: king10clubs ($898.17 in chips) 
king10clubs: posts small blind $3
rusdronenv: posts big blind $6
*** HOLE CARDS ***
garougary: raises $6 to $12
king10clubs: folds 
rusdronenv: calls $6
*** FLOP *** [Ts 7h 5h]
rusdronenv: checks 
garougary: checks 
*** TURN *** [Ts 7h 5h] [2d]
rusdronenv: bets $18
garougary: folds 
Uncalled bet ($18) returned to rusdronenv
rusdronenv collected $25.78 from pot
rusdronenv: doesn't show hand 
*** SUMMARY ***
Total pot $27 | Rake $1.22 
Board [Ts 7h 5h 2d]
Seat 1: rusdronenv (big blind) collected ($25.78)
Seat 3: garougary (button) folded on the Turn
Seat 5: king10clubs (small blind) folded before Flop


PokerStars Game #102593324806:  Hold'em No Limit ($3/$6 USD) - 2013/08/11 1:59:24 ET
Table 'Klemola 40-100 bb' 6-max Seat #5 is the button
Seat 1: rusdronenv ($613.78 in chips) 
Seat 3: garougary ($77.78 in chips) 
Seat 5: king10clubs ($895.17 in chips) 
rusdronenv: posts small blind $3
garougary: posts big blind $6
*** HOLE CARDS ***
king10clubs: raises $6 to $12
rusdronenv: folds 
garougary: calls $6
*** FLOP *** [8s 3c Jd]
garougary: checks 
king10clubs: checks 
*** TURN *** [8s 3c Jd] [2d]
garougary: checks 
king10clubs: checks 
*** RIVER *** [8s 3c Jd 2d] [Kd]
garougary: bets $6
onez69 joins the table at seat #4 
king10clubs: folds 
Uncalled bet ($6) returned to garougary
garougary collected $25.78 from pot
garougary: doesn't show hand 
*** SUMMARY ***
Total pot $27 | Rake $1.22 
Board [8s 3c Jd 2d Kd]
Seat 1: rusdronenv (small blind) folded before Flop
Seat 3: garougary (big blind) collected ($25.78)
Seat 5: king10clubs (button) folded on the River


PokerStars Game #102593332285:  Hold'em No Limit ($3/$6 USD) - 2013/08/11 2:00:04 ET
Table 'Klemola 40-100 bb' 6-max Seat #1 is the button
Seat 1: rusdronenv ($610.78 in chips) 
Seat 3: garougary ($91.56 in chips) 
Seat 4: onez69 ($240 in chips) 
Seat 5: king10clubs ($883.17 in chips) 
garougary: posts small blind $3
onez69: posts big blind $6
*** HOLE CARDS ***
king10clubs: folds 
rusdronenv: raises $12 to $18
garougary: folds 
mustanggino joins the table at seat #6 
onez69: raises $27 to $45
rusdronenv: calls $27
*** FLOP *** [As Jh 5c]
onez69: bets $30
rusdronenv: folds 
Uncalled bet ($30) returned to onez69
onez69 collected $91.50 from pot
onez69: doesn't show hand 
*** SUMMARY ***
Total pot $93 | Rake $1.50 
Board [As Jh 5c]
Seat 1: rusdronenv (button) folded on the Flop
Seat 3: garougary (small blind) folded before Flop
Seat 4: onez69 (big blind) collected ($91.50)
Seat 5: king10clubs folded before Flop (didn't bet)


PokerStars Game #102593340545:  Hold'em No Limit ($3/$6 USD) - 2013/08/11 2:00:46 ET
Table 'Klemola 40-100 bb' 6-max Seat #3 is the button
Seat 1: rusdronenv ($600 in chips) 
Seat 3: garougary ($88.56 in chips) 
Seat 4: onez69 ($286.50 in chips) 
Seat 5: king10clubs ($883.17 in chips) 
onez69: posts small blind $3
king10clubs: posts big blind $6
mustanggino: sits out 
*** HOLE CARDS ***
rusdronenv: raises $12 to $18
garougary: folds 
onez69: folds 
king10clubs: folds 
Uncalled bet ($12) returned to rusdronenv
rusdronenv collected $15 from pot
rusdronenv: doesn't show hand 
*** SUMMARY ***
Total pot $15 | Rake $0 
Seat 1: rusdronenv collected ($15)
Seat 3: garougary (button) folded before Flop (didn't bet)
Seat 4: onez69 (small blind) folded before Flop
Seat 5: king10clubs (big blind) folded before Flop


PokerStars Game #102593342950:  Hold'em No Limit ($3/$6 USD) - 2013/08/11 2:00:58 ET
Table 'Klemola 40-100 bb' 6-max Seat #4 is the button
Seat 1: rusdronenv ($609 in chips) 
Seat 3: garougary ($88.56 in chips) 
Seat 4: onez69 ($283.50 in chips) 
Seat 5: king10clubs ($877.17 in chips) 
Seat 6: mustanggino ($450 in chips) 
king10clubs: posts small blind $3
mustanggino: posts big blind $6
*** HOLE CARDS ***
rusdronenv: folds 
garougary: folds 
onez69: raises $9 to $15
king10clubs: folds 
mustanggino: folds 
Uncalled bet ($9) returned to onez69
onez69 collected $15 from pot
onez69: doesn't show hand 
*** SUMMARY ***
Total pot $15 | Rake $0 
Seat 1: rusdronenv folded before Flop (didn't bet)
Seat 3: garougary folded before Flop (didn't bet)
Seat 4: onez69 (button) collected ($15)
Seat 5: king10clubs (small blind) folded before Flop
Seat 6: mustanggino (big blind) folded before Flop


PokerStars Game #102593346165:  Hold'em No Limit ($3/$6 USD) - 2013/08/11 2:01:14 ET
Table 'Klemola 40-100 bb' 6-max Seat #5 is the button
Seat 1: rusdronenv ($609 in chips) 
Seat 3: garougary ($88.56 in chips) 
Seat 4: onez69 ($292.50 in chips) 
Seat 5: king10clubs ($874.17 in chips) 
Seat 6: mustanggino ($450 in chips) 
mustanggino: posts small blind $3
rusdronenv: posts big blind $6
*** HOLE CARDS ***
garougary: folds 
onez69: folds 
king10clubs: raises $6 to $12
mustanggino: folds 
rusdronenv: calls $6
*** FLOP *** [8s 5d 4c]
rusdronenv: checks 
king10clubs: bets $18
rusdronenv: raises $36 to $54
king10clubs: raises $78 to $132
rusdronenv: raises $465 to $597 and is all-in
king10clubs: folds 
Uncalled bet ($465) returned to rusdronenv
rusdronenv collected $288.20 from pot
rusdronenv: doesn't show hand 
*** SUMMARY ***
Total pot $291 | Rake $2.80 
Board [8s 5d 4c]
Seat 1: rusdronenv (big blind) collected ($288.20)
Seat 3: garougary folded before Flop (didn't bet)
Seat 4: onez69 folded before Flop (didn't bet)
Seat 5: king10clubs (button) folded on the Flop
Seat 6: mustanggino (small blind) folded before Flop


PokerStars Game #102593356719:  Hold'em No Limit ($3/$6 USD) - 2013/08/11 2:02:01 ET
Table 'Klemola 40-100 bb' 6-max Seat #6 is the button
Seat 1: rusdronenv ($753.20 in chips) 
Seat 3: garougary ($88.56 in chips) 
Seat 4: onez69 ($292.50 in chips) 
Seat 5: king10clubs ($730.17 in chips) 
Seat 6: mustanggino ($450 in chips) 
rusdronenv: posts small blind $3
garougary: posts big blind $6
*** HOLE CARDS ***
onez69: raises $6 to $12
king10clubs: folds 
mustanggino: folds 
rusdronenv: folds 
garougary: calls $6
*** FLOP *** [Qh Ah Qs]
garougary: checks 
onez69: checks 
*** TURN *** [Qh Ah Qs] [5d]
garougary: checks 
onez69: bets $12
garougary: calls $12
*** RIVER *** [Qh Ah Qs 5d] [Kh]
garougary: checks 
Taimuraz63 joins the table at seat #2 
onez69: checks 
*** SHOW DOWN ***
garougary: shows [Th 8h] (a flush, Ace high)
onez69: mucks hand 
garougary collected $48.70 from pot
*** SUMMARY ***
Total pot $51 | Rake $2.30 
Board [Qh Ah Qs 5d Kh]
Seat 1: rusdronenv (small blind) folded before Flop
Seat 3: garougary (big blind) showed [Th 8h] and won ($48.70) with a flush, Ace high
Seat 4: onez69 mucked
Seat 5: king10clubs folded before Flop (didn't bet)
Seat 6: mustanggino (button) folded before Flop (didn't bet)


PokerStars Game #102593368341:  Hold'em No Limit ($3/$6 USD) - 2013/08/11 2:02:53 ET
Table 'Klemola 40-100 bb' 6-max Seat #1 is the button
Seat 1: rusdronenv ($750.20 in chips) 
Seat 3: garougary ($113.26 in chips) 
Seat 4: onez69 ($268.50 in chips) 
Seat 5: king10clubs ($730.17 in chips) 
Seat 6: mustanggino ($450 in chips) 
Taimuraz63 will be allowed to play after the button
garougary: posts small blind $3
onez69: posts big blind $6
*** HOLE CARDS ***
king10clubs: folds 
mustanggino: folds 
rusdronenv: folds 
garougary: raises $6 to $12
onez69: raises $36 to $48
garougary: folds 
Uncalled bet ($36) returned to onez69
onez69 collected $24 from pot
onez69: doesn't show hand 
*** SUMMARY ***
Total pot $24 | Rake $0 
Seat 1: rusdronenv (button) folded before Flop (didn't bet)
Seat 3: garougary (small blind) folded before Flop
Seat 4: onez69 (big blind) collected ($24)
Seat 5: king10clubs folded before Flop (didn't bet)
Seat 6: mustanggino folded before Flop (didn't bet)


PokerStars Game #102593376001:  Hold'em No Limit ($3/$6 USD) - 2013/08/11 2:03:27 ET
Table 'Klemola 40-100 bb' 6-max Seat #3 is the button
Seat 1: rusdronenv ($750.20 in chips) 
Seat 3: garougary ($101.26 in chips) 
Seat 4: onez69 ($280.50 in chips) 
Seat 5: king10clubs ($730.17 in chips) 
Seat 6: mustanggino ($450 in chips) 
onez69: posts small blind $3
king10clubs: posts big blind $6
Taimuraz63: sits out 
*** HOLE CARDS ***
mustanggino: folds 
rusdronenv: folds 
garougary: folds 
onez69: raises $9 to $15
king10clubs: calls $9
*** FLOP *** [8h Kc 2c]
onez69: bets $15
king10clubs: folds 
Uncalled bet ($15) returned to onez69
onez69 collected $28.65 from pot
onez69: doesn't show hand 
*** SUMMARY ***
Total pot $30 | Rake $1.35 
Board [8h Kc 2c]
Seat 1: rusdronenv folded before Flop (didn't bet)
Seat 3: garougary (button) folded before Flop (didn't bet)
Seat 4: onez69 (small blind) collected ($28.65)
Seat 5: king10clubs (big blind) folded on the Flop
Seat 6: mustanggino folded before Flop (didn't bet)


PokerStars Game #102593382683:  Hold'em No Limit ($3/$6 USD) - 2013/08/11 2:03:56 ET
Table 'Klemola 40-100 bb' 6-max Seat #4 is the button
Seat 1: rusdronenv ($750.20 in chips) 
Seat 3: garougary ($101.26 in chips) 
Seat 4: onez69 ($294.15 in chips) 
Seat 5: king10clubs ($715.17 in chips) 
Seat 6: mustanggino ($450 in chips) 
king10clubs: posts small blind $3
mustanggino: posts big blind $6
Taimuraz63: sits out 
*** HOLE CARDS ***
rusdronenv: folds 
garougary: folds 
onez69: raises $9 to $15
king10clubs: raises $35 to $50
mustanggino: folds 
onez69: folds 
Uncalled bet ($35) returned to king10clubs
king10clubs collected $36 from pot
king10clubs: doesn't show hand 
*** SUMMARY ***
Total pot $36 | Rake $0 
Seat 1: rusdronenv folded before Flop (didn't bet)
Seat 3: garougary folded before Flop (didn't bet)
Seat 4: onez69 (button) folded before Flop
Seat 5: king10clubs (small blind) collected ($36)
Seat 6: mustanggino (big blind) folded before Flop


PokerStars Game #102593394014:  Hold'em No Limit ($3/$6 USD) - 2013/08/11 2:04:45 ET
Table 'Klemola 40-100 bb' 6-max Seat #5 is the button
Seat 1: rusdronenv ($750.20 in chips) 
Seat 3: garougary ($101.26 in chips) 
Seat 4: onez69 ($279.15 in chips) 
Seat 5: king10clubs ($736.17 in chips) 
Seat 6: mustanggino ($450 in chips) 
mustanggino: posts small blind $3
rusdronenv: posts big blind $6
Taimuraz63: sits out 
*** HOLE CARDS ***
garougary: folds 
onez69: raises $9 to $15
king10clubs: calls $15
mustanggino: folds 
rusdronenv: folds 
*** FLOP *** [5h Kd Kh]
onez69: checks 
king10clubs: checks 
*** TURN *** [5h Kd Kh] [Ks]
onez69: bets $18
king10clubs: folds 
Uncalled bet ($18) returned to onez69
onez69 collected $37.24 from pot
onez69: doesn't show hand 
*** SUMMARY ***
Total pot $39 | Rake $1.76 
Board [5h Kd Kh Ks]
Seat 1: rusdronenv (big blind) folded before Flop
Seat 3: garougary folded before Flop (didn't bet)
Seat 4: onez69 collected ($37.24)
Seat 5: king10clubs (button) folded on the Turn
Seat 6: mustanggino (small blind) folded before Flop


PokerStars Game #102593281376:  Hold'em No Limit ($3/$6 USD) - 2013/08/11 1:55:32 ET
Table 'Klemola 40-100 bb' 6-max Seat #5 is the button
Seat 3: garougary ($121.50 in chips) 
Seat 5: king10clubs ($860.17 in chips) 
king10clubs: posts small blind $3
garougary: posts big blind $6
*** HOLE CARDS ***
king10clubs: raises $6 to $12
garougary: folds 
Uncalled bet ($6) returned to king10clubs
king10clubs collected $12 from pot
king10clubs: doesn't show hand 
*** SUMMARY ***
Total pot $12 | Rake $0 
Seat 3: garougary (big blind) folded before Flop
Seat 5: king10clubs (button) (small blind) collected ($12)


PokerStars Game #102593283517:  Hold'em No Limit ($3/$6 USD) - 2013/08/11 1:55:43 ET
Table 'Klemola 40-100 bb' 6-max Seat #3 is the button
Seat 3: garougary ($115.50 in chips) 
Seat 5: king10clubs ($866.17 in chips) 
garougary: posts small blind $3
king10clubs: posts big blind $6
*** HOLE CARDS ***
garougary: raises $6 to $12
king10clubs: folds 
Uncalled bet ($6) returned to garougary
garougary collected $12 from pot
garougary: doesn't show hand 
*** SUMMARY ***
Total pot $12 | Rake $0 
Seat 3: garougary (button) (small blind) collected ($12)
Seat 5: king10clubs (big blind) folded before Flop


PokerStars Game #102593284851:  Hold'em No Limit ($3/$6 USD) - 2013/08/11 1:55:50 ET
Table 'Klemola 40-100 bb' 6-max Seat #5 is the button
Seat 3: garougary ($121.50 in chips) 
Seat 5: king10clubs ($860.17 in chips) 
king10clubs: posts small blind $3
garougary: posts big blind $6
*** HOLE CARDS ***
king10clubs: raises $6 to $12
garougary: raises $12 to $24
king10clubs: folds 
Uncalled bet ($12) returned to garougary
garougary collected $24 from pot
garougary: doesn't show hand 
*** SUMMARY ***
Total pot $24 | Rake $0 
Seat 3: garougary (big blind) collected ($24)
Seat 5: king10clubs (button) (small blind) folded before Flop


PokerStars Game #102593287901:  Hold'em No Limit ($3/$6 USD) - 2013/08/11 1:56:06 ET
Table 'Klemola 40-100 bb' 6-max Seat #3 is the button
Seat 3: garougary ($133.50 in chips) 
Seat 5: king10clubs ($848.17 in chips) 
garougary: posts small blind $3
king10clubs: posts big blind $6
*** HOLE CARDS ***
garougary: raises $6 to $12
king10clubs: calls $6
*** FLOP *** [9c As Qd]
king10clubs: checks 
garougary: checks 
*** TURN *** [9c As Qd] [7h]
king10clubs: checks 
garougary: checks 
*** RIVER *** [9c As Qd 7h] [4d]
king10clubs: checks 
garougary: bets $12
king10clubs: raises $36 to $48
garougary: calls $36
*** SHOW DOWN ***
king10clubs: shows [4h 4s] (three of a kind, Fours)
garougary: mucks hand 
king10clubs collected $119.50 from pot
*** SUMMARY ***
Total pot $120 | Rake $0.50 
Board [9c As Qd 7h 4d]
Seat 3: garougary (button) (small blind) mucked
Seat 5: king10clubs (big blind) showed [4h 4s] and won ($119.50) with three of a kind, Fours


PokerStars Game #102593292705:  Hold'em No Limit ($3/$6 USD) - 2013/08/11 1:56:32 ET
Table 'Klemola 40-100 bb' 6-max Seat #5 is the button
Seat 3: garougary ($73.50 in chips) 
Seat 5: king10clubs ($907.67 in chips) 
king10clubs: posts small blind $3
garougary: posts big blind $6
*** HOLE CARDS ***
king10clubs: folds 
Uncalled bet ($3) returned to garougary
garougary collected $6 from pot
garougary: doesn't show hand 
*** SUMMARY ***
Total pot $6 | Rake $0 
Seat 3: garougary (big blind) collected ($6)
Seat 5: king10clubs (button) (small blind) folded before Flop


PokerStars Game #102593293970:  Hold'em No Limit ($3/$6 USD) - 2013/08/11 1:56:38 ET
Table 'Klemola 40-100 bb' 6-max Seat #3 is the button
Seat 3: garougary ($76.50 in chips) 
Seat 5: king10clubs ($904.67 in chips) 
garougary: posts small blind $3
king10clubs: posts big blind $6
*** HOLE CARDS ***
garougary: raises $6 to $12
king10clubs: calls $6
*** FLOP *** [Qc Jc 6s]
king10clubs: checks 
garougary: bets $18
king10clubs: folds 
Uncalled bet ($18) returned to garougary
garougary collected $23.50 from pot
garougary: doesn't show hand 
*** SUMMARY ***
Total pot $24 | Rake $0.50 
Board [Qc Jc 6s]
Seat 3: garougary (button) (small blind) collected ($23.50)
Seat 5: king10clubs (big blind) folded on the Flop


PokerStars Game #102593296622:  Hold'em No Limit ($3/$6 USD) - 2013/08/11 1:56:52 ET
Table 'Klemola 40-100 bb' 6-max Seat #5 is the button
Seat 3: garougary ($88 in chips) 
Seat 5: king10clubs ($892.67 in chips) 
king10clubs: posts small blind $3
garougary: posts big blind $6
*** HOLE CARDS ***
king10clubs: raises $6 to $12
garougary: folds 
Uncalled bet ($6) returned to king10clubs
king10clubs collected $12 from pot
king10clubs: doesn't show hand 
*** SUMMARY ***
Total pot $12 | Rake $0 
Seat 3: garougary (big blind) folded before Flop
Seat 5: king10clubs (button) (small blind) collected ($12)


PokerStars Game #102593297777:  Hold'em No Limit ($3/$6 USD) - 2013/08/11 1:56:59 ET
Table 'Klemola 40-100 bb' 6-max Seat #3 is the button
Seat 3: garougary ($82 in chips) 
Seat 5: king10clubs ($898.67 in chips) 
garougary: posts small blind $3
king10clubs: posts big blind $6
*** HOLE CARDS ***
garougary: raises $6 to $12
king10clubs: calls $6
*** FLOP *** [8h 3c Qd]
king10clubs: checks 
garougary: checks 
*** TURN *** [8h 3c Qd] [3h]
king10clubs: checks 
garougary: checks 
*** RIVER *** [8h 3c Qd 3h] [7c]
king10clubs: bets $6
garougary: folds 
Uncalled bet ($6) returned to king10clubs
king10clubs collected $23.50 from pot
king10clubs: doesn't show hand 
*** SUMMARY ***
Total pot $24 | Rake $0.50 
Board [8h 3c Qd 3h 7c]
Seat 3: garougary (button) (small blind) folded on the River
Seat 5: king10clubs (big blind) collected ($23.50)


PokerStars Game #102593302716:  Hold'em No Limit ($3/$6 USD) - 2013/08/11 1:57:25 ET
Table 'Klemola 40-100 bb' 6-max Seat #5 is the button
Seat 3: garougary ($70 in chips) 
Seat 5: king10clubs ($910.17 in chips) 
king10clubs: posts small blind $3
garougary: posts big blind $6
*** HOLE CARDS ***
rusdronenv joins the table at seat #1 
king10clubs: raises $6 to $12
garougary: folds 
Uncalled bet ($6) returned to king10clubs
king10clubs collected $12 from pot
king10clubs: doesn't show hand 
*** SUMMARY ***
Total pot $12 | Rake $0 
Seat 3: garougary (big blind) folded before Flop
Seat 5: king10clubs (button) (small blind) collected ($12)


PokerStars Game #102593304525:  Hold'em No Limit ($3/$6 USD) - 2013/08/11 1:57:34 ET
Table 'Klemola 40-100 bb' 6-max Seat #3 is the button
Seat 3: garougary ($64 in chips) 
Seat 5: king10clubs ($916.17 in chips) 
garougary: posts small blind $3
king10clubs: posts big blind $6
*** HOLE CARDS ***
garougary: raises $6 to $12
king10clubs: folds 
Uncalled bet ($6) returned to garougary
garougary collected $12 from pot
garougary: doesn't show hand 
*** SUMMARY ***
Total pot $12 | Rake $0 
Seat 3: garougary (button) (small blind) collected ($12)
Seat 5: king10clubs (big blind) folded before Flop


PokerStars Game #102593564031:  Hold'em No Limit ($3/$6 USD) - 2013/08/11 2:16:46 ET
Table 'Klemola 40-100 bb' 6-max Seat #5 is the button
Seat 1: rusdronenv ($822.40 in chips) 
Seat 2: Taimuraz63 ($432.41 in chips) 
Seat 3: garougary ($88.61 in chips) 
Seat 4: onez69 ($450.02 in chips) 
Seat 5: king10clubs ($640.17 in chips) 
Seat 6: mustanggino ($450 in chips) 
mustanggino: posts small blind $3
rusdronenv: posts big blind $6
*** HOLE CARDS ***
Taimuraz63: folds 
garougary: calls $6
onez69: folds 
king10clubs: calls $6
mustanggino: calls $3
rusdronenv: checks 
*** FLOP *** [Qc 3d 6c]
mustanggino: checks 
rusdronenv: checks 
garougary: checks 
king10clubs: bets $18
mustanggino: folds 
rusdronenv: folds 
garougary: folds 
Uncalled bet ($18) returned to king10clubs
king10clubs collected $22.92 from pot
king10clubs: doesn't show hand 
*** SUMMARY ***
Total pot $24 | Rake $1.08 
Board [Qc 3d 6c]
Seat 1: rusdronenv (big blind) folded on the Flop
Seat 2: Taimuraz63 folded before Flop (didn't bet)
Seat 3: garougary folded on the Flop
Seat 4: onez69 folded before Flop (didn't bet)
Seat 5: king10clubs (button) collected ($22.92)
Seat 6: mustanggino (small blind) folded on the Flop


PokerStars Game #102593577489:  Hold'em No Limit ($3/$6 USD) - 2013/08/11 2:17:43 ET
Table 'Klemola 40-100 bb' 6-max Seat #6 is the button
Seat 1: rusdronenv ($816.40 in chips) 
Seat 2: Taimuraz63 ($432.41 in chips) 
Seat 3: garougary ($82.61 in chips) 
Seat 4: onez69 ($450.02 in chips) 
Seat 5: king10clubs ($657.09 in chips) 
Seat 6: mustanggino ($450 in chips) 
rusdronenv: posts small blind $3
Taimuraz63: posts big blind $6
*** HOLE CARDS ***
garougary: folds 
onez69: folds 
king10clubs: raises $6 to $12
mustanggino: raises $30 to $42
rusdronenv: folds 
Taimuraz63: folds 
king10clubs: folds 
Uncalled bet ($30) returned to mustanggino
mustanggino collected $33 from pot
mustanggino: doesn't show hand 
*** SUMMARY ***
Total pot $33 | Rake $0 
Seat 1: rusdronenv (small blind) folded before Flop
Seat 2: Taimuraz63 (big blind) folded before Flop
Seat 3: garougary folded before Flop (didn't bet)
Seat 4: onez69 folded before Flop (didn't bet)
Seat 5: king10clubs folded before Flop
Seat 6: mustanggino (button) collected ($33)


PokerStars Game #102593591470:  Hold'em No Limit ($3/$6 USD) - 2013/08/11 2:18:42 ET
Table 'Klemola 40-100 bb' 6-max Seat #1 is the button
Seat 1: rusdronenv ($813.40 in chips) 
Seat 2: Taimuraz63 ($426.41 in chips) 
Seat 3: garougary ($82.61 in chips) 
Seat 4: onez69 ($450.02 in chips) 
Seat 5: king10clubs ($645.09 in chips) 
Seat 6: mustanggino ($471 in chips) 
Taimuraz63: posts small blind $3
garougary: posts big blind $6
*** HOLE CARDS ***
onez69: folds 
king10clubs: folds 
mustanggino: folds 
rusdronenv: raises $12 to $18
Taimuraz63: folds 
garougary: folds 
Uncalled bet ($12) returned to rusdronenv
rusdronenv collected $15 from pot
rusdronenv: doesn't show hand 
*** SUMMARY ***
Total pot $15 | Rake $0 
Seat 1: rusdronenv (button) collected ($15)
Seat 2: Taimuraz63 (small blind) folded before Flop
Seat 3: garougary (big blind) folded before Flop
Seat 4: onez69 folded before Flop (didn't bet)
Seat 5: king10clubs folded before Flop (didn't bet)
Seat 6: mustanggino folded before Flop (didn't bet)


PokerStars Game #102593599485:  Hold'em No Limit ($3/$6 USD) - 2013/08/11 2:19:16 ET
Table 'Klemola 40-100 bb' 6-max Seat #2 is the button
Seat 1: rusdronenv ($822.40 in chips) 
Seat 2: Taimuraz63 ($423.41 in chips) 
Seat 3: garougary ($76.61 in chips) 
Seat 4: onez69 ($450.02 in chips) 
Seat 5: king10clubs ($645.09 in chips) 
Seat 6: mustanggino ($471 in chips) 
garougary: posts small blind $3
onez69: posts big blind $6
*** HOLE CARDS ***
king10clubs: folds 
mustanggino: folds 
rusdronenv: folds 
Taimuraz63: folds 
garougary: folds 
Uncalled bet ($3) returned to onez69
onez69 collected $6 from pot
onez69: doesn't show hand 
*** SUMMARY ***
Total pot $6 | Rake $0 
Seat 1: rusdronenv folded before Flop (didn't bet)
Seat 2: Taimuraz63 (button) folded before Flop (didn't bet)
Seat 3: garougary (small blind) folded before Flop
Seat 4: onez69 (big blind) collected ($6)
Seat 5: king10clubs folded before Flop (didn't bet)
Seat 6: mustanggino folded before Flop (didn't bet)


PokerStars Game #102593603595:  Hold'em No Limit ($3/$6 USD) - 2013/08/11 2:19:34 ET
Table 'Klemola 40-100 bb' 6-max Seat #3 is the button
Seat 1: rusdronenv ($822.40 in chips) 
Seat 2: Taimuraz63 ($423.41 in chips) 
Seat 3: garougary ($73.61 in chips) 
Seat 4: onez69 ($453.02 in chips) 
Seat 5: king10clubs ($645.09 in chips) 
Seat 6: mustanggino ($471 in chips) 
onez69: posts small blind $3
king10clubs: posts big blind $6
*** HOLE CARDS ***
mustanggino: folds 
rusdronenv: folds 
Taimuraz63: folds 
garougary: raises $6 to $12
onez69: raises $18 to $30
king10clubs: folds 
garougary: calls $18
*** FLOP *** [6c 8c Td]
onez69: bets $45
garougary: folds 
Uncalled bet ($45) returned to onez69
onez69 collected $63.20 from pot
onez69: doesn't show hand 
*** SUMMARY ***
Total pot $66 | Rake $2.80 
Board [6c 8c Td]
Seat 1: rusdronenv folded before Flop (didn't bet)
Seat 2: Taimuraz63 folded before Flop (didn't bet)
Seat 3: garougary (button) folded on the Flop
Seat 4: onez69 (small blind) collected ($63.20)
Seat 5: king10clubs (big blind) folded before Flop
Seat 6: mustanggino folded before Flop (didn't bet)


PokerStars Game #102593470997:  Hold'em No Limit ($3/$6 USD) - 2013/08/11 2:10:11 ET
Table 'Klemola 40-100 bb' 6-max Seat #1 is the button
Seat 1: rusdronenv ($714.20 in chips) 
Seat 2: Taimuraz63 ($576.50 in chips) 
Seat 3: garougary ($124.61 in chips) 
Seat 4: onez69 ($221.91 in chips) 
Seat 5: king10clubs ($700.17 in chips) 
Taimuraz63: posts small blind $3
garougary: posts big blind $6
*** HOLE CARDS ***
onez69: folds 
king10clubs: folds 
rusdronenv: folds 
Taimuraz63: folds 
Uncalled bet ($3) returned to garougary
garougary collected $6 from pot
garougary: doesn't show hand 
*** SUMMARY ***
Total pot $6 | Rake $0 
Seat 1: rusdronenv (button) folded before Flop (didn't bet)
Seat 2: Taimuraz63 (small blind) folded before Flop
Seat 3: garougary (big blind) collected ($6)
Seat 4: onez69 folded before Flop (didn't bet)
Seat 5: king10clubs folded before Flop (didn't bet)


PokerStars Game #102593474781:  Hold'em No Limit ($3/$6 USD) - 2013/08/11 2:10:27 ET
Table 'Klemola 40-100 bb' 6-max Seat #2 is the button
Seat 1: rusdronenv ($714.20 in chips) 
Seat 2: Taimuraz63 ($573.50 in chips) 
Seat 3: garougary ($127.61 in chips) 
Seat 4: onez69 ($221.91 in chips) 
Seat 5: king10clubs ($700.17 in chips) 
garougary: posts small blind $3
onez69: posts big blind $6
*** HOLE CARDS ***
king10clubs: folds 
rusdronenv: folds 
Taimuraz63: raises $6 to $12
garougary: folds 
onez69: folds 
Uncalled bet ($6) returned to Taimuraz63
Taimuraz63 collected $15 from pot
*** SUMMARY ***
Total pot $15 | Rake $0 
Seat 1: rusdronenv folded before Flop (didn't bet)
Seat 2: Taimuraz63 (button) collected ($15)
Seat 3: garougary (small blind) folded before Flop
Seat 4: onez69 (big blind) folded before Flop
Seat 5: king10clubs folded before Flop (didn't bet)


PokerStars Game #102593480465:  Hold'em No Limit ($3/$6 USD) - 2013/08/11 2:10:51 ET
Table 'Klemola 40-100 bb' 6-max Seat #3 is the button
Seat 1: rusdronenv ($714.20 in chips) 
Seat 2: Taimuraz63 ($582.50 in chips) 
Seat 3: garougary ($124.61 in chips) 
Seat 4: onez69 ($215.91 in chips) 
Seat 5: king10clubs ($700.17 in chips) 
onez69: posts small blind $3
king10clubs: posts big blind $6
*** HOLE CARDS ***
rusdronenv: raises $12 to $18
Taimuraz63: folds 
garougary: folds 
onez69: folds 
king10clubs: folds 
Uncalled bet ($12) returned to rusdronenv
rusdronenv collected $15 from pot
rusdronenv: doesn't show hand 
*** SUMMARY ***
Total pot $15 | Rake $0 
Seat 1: rusdronenv collected ($15)
Seat 2: Taimuraz63 folded before Flop (didn't bet)
Seat 3: garougary (button) folded before Flop (didn't bet)
Seat 4: onez69 (small blind) folded before Flop
Seat 5: king10clubs (big blind) folded before Flop


PokerStars Game #102593484393:  Hold'em No Limit ($3/$6 USD) - 2013/08/11 2:11:08 ET
Table 'Klemola 40-100 bb' 6-max Seat #4 is the button
Seat 1: rusdronenv ($723.20 in chips) 
Seat 2: Taimuraz63 ($582.50 in chips) 
Seat 3: garougary ($124.61 in chips) 
Seat 4: onez69 ($212.91 in chips) 
Seat 5: king10clubs ($694.17 in chips) 
king10clubs: posts small blind $3
rusdronenv: posts big blind $6
*** HOLE CARDS ***
Taimuraz63: folds 
garougary: folds 
onez69: raises $9 to $15
king10clubs: folds 
rusdronenv: folds 
Uncalled bet ($9) returned to onez69
onez69 collected $15 from pot
onez69: doesn't show hand 
*** SUMMARY ***
Total pot $15 | Rake $0 
Seat 1: rusdronenv (big blind) folded before Flop
Seat 2: Taimuraz63 folded before Flop (didn't bet)
Seat 3: garougary folded before Flop (didn't bet)
Seat 4: onez69 (button) collected ($15)
Seat 5: king10clubs (small blind) folded before Flop


PokerStars Game #102593487624:  Hold'em No Limit ($3/$6 USD) - 2013/08/11 2:11:22 ET
Table 'Klemola 40-100 bb' 6-max Seat #5 is the button
Seat 1: rusdronenv ($717.20 in chips) 
Seat 2: Taimuraz63 ($582.50 in chips) 
Seat 3: garougary ($124.61 in chips) 
Seat 4: onez69 ($221.91 in chips) 
Seat 5: king10clubs ($691.17 in chips) 
rusdronenv: posts small blind $3
Taimuraz63: posts big blind $6
*** HOLE CARDS ***
garougary: folds 
onez69: folds 
king10clubs: raises $6 to $12
rusdronenv: folds 
Taimuraz63: raises $12 to $24
king10clubs: calls $12
*** FLOP *** [Tc 3h 3c]
Taimuraz63: checks 
king10clubs: checks 
*** TURN *** [Tc 3h 3c] [9h]
Taimuraz63: bets $18
king10clubs: folds 
Uncalled bet ($18) returned to Taimuraz63
Taimuraz63 collected $48.70 from pot
*** SUMMARY ***
Total pot $51 | Rake $2.30 
Board [Tc 3h 3c 9h]
Seat 1: rusdronenv (small blind) folded before Flop
Seat 2: Taimuraz63 (big blind) collected ($48.70)
Seat 3: garougary folded before Flop (didn't bet)
Seat 4: onez69 folded before Flop (didn't bet)
Seat 5: king10clubs (button) folded on the Turn


PokerStars Game #102593501050:  Hold'em No Limit ($3/$6 USD) - 2013/08/11 2:12:19 ET
Table 'Klemola 40-100 bb' 6-max Seat #1 is the button
Seat 1: rusdronenv ($714.20 in chips) 
Seat 2: Taimuraz63 ($607.20 in chips) 
Seat 3: garougary ($124.61 in chips) 
Seat 4: onez69 ($221.91 in chips) 
Seat 5: king10clubs ($667.17 in chips) 
Taimuraz63: posts small blind $3
garougary: posts big blind $6
mustanggino: sits out 
*** HOLE CARDS ***
onez69: folds 
king10clubs: folds 
rusdronenv: folds 
Taimuraz63: raises $6 to $12
garougary: calls $6
*** FLOP *** [6c 5h 9h]
Taimuraz63: bets $12
garougary: folds 
Uncalled bet ($12) returned to Taimuraz63
Taimuraz63 collected $22.92 from pot
*** SUMMARY ***
Total pot $24 | Rake $1.08 
Board [6c 5h 9h]
Seat 1: rusdronenv (button) folded before Flop (didn't bet)
Seat 2: Taimuraz63 (small blind) collected ($22.92)
Seat 3: garougary (big blind) folded on the Flop
Seat 4: onez69 folded before Flop (didn't bet)
Seat 5: king10clubs folded before Flop (didn't bet)


PokerStars Game #102593509099:  Hold'em No Limit ($3/$6 USD) - 2013/08/11 2:12:53 ET
Table 'Klemola 40-100 bb' 6-max Seat #2 is the button
Seat 1: rusdronenv ($714.20 in chips) 
Seat 2: Taimuraz63 ($618.12 in chips) 
Seat 3: garougary ($112.61 in chips) 
Seat 4: onez69 ($221.91 in chips) 
Seat 5: king10clubs ($667.17 in chips) 
garougary: posts small blind $3
onez69: posts big blind $6
mustanggino: sits out 
*** HOLE CARDS ***
king10clubs: folds 
rusdronenv: folds 
Taimuraz63: raises $6 to $12
garougary: calls $9
onez69: raises $78 to $90
Taimuraz63: raises $156 to $246
garougary: folds 
onez69: calls $131.91 and is all-in
Uncalled bet ($24.09) returned to Taimuraz63
*** FLOP *** [Js Td 5h]
*** TURN *** [Js Td 5h] [9c]
*** RIVER *** [Js Td 5h 9c] [7c]
*** SHOW DOWN ***
onez69: shows [6h 6d] (a pair of Sixes)
Taimuraz63: shows [Ac Kh] (high card Ace)
onez69 collected $453.02 from pot
*** SUMMARY ***
Total pot $455.82 | Rake $2.80 
Board [Js Td 5h 9c 7c]
Seat 1: rusdronenv folded before Flop (didn't bet)
Seat 2: Taimuraz63 (button) showed [Ac Kh] and lost with high card Ace
Seat 3: garougary (small blind) folded before Flop
Seat 4: onez69 (big blind) showed [6h 6d] and won ($453.02) with a pair of Sixes
Seat 5: king10clubs folded before Flop (didn't bet)


PokerStars Game #102593520996:  Hold'em No Limit ($3/$6 USD) - 2013/08/11 2:13:44 ET
Table 'Klemola 40-100 bb' 6-max Seat #3 is the button
Seat 1: rusdronenv ($714.20 in chips) 
Seat 2: Taimuraz63 ($396.21 in chips) 
Seat 3: garougary ($100.61 in chips) 
Seat 4: onez69 ($453.02 in chips) 
Seat 5: king10clubs ($667.17 in chips) 
onez69: posts small blind $3
king10clubs: posts big blind $6
mustanggino: sits out 
*** HOLE CARDS ***
rusdronenv: folds 
Taimuraz63: raises $6 to $12
garougary: calls $12
onez69: folds 
king10clubs: calls $6
*** FLOP *** [Jh 5d 4c]
king10clubs: checks 
Taimuraz63: bets $12
garougary: folds 
king10clubs: calls $12
*** TURN *** [Jh 5d 4c] [2d]
king10clubs: checks 
Taimuraz63: checks 
*** RIVER *** [Jh 5d 4c 2d] [7d]
king10clubs: checks 
Taimuraz63: checks 
*** SHOW DOWN ***
king10clubs: shows [8s 5s] (a pair of Fives)
Taimuraz63: shows [7c Qc] (a pair of Sevens)
Taimuraz63 collected $60.20 from pot
*** SUMMARY ***
Total pot $63 | Rake $2.80 
Board [Jh 5d 4c 2d 7d]
Seat 1: rusdronenv folded before Flop (didn't bet)
Seat 2: Taimuraz63 showed [7c Qc] and won ($60.20) with a pair of Sevens
Seat 3: garougary (button) folded on the Flop
Seat 4: onez69 (small blind) folded before Flop
Seat 5: king10clubs (big blind) showed [8s 5s] and lost with a pair of Fives


PokerStars Game #102593533948:  Hold'em No Limit ($3/$6 USD) - 2013/08/11 2:14:39 ET
Table 'Klemola 40-100 bb' 6-max Seat #4 is the button
Seat 1: rusdronenv ($714.20 in chips) 
Seat 2: Taimuraz63 ($432.41 in chips) 
Seat 3: garougary ($88.61 in chips) 
Seat 4: onez69 ($450.02 in chips) 
Seat 5: king10clubs ($643.17 in chips) 
Seat 6: mustanggino ($450 in chips) 
king10clubs: posts small blind $3
mustanggino: posts big blind $6
*** HOLE CARDS ***
rusdronenv: raises $12 to $18
Taimuraz63: folds 
garougary: folds 
onez69: folds 
king10clubs: folds 
mustanggino: calls $12
*** FLOP *** [Th 7h Ad]
mustanggino: checks 
rusdronenv: checks 
*** TURN *** [Th 7h Ad] [Kh]
mustanggino: bets $24
rusdronenv: calls $24
*** RIVER *** [Th 7h Ad Kh] [7c]
mustanggino: bets $66
rusdronenv: raises $606.20 to $672.20 and is all-in
mustanggino: folds 
Uncalled bet ($606.20) returned to rusdronenv
rusdronenv collected $216.20 from pot
rusdronenv: doesn't show hand 
*** SUMMARY ***
Total pot $219 | Rake $2.80 
Board [Th 7h Ad Kh 7c]
Seat 1: rusdronenv collected ($216.20)
Seat 2: Taimuraz63 folded before Flop (didn't bet)
Seat 3: garougary folded before Flop (didn't bet)
Seat 4: onez69 (button) folded before Flop (didn't bet)
Seat 5: king10clubs (small blind) folded before Flop
Seat 6: mustanggino (big blind) folded on the River


PokerStars Game #102593756857:  Hold'em No Limit ($3/$6 USD) - 2013/08/11 2:30:23 ET
Table 'Klemola 40-100 bb' 6-max Seat #3 is the button
Seat 1: rusdronenv ($909.60 in chips) 
Seat 2: Taimuraz63 ($399.61 in chips) 
Seat 3: garougary ($55.61 in chips) 
Seat 4: onez69 ($462.22 in chips) 
Seat 5: king10clubs ($600 in chips) 
Seat 6: mustanggino ($462 in chips) 
onez69: posts small blind $3
king10clubs: posts big blind $6
*** HOLE CARDS ***
mustanggino: folds 
rusdronenv: folds 
Taimuraz63: folds 
garougary: folds 
onez69: raises $9 to $15
king10clubs: calls $9
*** FLOP *** [Jh 6d 5h]
onez69: bets $15
king10clubs: raises $33.60 to $48.60
onez69: calls $33.60
*** TURN *** [Jh 6d 5h] [4h]
onez69: checks 
garougary is disconnected 
king10clubs: bets $90
onez69: calls $90
*** RIVER *** [Jh 6d 5h 4h] [9s]
onez69: checks 
king10clubs: checks 
*** SHOW DOWN ***
onez69: shows [7c Js] (a pair of Jacks)
king10clubs: mucks hand 
onez69 collected $304.40 from pot
*** SUMMARY ***
Total pot $307.20 | Rake $2.80 
Board [Jh 6d 5h 4h 9s]
Seat 1: rusdronenv folded before Flop (didn't bet)
Seat 2: Taimuraz63 folded before Flop (didn't bet)
Seat 3: garougary (button) folded before Flop (didn't bet)
Seat 4: onez69 (small blind) showed [7c Js] and won ($304.40) with a pair of Jacks
Seat 5: king10clubs (big blind) mucked
Seat 6: mustanggino folded before Flop (didn't bet)


PokerStars Game #102593773346:  Hold'em No Limit ($3/$6 USD) - 2013/08/11 2:31:32 ET
Table 'Klemola 40-100 bb' 6-max Seat #4 is the button
Seat 1: rusdronenv ($909.60 in chips) 
Seat 2: Taimuraz63 ($399.61 in chips) 
Seat 3: garougary ($55.61 in chips) 
Seat 4: onez69 ($613.02 in chips) 
Seat 5: king10clubs ($600 in chips) 
Seat 6: mustanggino ($462 in chips) 
king10clubs: posts small blind $3
mustanggino: posts big blind $6
*** HOLE CARDS ***
rusdronenv: folds 
Taimuraz63: folds 
garougary: folds 
onez69: raises $9 to $15
king10clubs: folds 
mustanggino: raises $33 to $48
onez69: folds 
Uncalled bet ($33) returned to mustanggino
mustanggino collected $33 from pot
mustanggino: doesn't show hand 
*** SUMMARY ***
Total pot $33 | Rake $0 
Seat 1: rusdronenv folded before Flop (didn't bet)
Seat 2: Taimuraz63 folded before Flop (didn't bet)
Seat 3: garougary folded before Flop (didn't bet)
Seat 4: onez69 (button) folded before Flop
Seat 5: king10clubs (small blind) folded before Flop
Seat 6: mustanggino (big blind) collected ($33)


PokerStars Game #102593784431:  Hold'em No Limit ($3/$6 USD) - 2013/08/11 2:32:19 ET
Table 'Klemola 40-100 bb' 6-max Seat #5 is the button
Seat 1: rusdronenv ($909.60 in chips) 
Seat 2: Taimuraz63 ($399.61 in chips) 
Seat 3: garougary ($55.61 in chips) 
Seat 4: onez69 ($598.02 in chips) 
Seat 5: king10clubs ($600 in chips) 
Seat 6: mustanggino ($480 in chips) 
mustanggino: posts small blind $3
rusdronenv: posts big blind $6
*** HOLE CARDS ***
Taimuraz63: folds 
garougary: folds 
onez69: raises $9 to $15
king10clubs: raises $33 to $48
mustanggino: raises $54 to $102
rusdronenv: folds 
onez69: folds 
king10clubs: folds 
Uncalled bet ($54) returned to mustanggino
mustanggino collected $117 from pot
mustanggino: doesn't show hand 
*** SUMMARY ***
Total pot $117 | Rake $0 
Seat 1: rusdronenv (big blind) folded before Flop
Seat 2: Taimuraz63 folded before Flop (didn't bet)
Seat 3: garougary folded before Flop (didn't bet)
Seat 4: onez69 folded before Flop
Seat 5: king10clubs (button) folded before Flop
Seat 6: mustanggino (small blind) collected ($117)


PokerStars Game #102593799028:  Hold'em No Limit ($3/$6 USD) - 2013/08/11 2:33:21 ET
Table 'Klemola 40-100 bb' 6-max Seat #6 is the button
Seat 1: rusdronenv ($903.60 in chips) 
Seat 2: Taimuraz63 ($399.61 in chips) 
Seat 3: garougary ($55.61 in chips) 
Seat 4: onez69 ($583.02 in chips) 
Seat 5: king10clubs ($600 in chips) 
Seat 6: mustanggino ($549 in chips) 
rusdronenv: posts small blind $3
Taimuraz63: posts big blind $6
*** HOLE CARDS ***
garougary: folds 
onez69: folds 
king10clubs: raises $9 to $15
mustanggino: folds 
rusdronenv: folds 
Taimuraz63: calls $9
*** FLOP *** [Ac 3c Ks]
Taimuraz63: checks 
king10clubs: checks 
*** TURN *** [Ac 3c Ks] [5s]
Taimuraz63: bets $12
king10clubs: calls $12
*** RIVER *** [Ac 3c Ks 5s] [5h]
Taimuraz63: bets $12
king10clubs: calls $12
*** SHOW DOWN ***
Taimuraz63: shows [Kh Th] (two pair, Kings and Fives)
king10clubs: shows [Js Kd] (two pair, Kings and Fives)
Taimuraz63 collected $39.10 from pot
king10clubs collected $39.10 from pot
*** SUMMARY ***
Total pot $81 | Rake $2.80 
Board [Ac 3c Ks 5s 5h]
Seat 1: rusdronenv (small blind) folded before Flop
Seat 2: Taimuraz63 (big blind) showed [Kh Th] and won ($39.10) with two pair, Kings and Fives
Seat 3: garougary folded before Flop (didn't bet)
Seat 4: onez69 folded before Flop (didn't bet)
Seat 5: king10clubs showed [Js Kd] and won ($39.10) with two pair, Kings and Fives
Seat 6: mustanggino (button) folded before Flop (didn't bet)


PokerStars Game #102593815269:  Hold'em No Limit ($3/$6 USD) - 2013/08/11 2:34:30 ET
Table 'Klemola 40-100 bb' 6-max Seat #1 is the button
Seat 1: rusdronenv ($900.60 in chips) 
Seat 2: Taimuraz63 ($399.71 in chips) 
Seat 3: garougary ($55.61 in chips) 
Seat 4: onez69 ($583.02 in chips) 
Seat 5: king10clubs ($600.10 in chips) 
Seat 6: mustanggino ($549 in chips) 
Taimuraz63: posts small blind $3
garougary: posts big blind $6
*** HOLE CARDS ***
onez69: folds 
king10clubs: folds 
mustanggino: folds 
rusdronenv: folds 
Taimuraz63: folds 
Uncalled bet ($3) returned to garougary
garougary collected $6 from pot
*** SUMMARY ***
Total pot $6 | Rake $0 
Seat 1: rusdronenv (button) folded before Flop (didn't bet)
Seat 2: Taimuraz63 (small blind) folded before Flop
Seat 3: garougary (big blind) collected ($6)
Seat 4: onez69 folded before Flop (didn't bet)
Seat 5: king10clubs folded before Flop (didn't bet)
Seat 6: mustanggino folded before Flop (didn't bet)


PokerStars Game #102593821159:  Hold'em No Limit ($3/$6 USD) - 2013/08/11 2:34:55 ET
Table 'Klemola 40-100 bb' 6-max Seat #2 is the button
Seat 1: rusdronenv ($900.60 in chips) 
Seat 2: Taimuraz63 ($396.71 in chips) 
Seat 3: garougary ($58.61 in chips) 
Seat 4: onez69 ($583.02 in chips) 
Seat 5: king10clubs ($600.10 in chips) 
Seat 6: mustanggino ($549 in chips) 
garougary: posts small blind $3
onez69: posts big blind $6
*** HOLE CARDS ***
king10clubs: folds 
mustanggino: folds 
rusdronenv: folds 
Taimuraz63: folds 
garougary: folds 
Uncalled bet ($3) returned to onez69
onez69 collected $6 from pot
onez69: doesn't show hand 
*** SUMMARY ***
Total pot $6 | Rake $0 
Seat 1: rusdronenv folded before Flop (didn't bet)
Seat 2: Taimuraz63 (button) folded before Flop (didn't bet)
Seat 3: garougary (small blind) folded before Flop
Seat 4: onez69 (big blind) collected ($6)
Seat 5: king10clubs folded before Flop (didn't bet)
Seat 6: mustanggino folded before Flop (didn't bet)


PokerStars Game #102593686439:  Hold'em No Limit ($3/$6 USD) - 2013/08/11 2:25:25 ET
Table 'Klemola 40-100 bb' 6-max Seat #6 is the button
Seat 1: rusdronenv ($816.40 in chips) 
Seat 2: Taimuraz63 ($483.61 in chips) 
Seat 3: garougary ($52.61 in chips) 
Seat 4: onez69 ($477.22 in chips) 
Seat 5: king10clubs ($600.09 in chips) 
Seat 6: mustanggino ($453 in chips) 
rusdronenv: posts small blind $3
Taimuraz63: posts big blind $6
*** HOLE CARDS ***
garougary: folds 
onez69: folds 
king10clubs: folds 
mustanggino: folds 
rusdronenv: folds 
Uncalled bet ($3) returned to Taimuraz63
Taimuraz63 collected $6 from pot
*** SUMMARY ***
Total pot $6 | Rake $0 
Seat 1: rusdronenv (small blind) folded before Flop
Seat 2: Taimuraz63 (big blind) collected ($6)
Seat 3: garougary folded before Flop (didn't bet)
Seat 4: onez69 folded before Flop (didn't bet)
Seat 5: king10clubs folded before Flop (didn't bet)
Seat 6: mustanggino (button) folded before Flop (didn't bet)


PokerStars Game #102593692726:  Hold'em No Limit ($3/$6 USD) - 2013/08/11 2:25:51 ET
Table 'Klemola 40-100 bb' 6-max Seat #1 is the button
Seat 1: rusdronenv ($813.40 in chips) 
Seat 2: Taimuraz63 ($486.61 in chips) 
Seat 3: garougary ($52.61 in chips) 
Seat 4: onez69 ($477.22 in chips) 
Seat 5: king10clubs ($600.09 in chips) 
Seat 6: mustanggino ($453 in chips) 
Taimuraz63: posts small blind $3
garougary: posts big blind $6
*** HOLE CARDS ***
onez69: folds 
king10clubs: folds 
mustanggino: folds 
rusdronenv: raises $12 to $18
Taimuraz63: folds 
garougary: folds 
Uncalled bet ($12) returned to rusdronenv
rusdronenv collected $15 from pot
rusdronenv: doesn't show hand 
*** SUMMARY ***
Total pot $15 | Rake $0 
Seat 1: rusdronenv (button) collected ($15)
Seat 2: Taimuraz63 (small blind) folded before Flop
Seat 3: garougary (big blind) folded before Flop
Seat 4: onez69 folded before Flop (didn't bet)
Seat 5: king10clubs folded before Flop (didn't bet)
Seat 6: mustanggino folded before Flop (didn't bet)


PokerStars Game #102593697326:  Hold'em No Limit ($3/$6 USD) - 2013/08/11 2:26:11 ET
Table 'Klemola 40-100 bb' 6-max Seat #2 is the button
Seat 1: rusdronenv ($822.40 in chips) 
Seat 2: Taimuraz63 ($483.61 in chips) 
Seat 3: garougary ($46.61 in chips) 
Seat 4: onez69 ($477.22 in chips) 
Seat 5: king10clubs ($600.09 in chips) 
Seat 6: mustanggino ($453 in chips) 
garougary: posts small blind $3
onez69: posts big blind $6
*** HOLE CARDS ***
king10clubs: folds 
mustanggino: folds 
rusdronenv: raises $12 to $18
Taimuraz63: folds 
garougary: folds 
onez69: folds 
Uncalled bet ($12) returned to rusdronenv
rusdronenv collected $15 from pot
rusdronenv: doesn't show hand 
*** SUMMARY ***
Total pot $15 | Rake $0 
Seat 1: rusdronenv collected ($15)
Seat 2: Taimuraz63 (button) folded before Flop (didn't bet)
Seat 3: garougary (small blind) folded before Flop
Seat 4: onez69 (big blind) folded before Flop
Seat 5: king10clubs folded before Flop (didn't bet)
Seat 6: mustanggino folded before Flop (didn't bet)


PokerStars Game #102593706742:  Hold'em No Limit ($3/$6 USD) - 2013/08/11 2:26:51 ET
Table 'Klemola 40-100 bb' 6-max Seat #3 is the button
Seat 1: rusdronenv ($831.40 in chips) 
Seat 2: Taimuraz63 ($483.61 in chips) 
Seat 3: garougary ($43.61 in chips) 
Seat 4: onez69 ($471.22 in chips) 
Seat 5: king10clubs ($600.09 in chips) 
Seat 6: mustanggino ($453 in chips) 
onez69: posts small blind $3
king10clubs: posts big blind $6
*** HOLE CARDS ***
mustanggino: folds 
rusdronenv: folds 
Taimuraz63: raises $6 to $12
garougary: folds 
onez69: folds 
king10clubs: folds 
Uncalled bet ($6) returned to Taimuraz63
Taimuraz63 collected $15 from pot
*** SUMMARY ***
Total pot $15 | Rake $0 
Seat 1: rusdronenv folded before Flop (didn't bet)
Seat 2: Taimuraz63 collected ($15)
Seat 3: garougary (button) folded before Flop (didn't bet)
Seat 4: onez69 (small blind) folded before Flop
Seat 5: king10clubs (big blind) folded before Flop
Seat 6: mustanggino folded before Flop (didn't bet)


PokerStars Game #102593712476:  Hold'em No Limit ($3/$6 USD) - 2013/08/11 2:27:15 ET
Table 'Klemola 40-100 bb' 6-max Seat #4 is the button
Seat 1: rusdronenv ($831.40 in chips) 
Seat 2: Taimuraz63 ($492.61 in chips) 
Seat 3: garougary ($43.61 in chips) 
Seat 4: onez69 ($468.22 in chips) 
Seat 5: king10clubs ($600 in chips) 
Seat 6: mustanggino ($453 in chips) 
king10clubs: posts small blind $3
mustanggino: posts big blind $6
*** HOLE CARDS ***
rusdronenv: folds 
Taimuraz63: folds 
garougary: folds 
onez69: folds 
king10clubs: folds 
Uncalled bet ($3) returned to mustanggino
mustanggino collected $6 from pot
mustanggino: doesn't show hand 
*** SUMMARY ***
Total pot $6 | Rake $0 
Seat 1: rusdronenv folded before Flop (didn't bet)
Seat 2: Taimuraz63 folded before Flop (didn't bet)
Seat 3: garougary folded before Flop (didn't bet)
Seat 4: onez69 (button) folded before Flop (didn't bet)
Seat 5: king10clubs (small blind) folded before Flop
Seat 6: mustanggino (big blind) collected ($6)


PokerStars Game #102593716668:  Hold'em No Limit ($3/$6 USD) - 2013/08/11 2:27:32 ET
Table 'Klemola 40-100 bb' 6-max Seat #5 is the button
Seat 1: rusdronenv ($831.40 in chips) 
Seat 2: Taimuraz63 ($492.61 in chips) 
Seat 3: garougary ($43.61 in chips) 
Seat 4: onez69 ($468.22 in chips) 
Seat 5: king10clubs ($600 in chips) 
Seat 6: mustanggino ($456 in chips) 
mustanggino: posts small blind $3
rusdronenv: posts big blind $6
*** HOLE CARDS ***
Taimuraz63: folds 
garougary: folds 
onez69: folds 
king10clubs: folds 
mustanggino: raises $6 to $12
rusdronenv: folds 
Uncalled bet ($6) returned to mustanggino
mustanggino collected $12 from pot
mustanggino: doesn't show hand 
*** SUMMARY ***
Total pot $12 | Rake $0 
Seat 1: rusdronenv (big blind) folded before Flop
Seat 2: Taimuraz63 folded before Flop (didn't bet)
Seat 3: garougary folded before Flop (didn't bet)
Seat 4: onez69 folded before Flop (didn't bet)
Seat 5: king10clubs (button) folded before Flop (didn't bet)
Seat 6: mustanggino (small blind) collected ($12)


PokerStars Game #102593722338:  Hold'em No Limit ($3/$6 USD) - 2013/08/11 2:27:57 ET
Table 'Klemola 40-100 bb' 6-max Seat #6 is the button
Seat 1: rusdronenv ($825.40 in chips) 
Seat 2: Taimuraz63 ($492.61 in chips) 
Seat 3: garougary ($43.61 in chips) 
Seat 4: onez69 ($468.22 in chips) 
Seat 5: king10clubs ($600 in chips) 
Seat 6: mustanggino ($462 in chips) 
rusdronenv: posts small blind $3
Taimuraz63: posts big blind $6
*** HOLE CARDS ***
garougary: folds 
onez69: folds 
king10clubs: folds 
mustanggino: folds 
rusdronenv: folds 
Uncalled bet ($3) returned to Taimuraz63
Taimuraz63 collected $6 from pot
*** SUMMARY ***
Total pot $6 | Rake $0 
Seat 1: rusdronenv (small blind) folded before Flop
Seat 2: Taimuraz63 (big blind) collected ($6)
Seat 3: garougary folded before Flop (didn't bet)
Seat 4: onez69 folded before Flop (didn't bet)
Seat 5: king10clubs folded before Flop (didn't bet)
Seat 6: mustanggino (button) folded before Flop (didn't bet)


PokerStars Game #102593729713:  Hold'em No Limit ($3/$6 USD) - 2013/08/11 2:28:28 ET
Table 'Klemola 40-100 bb' 6-max Seat #1 is the button
Seat 1: rusdronenv ($822.40 in chips) 
Seat 2: Taimuraz63 ($495.61 in chips) 
Seat 3: garougary ($43.61 in chips) 
Seat 4: onez69 ($468.22 in chips) 
Seat 5: king10clubs ($600 in chips) 
Seat 6: mustanggino ($462 in chips) 
Taimuraz63: posts small blind $3
garougary: posts big blind $6
*** HOLE CARDS ***
onez69: folds 
king10clubs: folds 
mustanggino: folds 
rusdronenv: raises $6 to $12
Taimuraz63: calls $9
garougary: folds 
*** FLOP *** [3d 7s 9d]
Taimuraz63: checks 
rusdronenv: bets $18
Taimuraz63: calls $18
*** TURN *** [3d 7s 9d] [7d]
Taimuraz63: checks 
rusdronenv: bets $54
Taimuraz63: calls $54
*** RIVER *** [3d 7s 9d 7d] [4d]
Taimuraz63: checks 
rusdronenv: bets $132
Taimuraz63: folds 
Uncalled bet ($132) returned to rusdronenv
rusdronenv collected $171.20 from pot
rusdronenv: doesn't show hand 
*** SUMMARY ***
Total pot $174 | Rake $2.80 
Board [3d 7s 9d 7d 4d]
Seat 1: rusdronenv (button) collected ($171.20)
Seat 2: Taimuraz63 (small blind) folded on the River
Seat 3: garougary (big blind) folded before Flop
Seat 4: onez69 folded before Flop (didn't bet)
Seat 5: king10clubs folded before Flop (didn't bet)
Seat 6: mustanggino folded before Flop (didn't bet)


PokerStars Game #102593748976:  Hold'em No Limit ($3/$6 USD) - 2013/08/11 2:29:50 ET
Table 'Klemola 40-100 bb' 6-max Seat #2 is the button
Seat 1: rusdronenv ($909.60 in chips) 
Seat 2: Taimuraz63 ($411.61 in chips) 
Seat 3: garougary ($37.61 in chips) 
Seat 4: onez69 ($468.22 in chips) 
Seat 5: king10clubs ($600 in chips) 
Seat 6: mustanggino ($462 in chips) 
garougary: posts small blind $3
onez69: posts big blind $6
*** HOLE CARDS ***
king10clubs: folds 
mustanggino: folds 
rusdronenv: folds 
Taimuraz63: raises $6 to $12
garougary: raises $25.61 to $37.61 and is all-in
onez69: folds 
Taimuraz63: folds 
Uncalled bet ($25.61) returned to garougary
garougary collected $30 from pot
garougary: doesn't show hand 
*** SUMMARY ***
Total pot $30 | Rake $0 
Seat 1: rusdronenv folded before Flop (didn't bet)
Seat 2: Taimuraz63 (button) folded before Flop
Seat 3: garougary (small blind) collected ($30)
Seat 4: onez69 (big blind) folded before Flop
Seat 5: king10clubs folded before Flop (didn't bet)
Seat 6: mustanggino folded before Flop (didn't bet)


PokerStars Game #102593615242:  Hold'em No Limit ($3/$6 USD) - 2013/08/11 2:20:22 ET
Table 'Klemola 40-100 bb' 6-max Seat #4 is the button
Seat 1: rusdronenv ($822.40 in chips) 
Seat 2: Taimuraz63 ($423.41 in chips) 
Seat 3: garougary ($43.61 in chips) 
Seat 4: onez69 ($486.22 in chips) 
Seat 5: king10clubs ($639.09 in chips) 
Seat 6: mustanggino ($471 in chips) 
king10clubs: posts small blind $3
mustanggino: posts big blind $6
*** HOLE CARDS ***
rusdronenv: folds 
Taimuraz63: folds 
garougary: folds 
onez69: folds 
king10clubs: raises $9 to $15
mustanggino: folds 
Uncalled bet ($9) returned to king10clubs
king10clubs collected $12 from pot
king10clubs: doesn't show hand 
*** SUMMARY ***
Total pot $12 | Rake $0 
Seat 1: rusdronenv folded before Flop (didn't bet)
Seat 2: Taimuraz63 folded before Flop (didn't bet)
Seat 3: garougary folded before Flop (didn't bet)
Seat 4: onez69 (button) folded before Flop (didn't bet)
Seat 5: king10clubs (small blind) collected ($12)
Seat 6: mustanggino (big blind) folded before Flop


PokerStars Game #102593626435:  Hold'em No Limit ($3/$6 USD) - 2013/08/11 2:21:10 ET
Table 'Klemola 40-100 bb' 6-max Seat #5 is the button
Seat 1: rusdronenv ($822.40 in chips) 
Seat 2: Taimuraz63 ($423.41 in chips) 
Seat 3: garougary ($43.61 in chips) 
Seat 4: onez69 ($486.22 in chips) 
Seat 5: king10clubs ($645.09 in chips) 
Seat 6: mustanggino ($465 in chips) 
mustanggino: posts small blind $3
rusdronenv: posts big blind $6
*** HOLE CARDS ***
Taimuraz63: raises $6 to $12
garougary: folds 
onez69: folds 
king10clubs: folds 
mustanggino: folds 
rusdronenv: folds 
Uncalled bet ($6) returned to Taimuraz63
Taimuraz63 collected $15 from pot
*** SUMMARY ***
Total pot $15 | Rake $0 
Seat 1: rusdronenv (big blind) folded before Flop
Seat 2: Taimuraz63 collected ($15)
Seat 3: garougary folded before Flop (didn't bet)
Seat 4: onez69 folded before Flop (didn't bet)
Seat 5: king10clubs (button) folded before Flop (didn't bet)
Seat 6: mustanggino (small blind) folded before Flop


PokerStars Game #102593633685:  Hold'em No Limit ($3/$6 USD) - 2013/08/11 2:21:41 ET
Table 'Klemola 40-100 bb' 6-max Seat #6 is the button
Seat 1: rusdronenv ($816.40 in chips) 
Seat 2: Taimuraz63 ($432.41 in chips) 
Seat 3: garougary ($43.61 in chips) 
Seat 4: onez69 ($486.22 in chips) 
Seat 5: king10clubs ($645.09 in chips) 
Seat 6: mustanggino ($462 in chips) 
rusdronenv: posts small blind $3
Taimuraz63: posts big blind $6
*** HOLE CARDS ***
garougary: folds 
onez69: folds 
king10clubs: raises $9 to $15
mustanggino: folds 
rusdronenv: folds 
Taimuraz63: calls $9
*** FLOP *** [4d Js 5s]
Taimuraz63: checks 
king10clubs: bets $21
Taimuraz63: calls $21
*** TURN *** [4d Js 5s] [7s]
Taimuraz63: checks 
king10clubs: checks 
*** RIVER *** [4d Js 5s 7s] [2s]
Taimuraz63: checks 
king10clubs: checks 
*** SHOW DOWN ***
Taimuraz63: shows [Jh Qh] (a pair of Jacks)
king10clubs: mucks hand 
Taimuraz63 collected $72.20 from pot
*** SUMMARY ***
Total pot $75 | Rake $2.80 
Board [4d Js 5s 7s 2s]
Seat 1: rusdronenv (small blind) folded before Flop
Seat 2: Taimuraz63 (big blind) showed [Jh Qh] and won ($72.20) with a pair of Jacks
Seat 3: garougary folded before Flop (didn't bet)
Seat 4: onez69 folded before Flop (didn't bet)
Seat 5: king10clubs mucked
Seat 6: mustanggino (button) folded before Flop (didn't bet)


PokerStars Game #102593649634:  Hold'em No Limit ($3/$6 USD) - 2013/08/11 2:22:48 ET
Table 'Klemola 40-100 bb' 6-max Seat #1 is the button
Seat 1: rusdronenv ($813.40 in chips) 
Seat 2: Taimuraz63 ($468.61 in chips) 
Seat 3: garougary ($43.61 in chips) 
Seat 4: onez69 ($486.22 in chips) 
Seat 5: king10clubs ($609.09 in chips) 
Seat 6: mustanggino ($462 in chips) 
Taimuraz63: posts small blind $3
garougary: posts big blind $6
*** HOLE CARDS ***
onez69: folds 
king10clubs: folds 
mustanggino: folds 
rusdronenv: folds 
Taimuraz63: folds 
Uncalled bet ($3) returned to garougary
garougary collected $6 from pot
garougary: doesn't show hand 
*** SUMMARY ***
Total pot $6 | Rake $0 
Seat 1: rusdronenv (button) folded before Flop (didn't bet)
Seat 2: Taimuraz63 (small blind) folded before Flop
Seat 3: garougary (big blind) collected ($6)
Seat 4: onez69 folded before Flop (didn't bet)
Seat 5: king10clubs folded before Flop (didn't bet)
Seat 6: mustanggino folded before Flop (didn't bet)


PokerStars Game #102593656951:  Hold'em No Limit ($3/$6 USD) - 2013/08/11 2:23:20 ET
Table 'Klemola 40-100 bb' 6-max Seat #2 is the button
Seat 1: rusdronenv ($813.40 in chips) 
Seat 2: Taimuraz63 ($465.61 in chips) 
Seat 3: garougary ($46.61 in chips) 
Seat 4: onez69 ($486.22 in chips) 
Seat 5: king10clubs ($609.09 in chips) 
Seat 6: mustanggino ($462 in chips) 
garougary: posts small blind $3
onez69: posts big blind $6
*** HOLE CARDS ***
king10clubs: folds 
mustanggino: folds 
rusdronenv: raises $12 to $18
Taimuraz63: folds 
garougary: folds 
onez69: folds 
Uncalled bet ($12) returned to rusdronenv
rusdronenv collected $15 from pot
rusdronenv: doesn't show hand 
*** SUMMARY ***
Total pot $15 | Rake $0 
Seat 1: rusdronenv collected ($15)
Seat 2: Taimuraz63 (button) folded before Flop (didn't bet)
Seat 3: garougary (small blind) folded before Flop
Seat 4: onez69 (big blind) folded before Flop
Seat 5: king10clubs folded before Flop (didn't bet)
Seat 6: mustanggino folded before Flop (didn't bet)


PokerStars Game #102593665063:  Hold'em No Limit ($3/$6 USD) - 2013/08/11 2:23:54 ET
Table 'Klemola 40-100 bb' 6-max Seat #3 is the button
Seat 1: rusdronenv ($822.40 in chips) 
Seat 2: Taimuraz63 ($465.61 in chips) 
Seat 3: garougary ($43.61 in chips) 
Seat 4: onez69 ($480.22 in chips) 
Seat 5: king10clubs ($609.09 in chips) 
Seat 6: mustanggino ($462 in chips) 
onez69: posts small blind $3
king10clubs: posts big blind $6
*** HOLE CARDS ***
mustanggino: folds 
rusdronenv: folds 
Taimuraz63: raises $6 to $12
garougary: folds 
onez69: folds 
king10clubs: folds 
Uncalled bet ($6) returned to Taimuraz63
Taimuraz63 collected $15 from pot
*** SUMMARY ***
Total pot $15 | Rake $0 
Seat 1: rusdronenv folded before Flop (didn't bet)
Seat 2: Taimuraz63 collected ($15)
Seat 3: garougary (button) folded before Flop (didn't bet)
Seat 4: onez69 (small blind) folded before Flop
Seat 5: king10clubs (big blind) folded before Flop
Seat 6: mustanggino folded before Flop (didn't bet)


PokerStars Game #102593671218:  Hold'em No Limit ($3/$6 USD) - 2013/08/11 2:24:20 ET
Table 'Klemola 40-100 bb' 6-max Seat #4 is the button
Seat 1: rusdronenv ($822.40 in chips) 
Seat 2: Taimuraz63 ($474.61 in chips) 
Seat 3: garougary ($43.61 in chips) 
Seat 4: onez69 ($477.22 in chips) 
Seat 5: king10clubs ($603.09 in chips) 
Seat 6: mustanggino ($462 in chips) 
king10clubs: posts small blind $3
mustanggino: posts big blind $6
*** HOLE CARDS ***
rusdronenv: folds 
Taimuraz63: raises $6 to $12
garougary: folds 
onez69: folds 
king10clubs: folds 
mustanggino: folds 
Uncalled bet ($6) returned to Taimuraz63
Taimuraz63 collected $15 from pot
*** SUMMARY ***
Total pot $15 | Rake $0 
Seat 1: rusdronenv folded before Flop (didn't bet)
Seat 2: Taimuraz63 collected ($15)
Seat 3: garougary folded before Flop (didn't bet)
Seat 4: onez69 (button) folded before Flop (didn't bet)
Seat 5: king10clubs (small blind) folded before Flop
Seat 6: mustanggino (big blind) folded before Flop


PokerStars Game #102593677190:  Hold'em No Limit ($3/$6 USD) - 2013/08/11 2:24:45 ET
Table 'Klemola 40-100 bb' 6-max Seat #5 is the button
Seat 1: rusdronenv ($822.40 in chips) 
Seat 2: Taimuraz63 ($483.61 in chips) 
Seat 3: garougary ($43.61 in chips) 
Seat 4: onez69 ($477.22 in chips) 
Seat 5: king10clubs ($600.09 in chips) 
Seat 6: mustanggino ($456 in chips) 
mustanggino: posts small blind $3
rusdronenv: posts big blind $6
*** HOLE CARDS ***
Taimuraz63: folds 
garougary: raises $37.61 to $43.61 and is all-in
onez69: folds 
king10clubs: folds 
mustanggino: folds 
rusdronenv: folds 
Uncalled bet ($37.61) returned to garougary
garougary collected $15 from pot
garougary: doesn't show hand 
*** SUMMARY ***
Total pot $15 | Rake $0 
Seat 1: rusdronenv (big blind) folded before Flop
Seat 2: Taimuraz63 folded before Flop (didn't bet)
Seat 3: garougary collected ($15)
Seat 4: onez69 folded before Flop (didn't bet)
Seat 5: king10clubs (button) folded before Flop (didn't bet)
Seat 6: mustanggino (small blind) folded before Flop


PokerStars Game #102593968560:  Hold'em No Limit ($3/$6 USD) - 2013/08/11 2:45:08 ET
Table 'Klemola 40-100 bb' 6-max Seat #2 is the button
Seat 1: rusdronenv ($947.69 in chips) 
Seat 2: Taimuraz63 ($402.87 in chips) 
Seat 3: garougary ($96.42 in chips) 
Seat 4: mrienader ($619.28 in chips) 
Seat 5: king10clubs ($653.78 in chips) 
garougary: posts small blind $3
mrienader: posts big blind $6
Blazterr: sits out 
*** HOLE CARDS ***
king10clubs: folds 
rusdronenv: raises $12 to $18
Taimuraz63: folds 
garougary: calls $15
mrienader: folds 
*** FLOP *** [Ts 7d 3c]
garougary: checks 
rusdronenv: checks 
*** TURN *** [Ts 7d 3c] [Kh]
garougary: checks 
rusdronenv: checks 
*** RIVER *** [Ts 7d 3c Kh] [2h]
garougary: checks 
rusdronenv: checks 
*** SHOW DOWN ***
garougary: shows [Ah 7h] (a pair of Sevens)
rusdronenv: mucks hand 
garougary collected $40.11 from pot
*** SUMMARY ***
Total pot $42 | Rake $1.89 
Board [Ts 7d 3c Kh 2h]
Seat 1: rusdronenv mucked
Seat 2: Taimuraz63 (button) folded before Flop (didn't bet)
Seat 3: garougary (small blind) showed [Ah 7h] and won ($40.11) with a pair of Sevens
Seat 4: mrienader (big blind) folded before Flop
Seat 5: king10clubs folded before Flop (didn't bet)


PokerStars Game #102593979726:  Hold'em No Limit ($3/$6 USD) - 2013/08/11 2:45:53 ET
Table 'Klemola 40-100 bb' 6-max Seat #3 is the button
Seat 1: rusdronenv ($929.69 in chips) 
Seat 3: garougary ($118.53 in chips) 
Seat 4: mrienader ($613.28 in chips) 
Seat 5: king10clubs ($653.78 in chips) 
mrienader: posts small blind $3
king10clubs: posts big blind $6
Blazterr: sits out 
*** HOLE CARDS ***
rusdronenv: folds 
garougary: raises $6 to $12
mrienader: folds 
king10clubs: raises $36 to $48
garougary: folds 
Uncalled bet ($36) returned to king10clubs
king10clubs collected $27 from pot
king10clubs: doesn't show hand 
*** SUMMARY ***
Total pot $27 | Rake $0 
Seat 1: rusdronenv folded before Flop (didn't bet)
Seat 3: garougary (button) folded before Flop
Seat 4: mrienader (small blind) folded before Flop
Seat 5: king10clubs (big blind) collected ($27)


PokerStars Game #102593985442:  Hold'em No Limit ($3/$6 USD) - 2013/08/11 2:46:16 ET
Table 'Klemola 40-100 bb' 6-max Seat #4 is the button
Seat 1: rusdronenv ($929.69 in chips) 
Seat 3: garougary ($106.53 in chips) 
Seat 4: mrienader ($610.28 in chips) 
Seat 5: king10clubs ($668.78 in chips) 
Seat 6: Blazterr ($240 in chips) 
king10clubs: posts small blind $3
Blazterr: posts big blind $6
*** HOLE CARDS ***
rusdronenv: folds 
garougary: folds 
mrienader: folds 
king10clubs: raises $9 to $15
Blazterr: folds 
Uncalled bet ($9) returned to king10clubs
king10clubs collected $12 from pot
king10clubs: doesn't show hand 
*** SUMMARY ***
Total pot $12 | Rake $0 
Seat 1: rusdronenv folded before Flop (didn't bet)
Seat 3: garougary folded before Flop (didn't bet)
Seat 4: mrienader (button) folded before Flop (didn't bet)
Seat 5: king10clubs (small blind) collected ($12)
Seat 6: Blazterr (big blind) folded before Flop


PokerStars Game #102593990611:  Hold'em No Limit ($3/$6 USD) - 2013/08/11 2:46:37 ET
Table 'Klemola 40-100 bb' 6-max Seat #5 is the button
Seat 1: rusdronenv ($929.69 in chips) 
Seat 3: garougary ($106.53 in chips) 
Seat 4: mrienader ($610.28 in chips) 
Seat 5: king10clubs ($674.78 in chips) 
Seat 6: Blazterr ($234 in chips) 
Blazterr: posts small blind $3
rusdronenv: posts big blind $6
*** HOLE CARDS ***
garougary: folds 
mrienader: folds 
king10clubs: raises $6 to $12
Blazterr: folds 
rusdronenv: calls $6
*** FLOP *** [Kh 9s Jh]
rusdronenv: checks 
king10clubs: bets $18
rusdronenv: calls $18
*** TURN *** [Kh 9s Jh] [6d]
rusdronenv: checks 
king10clubs: bets $47.50
rusdronenv: calls $47.50
*** RIVER *** [Kh 9s Jh 6d] [Qc]
rusdronenv: checks 
king10clubs: bets $108
rusdronenv: calls $108
*** SHOW DOWN ***
king10clubs: shows [9h 4h] (a pair of Nines)
rusdronenv: shows [Tc 9d] (a straight, Nine to King)
rusdronenv collected $371.20 from pot
*** SUMMARY ***
Total pot $374 | Rake $2.80 
Board [Kh 9s Jh 6d Qc]
Seat 1: rusdronenv (big blind) showed [Tc 9d] and won ($371.20) with a straight, Nine to King
Seat 3: garougary folded before Flop (didn't bet)
Seat 4: mrienader folded before Flop (didn't bet)
Seat 5: king10clubs (button) showed [9h 4h] and lost with a pair of Nines
Seat 6: Blazterr (small blind) folded before Flop


PokerStars Game #102594010857:  Hold'em No Limit ($3/$6 USD) - 2013/08/11 2:47:59 ET
Table 'Klemola 40-100 bb' 6-max Seat #6 is the button
Seat 1: rusdronenv ($1115.39 in chips) 
Seat 3: garougary ($106.53 in chips) 
Seat 4: mrienader ($610.28 in chips) 
Seat 5: king10clubs ($600 in chips) 
Seat 6: Blazterr ($231 in chips) 
rusdronenv: posts small blind $3
garougary: posts big blind $6
*** HOLE CARDS ***
mrienader: folds 
king10clubs: folds 
Blazterr: raises $6 to $12
rusdronenv: folds 
garougary: calls $6
*** FLOP *** [Qs 9s Qd]
garougary: checks 
Blazterr: bets $15.46
garougary: folds 
Uncalled bet ($15.46) returned to Blazterr
Blazterr collected $25.78 from pot
Blazterr: doesn't show hand 
*** SUMMARY ***
Total pot $27 | Rake $1.22 
Board [Qs 9s Qd]
Seat 1: rusdronenv (small blind) folded before Flop
Seat 3: garougary (big blind) folded on the Flop
Seat 4: mrienader folded before Flop (didn't bet)
Seat 5: king10clubs folded before Flop (didn't bet)
Seat 6: Blazterr (button) collected ($25.78)


PokerStars Game #102594024208:  Hold'em No Limit ($3/$6 USD) - 2013/08/11 2:48:52 ET
Table 'Klemola 40-100 bb' 6-max Seat #1 is the button
Seat 1: rusdronenv ($1112.39 in chips) 
Seat 3: garougary ($94.53 in chips) 
Seat 4: mrienader ($610.28 in chips) 
Seat 5: king10clubs ($600 in chips) 
Seat 6: Blazterr ($244.78 in chips) 
garougary: posts small blind $3
mrienader: posts big blind $6
*** HOLE CARDS ***
king10clubs: folds 
Blazterr: folds 
rusdronenv: folds 
garougary: folds 
Uncalled bet ($3) returned to mrienader
mrienader collected $6 from pot
mrienader: doesn't show hand 
*** SUMMARY ***
Total pot $6 | Rake $0 
Seat 1: rusdronenv (button) folded before Flop (didn't bet)
Seat 3: garougary (small blind) folded before Flop
Seat 4: mrienader (big blind) collected ($6)
Seat 5: king10clubs folded before Flop (didn't bet)
Seat 6: Blazterr folded before Flop (didn't bet)


PokerStars Game #102594030227:  Hold'em No Limit ($3/$6 USD) - 2013/08/11 2:49:16 ET
Table 'Klemola 40-100 bb' 6-max Seat #3 is the button
Seat 1: rusdronenv ($1112.39 in chips) 
Seat 3: garougary ($91.53 in chips) 
Seat 4: mrienader ($613.28 in chips) 
Seat 5: king10clubs ($600 in chips) 
Seat 6: Blazterr ($244.78 in chips) 
mrienader: posts small blind $3
king10clubs: posts big blind $6
*** HOLE CARDS ***
Blazterr: folds 
rusdronenv: raises $12 to $18
garougary: folds 
mrienader: folds 
king10clubs: folds 
Uncalled bet ($12) returned to rusdronenv
rusdronenv collected $15 from pot
rusdronenv: doesn't show hand 
*** SUMMARY ***
Total pot $15 | Rake $0 
Seat 1: rusdronenv collected ($15)
Seat 3: garougary (button) folded before Flop (didn't bet)
Seat 4: mrienader (small blind) folded before Flop
Seat 5: king10clubs (big blind) folded before Flop
Seat 6: Blazterr folded before Flop (didn't bet)


PokerStars Game #102594034656:  Hold'em No Limit ($3/$6 USD) - 2013/08/11 2:49:34 ET
Table 'Klemola 40-100 bb' 6-max Seat #4 is the button
Seat 1: rusdronenv ($1121.39 in chips) 
Seat 3: garougary ($91.53 in chips) 
Seat 4: mrienader ($610.28 in chips) 
Seat 5: king10clubs ($600 in chips) 
Seat 6: Blazterr ($244.78 in chips) 
king10clubs: posts small blind $3
Blazterr: posts big blind $6
*** HOLE CARDS ***
rusdronenv: folds 
garougary: folds 
mrienader: folds 
king10clubs: folds 
Uncalled bet ($3) returned to Blazterr
Blazterr collected $6 from pot
Blazterr: doesn't show hand 
*** SUMMARY ***
Total pot $6 | Rake $0 
Seat 1: rusdronenv folded before Flop (didn't bet)
Seat 3: garougary folded before Flop (didn't bet)
Seat 4: mrienader (button) folded before Flop (didn't bet)
Seat 5: king10clubs (small blind) folded before Flop
Seat 6: Blazterr (big blind) collected ($6)


PokerStars Game #102594040062:  Hold'em No Limit ($3/$6 USD) - 2013/08/11 2:49:55 ET
Table 'Klemola 40-100 bb' 6-max Seat #5 is the button
Seat 1: rusdronenv ($1121.39 in chips) 
Seat 3: garougary ($91.53 in chips) 
Seat 4: mrienader ($610.28 in chips) 
Seat 5: king10clubs ($600 in chips) 
Seat 6: Blazterr ($247.78 in chips) 
Blazterr: posts small blind $3
rusdronenv: posts big blind $6
*** HOLE CARDS ***
garougary: folds 
mrienader: folds 
king10clubs: raises $6 to $12
Blazterr: folds 
rusdronenv: calls $6
*** FLOP *** [8h 9d 2c]
rusdronenv: checks 
king10clubs: checks 
*** TURN *** [8h 9d 2c] [5d]
rusdronenv: bets $18
king10clubs: calls $18
*** RIVER *** [8h 9d 2c 5d] [8s]
rusdronenv: checks 
king10clubs: checks 
*** SHOW DOWN ***
rusdronenv: shows [7d Qd] (a pair of Eights)
king10clubs: mucks hand 
rusdronenv collected $60.20 from pot
*** SUMMARY ***
Total pot $63 | Rake $2.80 
Board [8h 9d 2c 5d 8s]
Seat 1: rusdronenv (big blind) showed [7d Qd] and won ($60.20) with a pair of Eights
Seat 3: garougary folded before Flop (didn't bet)
Seat 4: mrienader folded before Flop (didn't bet)
Seat 5: king10clubs (button) mucked
Seat 6: Blazterr (small blind) folded before Flop


PokerStars Game #102593893975:  Hold'em No Limit ($3/$6 USD) - 2013/08/11 2:40:00 ET
Table 'Klemola 40-100 bb' 6-max Seat #5 is the button
Seat 1: rusdronenv ($1020.80 in chips) 
Seat 2: Taimuraz63 ($410.49 in chips) 
Seat 3: garougary ($55.61 in chips) 
Seat 4: onez69 ($583.02 in chips) 
Seat 5: king10clubs ($600 in chips) 
Seat 6: mustanggino ($450 in chips) 
mustanggino: posts small blind $3
rusdronenv: posts big blind $6
*** HOLE CARDS ***
Taimuraz63: folds 
garougary: folds 
onez69: folds 
king10clubs: raises $6 to $12
mustanggino: folds 
rusdronenv: raises $36 to $48
king10clubs: folds 
Uncalled bet ($36) returned to rusdronenv
rusdronenv collected $27 from pot
rusdronenv: doesn't show hand 
*** SUMMARY ***
Total pot $27 | Rake $0 
Seat 1: rusdronenv (big blind) collected ($27)
Seat 2: Taimuraz63 folded before Flop (didn't bet)
Seat 3: garougary folded before Flop (didn't bet)
Seat 4: onez69 folded before Flop (didn't bet)
Seat 5: king10clubs (button) folded before Flop
Seat 6: mustanggino (small blind) folded before Flop


PokerStars Game #102593900835:  Hold'em No Limit ($3/$6 USD) - 2013/08/11 2:40:29 ET
Table 'Klemola 40-100 bb' 6-max Seat #6 is the button
Seat 1: rusdronenv ($1035.80 in chips) 
Seat 2: Taimuraz63 ($410.49 in chips) 
Seat 3: garougary ($55.61 in chips) 
Seat 4: onez69 ($583.02 in chips) 
Seat 5: king10clubs ($600 in chips) 
Seat 6: mustanggino ($450 in chips) 
rusdronenv: posts small blind $3
Taimuraz63: posts big blind $6
*** HOLE CARDS ***
garougary: folds 
onez69: folds 
king10clubs: folds 
mustanggino: raises $6 to $12
rusdronenv: folds 
Taimuraz63: calls $6
*** FLOP *** [9s 3c Kd]
Taimuraz63: checks 
mustanggino: bets $12
Taimuraz63: folds 
Uncalled bet ($12) returned to mustanggino
mustanggino collected $25.78 from pot
mustanggino: doesn't show hand 
*** SUMMARY ***
Total pot $27 | Rake $1.22 
Board [9s 3c Kd]
Seat 1: rusdronenv (small blind) folded before Flop
Seat 2: Taimuraz63 (big blind) folded on the Flop
Seat 3: garougary folded before Flop (didn't bet)
Seat 4: onez69 folded before Flop (didn't bet)
Seat 5: king10clubs folded before Flop (didn't bet)
Seat 6: mustanggino (button) collected ($25.78)


PokerStars Game #102593912310:  Hold'em No Limit ($3/$6 USD) - 2013/08/11 2:41:17 ET
Table 'Klemola 40-100 bb' 6-max Seat #1 is the button
Seat 1: rusdronenv ($1032.80 in chips) 
Seat 2: Taimuraz63 ($398.49 in chips) 
Seat 3: garougary ($55.61 in chips) 
Seat 4: onez69 ($583.02 in chips) 
Seat 5: king10clubs ($600 in chips) 
Seat 6: mustanggino ($463.78 in chips) 
Taimuraz63: posts small blind $3
garougary: posts big blind $6
*** HOLE CARDS ***
onez69: folds 
king10clubs: raises $9 to $15
mustanggino: folds 
rusdronenv: folds 
Taimuraz63: calls $12
garougary: folds 
*** FLOP *** [9h 8c 5h]
Taimuraz63: checks 
king10clubs: checks 
*** TURN *** [9h 8c 5h] [5d]
Taimuraz63: bets $18
king10clubs: folds 
Uncalled bet ($18) returned to Taimuraz63
Taimuraz63 collected $34.38 from pot
*** SUMMARY ***
Total pot $36 | Rake $1.62 
Board [9h 8c 5h 5d]
Seat 1: rusdronenv (button) folded before Flop (didn't bet)
Seat 2: Taimuraz63 (small blind) collected ($34.38)
Seat 3: garougary (big blind) folded before Flop
Seat 4: onez69 folded before Flop (didn't bet)
Seat 5: king10clubs folded on the Turn
Seat 6: mustanggino folded before Flop (didn't bet)


PokerStars Game #102593925559:  Hold'em No Limit ($3/$6 USD) - 2013/08/11 2:42:12 ET
Table 'Klemola 40-100 bb' 6-max Seat #2 is the button
Seat 1: rusdronenv ($1032.80 in chips) 
Seat 2: Taimuraz63 ($417.87 in chips) 
Seat 3: garougary ($49.61 in chips) 
Seat 5: king10clubs ($600 in chips) 
Seat 6: mustanggino ($463.78 in chips) 
garougary: posts small blind $3
onez69: is sitting out 
king10clubs: posts big blind $6
*** HOLE CARDS ***
mustanggino: folds 
rusdronenv: raises $12 to $18
Taimuraz63: folds 
garougary: raises $31.61 to $49.61 and is all-in
king10clubs: folds 
rusdronenv: calls $31.61
*** FLOP *** [Ac 4s 7h]
*** TURN *** [Ac 4s 7h] [5d]
*** RIVER *** [Ac 4s 7h 5d] [Kh]
*** SHOW DOWN ***
garougary: shows [As Jh] (a pair of Aces)
rusdronenv: mucks hand 
garougary collected $102.42 from pot
*** SUMMARY ***
Total pot $105.22 | Rake $2.80 
Board [Ac 4s 7h 5d Kh]
Seat 1: rusdronenv mucked
Seat 2: Taimuraz63 (button) folded before Flop (didn't bet)
Seat 3: garougary (small blind) showed [As Jh] and won ($102.42) with a pair of Aces
Seat 5: king10clubs (big blind) folded before Flop
Seat 6: mustanggino folded before Flop (didn't bet)


PokerStars Game #102593933156:  Hold'em No Limit ($3/$6 USD) - 2013/08/11 2:42:43 ET
Table 'Klemola 40-100 bb' 6-max Seat #3 is the button
Seat 1: rusdronenv ($983.19 in chips) 
Seat 2: Taimuraz63 ($417.87 in chips) 
Seat 3: garougary ($102.42 in chips) 
Seat 5: king10clubs ($600 in chips) 
king10clubs: posts small blind $3
mustanggino: is sitting out 
rusdronenv: posts big blind $6
*** HOLE CARDS ***
Taimuraz63: folds 
garougary: folds 
king10clubs: raises $9 to $15
mustanggino leaves the table
rusdronenv: calls $9
*** FLOP *** [Qd 2s Qs]
Blazterr joins the table at seat #6 
onez69 leaves the table
king10clubs: bets $17.50
rusdronenv: calls $17.50
*** TURN *** [Qd 2s Qs] [9s]
king10clubs: bets $42
rusdronenv: folds 
Uncalled bet ($42) returned to king10clubs
king10clubs collected $63.50 from pot
king10clubs: doesn't show hand 
*** SUMMARY ***
Total pot $65 | Rake $1.50 
Board [Qd 2s Qs 9s]
Seat 1: rusdronenv (big blind) folded on the Turn
Seat 2: Taimuraz63 folded before Flop (didn't bet)
Seat 3: garougary (button) folded before Flop (didn't bet)
Seat 5: king10clubs (small blind) collected ($63.50)


PokerStars Game #102593948505:  Hold'em No Limit ($3/$6 USD) - 2013/08/11 2:43:46 ET
Table 'Klemola 40-100 bb' 6-max Seat #5 is the button
Seat 1: rusdronenv ($950.69 in chips) 
Seat 2: Taimuraz63 ($417.87 in chips) 
Seat 3: garougary ($102.42 in chips) 
Seat 5: king10clubs ($631 in chips) 
Blazterr will be allowed to play after the button
rusdronenv: posts small blind $3
Taimuraz63: posts big blind $6
*** HOLE CARDS ***
garougary: folds 
king10clubs: raises $6 to $12
rusdronenv: folds 
Taimuraz63: calls $6
*** FLOP *** [Ad 8s 6d]
Taimuraz63: checks 
king10clubs: bets $18
mrienader joins the table at seat #4 
Taimuraz63: folds 
Uncalled bet ($18) returned to king10clubs
king10clubs collected $25.78 from pot
king10clubs: doesn't show hand 
*** SUMMARY ***
Total pot $27 | Rake $1.22 
Board [Ad 8s 6d]
Seat 1: rusdronenv (small blind) folded before Flop
Seat 2: Taimuraz63 (big blind) folded on the Flop
Seat 3: garougary folded before Flop (didn't bet)
Seat 5: king10clubs (button) collected ($25.78)


PokerStars Game #102593957622:  Hold'em No Limit ($3/$6 USD) - 2013/08/11 2:44:24 ET
Table 'Klemola 40-100 bb' 6-max Seat #1 is the button
Seat 1: rusdronenv ($947.69 in chips) 
Seat 2: Taimuraz63 ($405.87 in chips) 
Seat 3: garougary ($102.42 in chips) 
Seat 5: king10clubs ($644.78 in chips) 
Taimuraz63: posts small blind $3
garougary: posts big blind $6
mrienader: sits out 
Blazterr: sits out 
*** HOLE CARDS ***
king10clubs: raises $6 to $12
rusdronenv: folds 
Taimuraz63: folds 
garougary: folds 
Uncalled bet ($6) returned to king10clubs
king10clubs collected $15 from pot
king10clubs: doesn't show hand 
*** SUMMARY ***
Total pot $15 | Rake $0 
Seat 1: rusdronenv (button) folded before Flop (didn't bet)
Seat 2: Taimuraz63 (small blind) folded before Flop
Seat 3: garougary (big blind) folded before Flop
Seat 5: king10clubs collected ($15)


PokerStars Game #102593826629:  Hold'em No Limit ($3/$6 USD) - 2013/08/11 2:35:18 ET
Table 'Klemola 40-100 bb' 6-max Seat #3 is the button
Seat 1: rusdronenv ($900.60 in chips) 
Seat 2: Taimuraz63 ($396.71 in chips) 
Seat 3: garougary ($55.61 in chips) 
Seat 4: onez69 ($586.02 in chips) 
Seat 5: king10clubs ($600.10 in chips) 
Seat 6: mustanggino ($549 in chips) 
onez69: posts small blind $3
king10clubs: posts big blind $6
*** HOLE CARDS ***
mustanggino: folds 
rusdronenv: folds 
Taimuraz63: raises $6 to $12
garougary: folds 
onez69: folds 
king10clubs: calls $6
*** FLOP *** [Jc Jh 6h]
king10clubs: checks 
Taimuraz63: checks 
*** TURN *** [Jc Jh 6h] [Qh]
king10clubs: checks 
Taimuraz63: checks 
*** RIVER *** [Jc Jh 6h Qh] [7h]
king10clubs: checks 
Taimuraz63: checks 
*** SHOW DOWN ***
king10clubs: shows [5s 3s] (a pair of Jacks)
Taimuraz63: shows [4d As] (a pair of Jacks - Ace kicker)
Taimuraz63 collected $25.78 from pot
*** SUMMARY ***
Total pot $27 | Rake $1.22 
Board [Jc Jh 6h Qh 7h]
Seat 1: rusdronenv folded before Flop (didn't bet)
Seat 2: Taimuraz63 showed [4d As] and won ($25.78) with a pair of Jacks
Seat 3: garougary (button) folded before Flop (didn't bet)
Seat 4: onez69 (small blind) folded before Flop
Seat 5: king10clubs (big blind) showed [5s 3s] and lost with a pair of Jacks
Seat 6: mustanggino folded before Flop (didn't bet)


PokerStars Game #102593839058:  Hold'em No Limit ($3/$6 USD) - 2013/08/11 2:36:10 ET
Table 'Klemola 40-100 bb' 6-max Seat #4 is the button
Seat 1: rusdronenv ($900.60 in chips) 
Seat 2: Taimuraz63 ($410.49 in chips) 
Seat 3: garougary ($55.61 in chips) 
Seat 4: onez69 ($583.02 in chips) 
Seat 5: king10clubs ($600 in chips) 
Seat 6: mustanggino ($549 in chips) 
king10clubs: posts small blind $3
mustanggino: posts big blind $6
*** HOLE CARDS ***
rusdronenv: raises $12 to $18
Taimuraz63: folds 
garougary: folds 
onez69: folds 
king10clubs: folds 
mustanggino: calls $12
*** FLOP *** [7s 4h Ks]
mustanggino: checks 
rusdronenv: bets $30
mustanggino: calls $30
*** TURN *** [7s 4h Ks] [Kc]
mustanggino: checks 
rusdronenv: bets $72
mustanggino: calls $72
*** RIVER *** [7s 4h Ks Kc] [9d]
mustanggino: checks 
rusdronenv: bets $180
mustanggino has timed out
mustanggino: folds 
Uncalled bet ($180) returned to rusdronenv
rusdronenv collected $240.20 from pot
rusdronenv: doesn't show hand 
*** SUMMARY ***
Total pot $243 | Rake $2.80 
Board [7s 4h Ks Kc 9d]
Seat 1: rusdronenv collected ($240.20)
Seat 2: Taimuraz63 folded before Flop (didn't bet)
Seat 3: garougary folded before Flop (didn't bet)
Seat 4: onez69 (button) folded before Flop (didn't bet)
Seat 5: king10clubs (small blind) folded before Flop
Seat 6: mustanggino (big blind) folded on the River


PokerStars Game #102594051978:  Hold'em No Limit ($3/$6 USD) - 2013/08/11 2:50:43 ET
Table 'Klemola 40-100 bb' 6-max Seat #6 is the button
Seat 1: rusdronenv ($1151.59 in chips) 
Seat 4: mrienader ($610.28 in chips) 
Seat 5: king10clubs ($600 in chips) 
Seat 6: Blazterr ($244.78 in chips) 
rusdronenv: posts small blind $3
garougary is disconnected 
garougary has timed out while disconnected
garougary: is sitting out 
mrienader: posts big blind $6
*** HOLE CARDS ***
king10clubs: folds 
Blazterr: raises $6 to $12
rusdronenv: folds 
mrienader: folds 
Uncalled bet ($6) returned to Blazterr
Blazterr collected $15 from pot
Blazterr: doesn't show hand 
*** SUMMARY ***
Total pot $15 | Rake $0 
Seat 1: rusdronenv (small blind) folded before Flop
Seat 4: mrienader (big blind) folded before Flop
Seat 5: king10clubs folded before Flop (didn't bet)
Seat 6: Blazterr (button) collected ($15)


PokerStars Game #102594065853:  Hold'em No Limit ($3/$6 USD) - 2013/08/11 2:51:40 ET
Table 'Klemola 40-100 bb' 6-max Seat #1 is the button
Seat 1: rusdronenv ($1148.59 in chips) 
Seat 4: mrienader ($604.28 in chips) 
Seat 5: king10clubs ($600 in chips) 
Seat 6: Blazterr ($253.78 in chips) 
Taimuraz63 will be allowed to play after the button
mrienader: posts small blind $3
king10clubs: posts big blind $6
*** HOLE CARDS ***
Blazterr: folds 
rusdronenv: raises $12 to $18
mrienader: calls $15
king10clubs: calls $12
*** FLOP *** [9d Jc Qs]
mrienader: checks 
king10clubs: checks 
rusdronenv: bets $30
mrienader: raises $54 to $84
king10clubs: folds 
rusdronenv: folds 
Uncalled bet ($54) returned to mrienader
mrienader collected $112.50 from pot
mrienader: doesn't show hand 
*** SUMMARY ***
Total pot $114 | Rake $1.50 
Board [9d Jc Qs]
Seat 1: rusdronenv (button) folded on the Flop
Seat 4: mrienader (small blind) collected ($112.50)
Seat 5: king10clubs (big blind) folded on the Flop
Seat 6: Blazterr folded before Flop (didn't bet)


PokerStars Game #102594086369:  Hold'em No Limit ($3/$6 USD) - 2013/08/11 2:53:02 ET
Table 'Klemola 40-100 bb' 6-max Seat #4 is the button
Seat 1: rusdronenv ($1100.59 in chips) 
Seat 3: garougary ($91.53 in chips) 
Seat 4: mrienader ($668.78 in chips) 
Seat 5: king10clubs ($600 in chips) 
king10clubs: posts small blind $3
Blazterr: is sitting out 
rusdronenv: posts big blind $6
Taimuraz63: sits out 
garougary: posts small & big blinds $9
*** HOLE CARDS ***
garougary: raises $6 to $12
Blazterr leaves the table
mrienader: folds 
king10clubs: folds 
rusdronenv: calls $6
*** FLOP *** [4h Qc 9d]
rusdronenv: checks 
garougary: bets $6
rusdronenv: folds 
Uncalled bet ($6) returned to garougary
Naebushkin joins the table at seat #6 
garougary collected $28.65 from pot
garougary: doesn't show hand 
*** SUMMARY ***
Total pot $30 | Rake $1.35 
Board [4h Qc 9d]
Seat 1: rusdronenv (big blind) folded on the Flop
Seat 3: garougary collected ($28.65)
Seat 4: mrienader (button) folded before Flop (didn't bet)
Seat 5: king10clubs (small blind) folded before Flop


PokerStars Game #102594093121:  Hold'em No Limit ($3/$6 USD) - 2013/08/11 2:53:29 ET
Table 'Klemola 40-100 bb' 6-max Seat #5 is the button
Seat 1: rusdronenv ($1088.59 in chips) 
Seat 2: Taimuraz63 ($402.87 in chips) 
Seat 3: garougary ($105.18 in chips) 
Seat 4: mrienader ($668.78 in chips) 
Seat 5: king10clubs ($600 in chips) 
Naebushkin will be allowed to play after the button
rusdronenv: posts small blind $3
Taimuraz63: posts big blind $6
*** HOLE CARDS ***
garougary: folds 
mrienader: raises $12 to $18
king10clubs: folds 
rusdronenv: folds 
Taimuraz63: calls $12
*** FLOP *** [9h Kd 8d]
Taimuraz63: checks 
mrienader: bets $18
Taimuraz63: raises $30 to $48
mrienader: folds 
Uncalled bet ($30) returned to Taimuraz63
Taimuraz63 collected $72.20 from pot
*** SUMMARY ***
Total pot $75 | Rake $2.80 
Board [9h Kd 8d]
Seat 1: rusdronenv (small blind) folded before Flop
Seat 2: Taimuraz63 (big blind) collected ($72.20)
Seat 3: garougary folded before Flop (didn't bet)
Seat 4: mrienader folded on the Flop
Seat 5: king10clubs (button) folded before Flop (didn't bet)


PokerStars Game #102594103630:  Hold'em No Limit ($3/$6 USD) - 2013/08/11 2:54:11 ET
Table 'Klemola 40-100 bb' 6-max Seat #1 is the button
Seat 1: rusdronenv ($1085.59 in chips) 
Seat 2: Taimuraz63 ($439.07 in chips) 
Seat 3: garougary ($105.18 in chips) 
Seat 4: mrienader ($632.78 in chips) 
Seat 5: king10clubs ($600 in chips) 
Taimuraz63: posts small blind $3
garougary: posts big blind $6
Naebushkin: sits out 
*** HOLE CARDS ***
mrienader: folds 
king10clubs: folds 
rusdronenv: raises $12 to $18
Taimuraz63: folds 
garougary: folds 
Uncalled bet ($12) returned to rusdronenv
rusdronenv collected $15 from pot
rusdronenv: doesn't show hand 
*** SUMMARY ***
Total pot $15 | Rake $0 
Seat 1: rusdronenv (button) collected ($15)
Seat 2: Taimuraz63 (small blind) folded before Flop
Seat 3: garougary (big blind) folded before Flop
Seat 4: mrienader folded before Flop (didn't bet)
Seat 5: king10clubs folded before Flop (didn't bet)


PokerStars Game #102594111672:  Hold'em No Limit ($3/$6 USD) - 2013/08/11 2:54:43 ET
Table 'Klemola 40-100 bb' 6-max Seat #2 is the button
Seat 1: rusdronenv ($1094.59 in chips) 
Seat 2: Taimuraz63 ($436.07 in chips) 
Seat 3: garougary ($99.18 in chips) 
Seat 4: mrienader ($632.78 in chips) 
Seat 5: king10clubs ($600 in chips) 
garougary: posts small blind $3
mrienader: posts big blind $6
Naebushkin: sits out 
*** HOLE CARDS ***
king10clubs: folds 
rusdronenv: raises $12 to $18
Taimuraz63: calls $18
garougary: calls $15
mrienader: folds 
*** FLOP *** [4c 7d 6h]
garougary: checks 
rusdronenv: checks 
Taimuraz63: checks 
*** TURN *** [4c 7d 6h] [5c]
garougary: checks 
rusdronenv: checks 
Taimuraz63: checks 
*** RIVER *** [4c 7d 6h 5c] [7c]
garougary: checks 
rusdronenv: checks 
Taimuraz63: checks 
*** SHOW DOWN ***
garougary: shows [Qc Js] (a pair of Sevens)
rusdronenv: shows [Qs Kh] (a pair of Sevens - King kicker)
Taimuraz63: shows [2s 2d] (two pair, Sevens and Deuces)
Taimuraz63 collected $57.30 from pot
*** SUMMARY ***
Total pot $60 | Rake $2.70 
Board [4c 7d 6h 5c 7c]
Seat 1: rusdronenv showed [Qs Kh] and lost with a pair of Sevens
Seat 2: Taimuraz63 (button) showed [2s 2d] and won ($57.30) with two pair, Sevens and Deuces
Seat 3: garougary (small blind) showed [Qc Js] and lost with a pair of Sevens
Seat 4: mrienader (big blind) folded before Flop
Seat 5: king10clubs folded before Flop (didn't bet)


PokerStars Game #102594350989:  Hold'em No Limit ($3/$6 USD) - 2013/08/11 3:10:11 ET
Table 'Klemola 40-100 bb' 6-max Seat #5 is the button
Seat 1: rusdronenv ($1043.87 in chips) 
Seat 2: NutPopper ($256.50 in chips) 
Seat 3: garougary ($166.80 in chips) 
Seat 4: pacopil ($444.20 in chips) 
Seat 5: king10clubs ($662.22 in chips) 
vjxbkf will be allowed to play after the button
rusdronenv: posts small blind $3
NutPopper: posts big blind $6
*** HOLE CARDS ***
garougary: folds 
pacopil: raises $9 to $15
king10clubs: raises $31 to $46
rusdronenv: folds 
NutPopper: folds 
pacopil: raises $35 to $81
king10clubs: raises $74.70 to $155.70
pacopil: calls $74.70
*** FLOP *** [7s 7c 8d]
pacopil: checks 
king10clubs: bets $75
pacopil: raises $213.50 to $288.50 and is all-in
king10clubs: calls $213.50
*** FIRST TURN *** [7s 7c 8d] [Ac]
*** FIRST RIVER *** [7s 7c 8d Ac] [9h]
*** SECOND TURN *** [7s 7c 8d] [Qd]
*** SECOND RIVER *** [7s 7c 8d Qd] [6h]
*** FIRST SHOW DOWN ***
pacopil: shows [Kc Kh] (two pair, Kings and Sevens)
king10clubs: shows [Ks Ah] (two pair, Aces and Sevens)
king10clubs collected $447.30 from pot
*** SECOND SHOW DOWN ***
pacopil: shows [Kc Kh] (two pair, Kings and Sevens)
king10clubs: shows [Ks Ah] (a pair of Sevens)
pacopil collected $447.30 from pot
*** SUMMARY ***
Total pot $897.40 | Rake $2.80 
Hand was run twice
FIRST Board [7s 7c 8d Ac 9h]
SECOND Board [7s 7c 8d Qd 6h]
Seat 1: rusdronenv (small blind) folded before Flop
Seat 2: NutPopper (big blind) folded before Flop
Seat 3: garougary folded before Flop (didn't bet)
Seat 4: pacopil showed [Kc Kh] and lost with two pair, Kings and Sevens, and won ($447.30) with two pair, Kings and Sevens
Seat 5: king10clubs (button) showed [Ks Ah] and won ($447.30) with two pair, Aces and Sevens, and lost with a pair of Sevens


PokerStars Game #102594388018:  Hold'em No Limit ($3/$6 USD) - 2013/08/11 3:12:15 ET
Table 'Klemola 40-100 bb' 6-max Seat #1 is the button
Seat 1: rusdronenv ($1040.87 in chips) 
Seat 2: NutPopper ($250.50 in chips) 
Seat 3: garougary ($166.80 in chips) 
Seat 4: pacopil ($447.30 in chips) 
Seat 5: king10clubs ($665.32 in chips) 
NutPopper: posts small blind $3
garougary: posts big blind $6
vjxbkf: sits out 
*** HOLE CARDS ***
pacopil: folds 
king10clubs: folds 
rusdronenv: raises $6 to $12
NutPopper: folds 
garougary: calls $6
*** FLOP *** [5c Ks Qd]
garougary: checks 
rusdronenv: checks 
*** TURN *** [5c Ks Qd] [Jh]
garougary: checks 
rusdronenv: checks 
*** RIVER *** [5c Ks Qd Jh] [4h]
garougary: checks 
rusdronenv: checks 
*** SHOW DOWN ***
garougary: shows [Th Qc] (a pair of Queens)
rusdronenv: mucks hand 
garougary collected $25.78 from pot
*** SUMMARY ***
Total pot $27 | Rake $1.22 
Board [5c Ks Qd Jh 4h]
Seat 1: rusdronenv (button) mucked
Seat 2: NutPopper (small blind) folded before Flop
Seat 3: garougary (big blind) showed [Th Qc] and won ($25.78) with a pair of Queens
Seat 4: pacopil folded before Flop (didn't bet)
Seat 5: king10clubs folded before Flop (didn't bet)


PokerStars Game #102594401812:  Hold'em No Limit ($3/$6 USD) - 2013/08/11 3:13:01 ET
Table 'Klemola 40-100 bb' 6-max Seat #2 is the button
Seat 1: rusdronenv ($1028.87 in chips) 
Seat 2: NutPopper ($247.50 in chips) 
Seat 3: garougary ($180.58 in chips) 
Seat 5: king10clubs ($665.32 in chips) 
garougary: posts small blind $3
pacopil: is sitting out 
king10clubs: posts big blind $6
vjxbkf: sits out 
*** HOLE CARDS ***
pacopil leaves the table
rusdronenv: folds 
NutPopper: raises $6 to $12
garougary: folds 
mustanggino joins the table at seat #4 
king10clubs: calls $6
*** FLOP *** [2h Kc Qc]
king10clubs: checks 
NutPopper: bets $18
king10clubs: calls $18
*** TURN *** [2h Kc Qc] [3s]
king10clubs: checks 
NutPopper: checks 
*** RIVER *** [2h Kc Qc 3s] [5d]
king10clubs: checks 
NutPopper: checks 
*** SHOW DOWN ***
king10clubs: shows [Ts Qd] (a pair of Queens)
NutPopper: mucks hand 
king10clubs collected $61.50 from pot
*** SUMMARY ***
Total pot $63 | Rake $1.50 
Board [2h Kc Qc 3s 5d]
Seat 1: rusdronenv folded before Flop (didn't bet)
Seat 2: NutPopper (button) mucked
Seat 3: garougary (small blind) folded before Flop
Seat 5: king10clubs (big blind) showed [Ts Qd] and won ($61.50) with a pair of Queens


PokerStars Game #102594425499:  Hold'em No Limit ($3/$6 USD) - 2013/08/11 3:14:20 ET
Table 'Klemola 40-100 bb' 6-max Seat #3 is the button
Seat 1: rusdronenv ($1028.87 in chips) 
Seat 2: NutPopper ($217.50 in chips) 
Seat 3: garougary ($177.58 in chips) 
Seat 5: king10clubs ($696.82 in chips) 
Seat 6: vjxbkf ($600 in chips) 
mustanggino will be allowed to play after the button
king10clubs: posts small blind $3
vjxbkf: posts big blind $6
*** HOLE CARDS ***
rusdronenv: raises $12 to $18
NutPopper: folds 
garougary: folds 
king10clubs: calls $15
vjxbkf: folds 
*** FLOP *** [9d Jd 2h]
king10clubs: checks 
rusdronenv: checks 
*** TURN *** [9d Jd 2h] [Qc]
king10clubs: checks 
rusdronenv: checks 
*** RIVER *** [9d Jd 2h Qc] [Kc]
king10clubs: bets $26
rusdronenv: calls $26
*** SHOW DOWN ***
king10clubs: shows [9h 9s] (three of a kind, Nines)
rusdronenv: mucks hand 
king10clubs collected $91.20 from pot
*** SUMMARY ***
Total pot $94 | Rake $2.80 
Board [9d Jd 2h Qc Kc]
Seat 1: rusdronenv mucked
Seat 2: NutPopper folded before Flop (didn't bet)
Seat 3: garougary (button) folded before Flop (didn't bet)
Seat 5: king10clubs (small blind) showed [9h 9s] and won ($91.20) with three of a kind, Nines
Seat 6: vjxbkf (big blind) folded before Flop


PokerStars Game #102594265934:  Hold'em No Limit ($3/$6 USD) - 2013/08/11 3:05:19 ET
Table 'Klemola 40-100 bb' 6-max Seat #2 is the button
Seat 1: rusdronenv ($1009.37 in chips) 
Seat 2: Taimuraz63 ($472.77 in chips) 
Seat 3: garougary ($147.56 in chips) 
Seat 4: pacopil ($240 in chips) 
Seat 5: king10clubs ($668.22 in chips) 
Seat 6: Naebushkin ($1262.07 in chips) 
garougary: posts small blind $3
pacopil: posts big blind $6
*** HOLE CARDS ***
king10clubs: raises $12 to $18
Naebushkin: folds 
rusdronenv: folds 
Taimuraz63: folds 
garougary: folds 
pacopil: folds 
Uncalled bet ($12) returned to king10clubs
king10clubs collected $15 from pot
king10clubs: doesn't show hand 
*** SUMMARY ***
Total pot $15 | Rake $0 
Seat 1: rusdronenv folded before Flop (didn't bet)
Seat 2: Taimuraz63 (button) folded before Flop (didn't bet)
Seat 3: garougary (small blind) folded before Flop
Seat 4: pacopil (big blind) folded before Flop
Seat 5: king10clubs collected ($15)
Seat 6: Naebushkin folded before Flop (didn't bet)


PokerStars Game #102594274478:  Hold'em No Limit ($3/$6 USD) - 2013/08/11 3:05:48 ET
Table 'Klemola 40-100 bb' 6-max Seat #3 is the button
Seat 1: rusdronenv ($1009.37 in chips) 
Seat 2: Taimuraz63 ($472.77 in chips) 
Seat 3: garougary ($144.56 in chips) 
Seat 4: pacopil ($240 in chips) 
Seat 5: king10clubs ($677.22 in chips) 
Seat 6: Naebushkin ($1262.07 in chips) 
pacopil: posts small blind $3
king10clubs: posts big blind $6
*** HOLE CARDS ***
Naebushkin: folds 
rusdronenv: folds 
Taimuraz63: raises $6 to $12
garougary: calls $12
pacopil: folds 
king10clubs: calls $6
*** FLOP *** [Jh Ac 7s]
king10clubs: checks 
Taimuraz63: checks 
garougary: checks 
*** TURN *** [Jh Ac 7s] [Kd]
king10clubs: checks 
Taimuraz63: checks 
garougary: bets $12
king10clubs: folds 
Taimuraz63: folds 
Uncalled bet ($12) returned to garougary
garougary collected $37.24 from pot
garougary: doesn't show hand 
*** SUMMARY ***
Total pot $39 | Rake $1.76 
Board [Jh Ac 7s Kd]
Seat 1: rusdronenv folded before Flop (didn't bet)
Seat 2: Taimuraz63 folded on the Turn
Seat 3: garougary (button) collected ($37.24)
Seat 4: pacopil (small blind) folded before Flop
Seat 5: king10clubs (big blind) folded on the Turn
Seat 6: Naebushkin folded before Flop (didn't bet)


PokerStars Game #102594289613:  Hold'em No Limit ($3/$6 USD) - 2013/08/11 3:06:41 ET
Table 'Klemola 40-100 bb' 6-max Seat #4 is the button
Seat 1: rusdronenv ($1009.37 in chips) 
Seat 2: Taimuraz63 ($460.77 in chips) 
Seat 3: garougary ($169.80 in chips) 
Seat 4: pacopil ($240 in chips) 
Seat 5: king10clubs ($665.22 in chips) 
Seat 6: Naebushkin ($1262.07 in chips) 
king10clubs: posts small blind $3
Naebushkin: posts big blind $6
*** HOLE CARDS ***
rusdronenv: folds 
Taimuraz63: raises $6 to $12
garougary: folds 
pacopil: raises $26 to $38
king10clubs: folds 
Naebushkin: folds 
Taimuraz63: calls $26
*** FLOP *** [9s Jc 8h]
Taimuraz63: checks 
pacopil: bets $57
Taimuraz63: raises $153 to $210
pacopil: calls $145 and is all-in
Uncalled bet ($8) returned to Taimuraz63
*** TURN *** [9s Jc 8h] [Qd]
*** RIVER *** [9s Jc 8h Qd] [9c]
*** SHOW DOWN ***
Taimuraz63: shows [Ah Jh] (two pair, Jacks and Nines)
pacopil: shows [Kh Kd] (two pair, Kings and Nines)
pacopil collected $486.20 from pot
*** SUMMARY ***
Total pot $489 | Rake $2.80 
Board [9s Jc 8h Qd 9c]
Seat 1: rusdronenv folded before Flop (didn't bet)
Seat 2: Taimuraz63 showed [Ah Jh] and lost with two pair, Jacks and Nines
Seat 3: garougary folded before Flop (didn't bet)
Seat 4: pacopil (button) showed [Kh Kd] and won ($486.20) with two pair, Kings and Nines
Seat 5: king10clubs (small blind) folded before Flop
Seat 6: Naebushkin (big blind) folded before Flop


PokerStars Game #102594310211:  Hold'em No Limit ($3/$6 USD) - 2013/08/11 3:07:53 ET
Table 'Klemola 40-100 bb' 6-max Seat #5 is the button
Seat 1: rusdronenv ($1009.37 in chips) 
Seat 2: Taimuraz63 ($220.77 in chips) 
Seat 3: garougary ($169.80 in chips) 
Seat 4: pacopil ($486.20 in chips) 
Seat 5: king10clubs ($662.22 in chips) 
Seat 6: Naebushkin ($1256.07 in chips) 
Naebushkin: posts small blind $3
rusdronenv: posts big blind $6
*** HOLE CARDS ***
Taimuraz63: raises $6 to $12
garougary: folds 
pacopil: folds 
king10clubs: folds 
Naebushkin: folds 
rusdronenv: folds 
Uncalled bet ($6) returned to Taimuraz63
Taimuraz63 collected $15 from pot
*** SUMMARY ***
Total pot $15 | Rake $0 
Seat 1: rusdronenv (big blind) folded before Flop
Seat 2: Taimuraz63 collected ($15)
Seat 3: garougary folded before Flop (didn't bet)
Seat 4: pacopil folded before Flop (didn't bet)
Seat 5: king10clubs (button) folded before Flop (didn't bet)
Seat 6: Naebushkin (small blind) folded before Flop


PokerStars Game #102594317706:  Hold'em No Limit ($3/$6 USD) - 2013/08/11 3:08:18 ET
Table 'Klemola 40-100 bb' 6-max Seat #6 is the button
Seat 1: rusdronenv ($1003.37 in chips) 
Seat 2: Taimuraz63 ($229.77 in chips) 
Seat 3: garougary ($169.80 in chips) 
Seat 4: pacopil ($486.20 in chips) 
Seat 5: king10clubs ($662.22 in chips) 
Seat 6: Naebushkin ($1253.07 in chips) 
rusdronenv: posts small blind $3
Taimuraz63: posts big blind $6
*** HOLE CARDS ***
garougary: folds 
pacopil: folds 
king10clubs: raises $9 to $15
Naebushkin: folds 
rusdronenv: folds 
Taimuraz63: folds 
Uncalled bet ($9) returned to king10clubs
Taimuraz63 leaves the table
king10clubs collected $15 from pot
king10clubs: doesn't show hand 
*** SUMMARY ***
Total pot $15 | Rake $0 
Seat 1: rusdronenv (small blind) folded before Flop
Seat 2: Taimuraz63 (big blind) folded before Flop
Seat 3: garougary folded before Flop (didn't bet)
Seat 4: pacopil folded before Flop (didn't bet)
Seat 5: king10clubs collected ($15)
Seat 6: Naebushkin (button) folded before Flop (didn't bet)


PokerStars Game #102594325601:  Hold'em No Limit ($3/$6 USD) - 2013/08/11 3:08:45 ET
Table 'Klemola 40-100 bb' 6-max Seat #1 is the button
Seat 1: rusdronenv ($1000.37 in chips) 
Seat 3: garougary ($169.80 in chips) 
Seat 4: pacopil ($486.20 in chips) 
Seat 5: king10clubs ($671.22 in chips) 
Seat 6: Naebushkin ($1253.07 in chips) 
garougary: posts small blind $3
pacopil: posts big blind $6
*** HOLE CARDS ***
king10clubs: folds 
Naebushkin: folds 
rusdronenv: raises $12 to $18
JulyShort joins the table at seat #2 
JulyShort leaves the table
garougary: folds 
pacopil: folds 
Uncalled bet ($12) returned to rusdronenv
rusdronenv collected $15 from pot
rusdronenv: doesn't show hand 
*** SUMMARY ***
Total pot $15 | Rake $0 
Seat 1: rusdronenv (button) collected ($15)
Seat 3: garougary (small blind) folded before Flop
Seat 4: pacopil (big blind) folded before Flop
Seat 5: king10clubs folded before Flop (didn't bet)
Seat 6: Naebushkin folded before Flop (didn't bet)


PokerStars Game #102594331256:  Hold'em No Limit ($3/$6 USD) - 2013/08/11 3:09:05 ET
Table 'Klemola 40-100 bb' 6-max Seat #3 is the button
Seat 1: rusdronenv ($1009.37 in chips) 
Seat 3: garougary ($166.80 in chips) 
Seat 4: pacopil ($480.20 in chips) 
Seat 5: king10clubs ($671.22 in chips) 
Seat 6: Naebushkin ($1253.07 in chips) 
pacopil: posts small blind $3
king10clubs: posts big blind $6
*** HOLE CARDS ***
NutPopper joins the table at seat #2 
Naebushkin: raises $12 to $18
rusdronenv: folds 
garougary: folds 
pacopil: folds 
king10clubs: folds 
Uncalled bet ($12) returned to Naebushkin
Naebushkin collected $15 from pot
Naebushkin: doesn't show hand 
*** SUMMARY ***
Total pot $15 | Rake $0 
Seat 1: rusdronenv folded before Flop (didn't bet)
Seat 3: garougary (button) folded before Flop (didn't bet)
Seat 4: pacopil (small blind) folded before Flop
Seat 5: king10clubs (big blind) folded before Flop
Seat 6: Naebushkin collected ($15)


PokerStars Game #102594337102:  Hold'em No Limit ($3/$6 USD) - 2013/08/11 3:09:24 ET
Table 'Klemola 40-100 bb' 6-max Seat #4 is the button
Seat 1: rusdronenv ($1009.37 in chips) 
Seat 3: garougary ($166.80 in chips) 
Seat 4: pacopil ($477.20 in chips) 
Seat 5: king10clubs ($665.22 in chips) 
king10clubs: posts small blind $3
Naebushkin: is sitting out 
rusdronenv: posts big blind $6
NutPopper: sits out 
*** HOLE CARDS ***
garougary: folds 
Naebushkin leaves the table
pacopil: raises $9 to $15
vjxbkf joins the table at seat #6 
king10clubs: folds 
rusdronenv: calls $9
*** FLOP *** [5c Ks 7s]
rusdronenv: checks 
pacopil: bets $18
rusdronenv: raises $36 to $54
pacopil: folds 
Uncalled bet ($36) returned to rusdronenv
rusdronenv collected $67.50 from pot
rusdronenv: doesn't show hand 
*** SUMMARY ***
Total pot $69 | Rake $1.50 
Board [5c Ks 7s]
Seat 1: rusdronenv (big blind) collected ($67.50)
Seat 3: garougary folded before Flop (didn't bet)
Seat 4: pacopil (button) folded on the Flop
Seat 5: king10clubs (small blind) folded before Flop


PokerStars Game #102594123425:  Hold'em No Limit ($3/$6 USD) - 2013/08/11 2:55:35 ET
Table 'Klemola 40-100 bb' 6-max Seat #3 is the button
Seat 1: rusdronenv ($1076.59 in chips) 
Seat 2: Taimuraz63 ($475.37 in chips) 
Seat 3: garougary ($81.18 in chips) 
Seat 4: mrienader ($626.78 in chips) 
Seat 5: king10clubs ($600 in chips) 
mrienader: posts small blind $3
king10clubs: posts big blind $6
Naebushkin: sits out 
*** HOLE CARDS ***
rusdronenv: folds 
Taimuraz63: folds 
garougary: folds 
mrienader: folds 
Uncalled bet ($3) returned to king10clubs
king10clubs collected $6 from pot
king10clubs: doesn't show hand 
*** SUMMARY ***
Total pot $6 | Rake $0 
Seat 1: rusdronenv folded before Flop (didn't bet)
Seat 2: Taimuraz63 folded before Flop (didn't bet)
Seat 3: garougary (button) folded before Flop (didn't bet)
Seat 4: mrienader (small blind) folded before Flop
Seat 5: king10clubs (big blind) collected ($6)


PokerStars Game #102594125682:  Hold'em No Limit ($3/$6 USD) - 2013/08/11 2:55:46 ET
Table 'Klemola 40-100 bb' 6-max Seat #4 is the button
Seat 1: rusdronenv ($1076.59 in chips) 
Seat 2: Taimuraz63 ($475.37 in chips) 
Seat 3: garougary ($81.18 in chips) 
Seat 4: mrienader ($623.78 in chips) 
Seat 5: king10clubs ($603 in chips) 
Seat 6: Naebushkin ($1310.25 in chips) 
king10clubs: posts small blind $3
Naebushkin: posts big blind $6
*** HOLE CARDS ***
rusdronenv: folds 
Taimuraz63: folds 
garougary: folds 
mrienader: folds 
king10clubs: folds 
Uncalled bet ($3) returned to Naebushkin
Naebushkin collected $6 from pot
Naebushkin: doesn't show hand 
*** SUMMARY ***
Total pot $6 | Rake $0 
Seat 1: rusdronenv folded before Flop (didn't bet)
Seat 2: Taimuraz63 folded before Flop (didn't bet)
Seat 3: garougary folded before Flop (didn't bet)
Seat 4: mrienader (button) folded before Flop (didn't bet)
Seat 5: king10clubs (small blind) folded before Flop
Seat 6: Naebushkin (big blind) collected ($6)


PokerStars Game #102594129256:  Hold'em No Limit ($3/$6 USD) - 2013/08/11 2:56:03 ET
Table 'Klemola 40-100 bb' 6-max Seat #5 is the button
Seat 1: rusdronenv ($1076.59 in chips) 
Seat 2: Taimuraz63 ($475.37 in chips) 
Seat 3: garougary ($81.18 in chips) 
Seat 4: mrienader ($623.78 in chips) 
Seat 5: king10clubs ($600 in chips) 
Seat 6: Naebushkin ($1313.25 in chips) 
Naebushkin: posts small blind $3
rusdronenv: posts big blind $6
*** HOLE CARDS ***
Taimuraz63: folds 
garougary: folds 
mrienader: raises $6 to $12
king10clubs: raises $33 to $45
Naebushkin: folds 
rusdronenv: folds 
mrienader: folds 
Uncalled bet ($33) returned to king10clubs
king10clubs collected $33 from pot
king10clubs: doesn't show hand 
*** SUMMARY ***
Total pot $33 | Rake $0 
Seat 1: rusdronenv (big blind) folded before Flop
Seat 2: Taimuraz63 folded before Flop (didn't bet)
Seat 3: garougary folded before Flop (didn't bet)
Seat 4: mrienader folded before Flop
Seat 5: king10clubs (button) collected ($33)
Seat 6: Naebushkin (small blind) folded before Flop


PokerStars Game #102594138316:  Hold'em No Limit ($3/$6 USD) - 2013/08/11 2:56:46 ET
Table 'Klemola 40-100 bb' 6-max Seat #6 is the button
Seat 1: rusdronenv ($1070.59 in chips) 
Seat 2: Taimuraz63 ($475.37 in chips) 
Seat 3: garougary ($81.18 in chips) 
Seat 4: mrienader ($611.78 in chips) 
Seat 5: king10clubs ($621 in chips) 
Seat 6: Naebushkin ($1310.25 in chips) 
rusdronenv: posts small blind $3
Taimuraz63: posts big blind $6
*** HOLE CARDS ***
garougary: folds 
mrienader: folds 
king10clubs: raises $9 to $15
Naebushkin: folds 
rusdronenv: folds 
Taimuraz63: calls $9
*** FLOP *** [9c 6s 9s]
Taimuraz63: checks 
king10clubs: bets $20.70
Taimuraz63: folds 
Uncalled bet ($20.70) returned to king10clubs
king10clubs collected $31.52 from pot
king10clubs: doesn't show hand 
*** SUMMARY ***
Total pot $33 | Rake $1.48 
Board [9c 6s 9s]
Seat 1: rusdronenv (small blind) folded before Flop
Seat 2: Taimuraz63 (big blind) folded on the Flop
Seat 3: garougary folded before Flop (didn't bet)
Seat 4: mrienader folded before Flop (didn't bet)
Seat 5: king10clubs collected ($31.52)
Seat 6: Naebushkin (button) folded before Flop (didn't bet)


PokerStars Game #102594149218:  Hold'em No Limit ($3/$6 USD) - 2013/08/11 2:57:37 ET
Table 'Klemola 40-100 bb' 6-max Seat #1 is the button
Seat 1: rusdronenv ($1067.59 in chips) 
Seat 2: Taimuraz63 ($460.37 in chips) 
Seat 3: garougary ($81.18 in chips) 
Seat 4: mrienader ($611.78 in chips) 
Seat 5: king10clubs ($637.52 in chips) 
Seat 6: Naebushkin ($1310.25 in chips) 
Taimuraz63: posts small blind $3
garougary: posts big blind $6
*** HOLE CARDS ***
mrienader: folds 
king10clubs: raises $9 to $15
Naebushkin: folds 
rusdronenv: folds 
Taimuraz63: folds 
garougary: folds 
Uncalled bet ($9) returned to king10clubs
king10clubs collected $15 from pot
king10clubs: doesn't show hand 
*** SUMMARY ***
Total pot $15 | Rake $0 
Seat 1: rusdronenv (button) folded before Flop (didn't bet)
Seat 2: Taimuraz63 (small blind) folded before Flop
Seat 3: garougary (big blind) folded before Flop
Seat 4: mrienader folded before Flop (didn't bet)
Seat 5: king10clubs collected ($15)
Seat 6: Naebushkin folded before Flop (didn't bet)


PokerStars Game #102594154078:  Hold'em No Limit ($3/$6 USD) - 2013/08/11 2:58:00 ET
Table 'Klemola 40-100 bb' 6-max Seat #2 is the button
Seat 1: rusdronenv ($1067.59 in chips) 
Seat 2: Taimuraz63 ($457.37 in chips) 
Seat 3: garougary ($75.18 in chips) 
Seat 4: mrienader ($611.78 in chips) 
Seat 5: king10clubs ($646.52 in chips) 
Seat 6: Naebushkin ($1310.25 in chips) 
garougary: posts small blind $3
mrienader: posts big blind $6
*** HOLE CARDS ***
king10clubs: folds 
Naebushkin: folds 
rusdronenv: folds 
Taimuraz63: folds 
garougary: folds 
Uncalled bet ($3) returned to mrienader
mrienader collected $6 from pot
mrienader: doesn't show hand 
*** SUMMARY ***
Total pot $6 | Rake $0 
Seat 1: rusdronenv folded before Flop (didn't bet)
Seat 2: Taimuraz63 (button) folded before Flop (didn't bet)
Seat 3: garougary (small blind) folded before Flop
Seat 4: mrienader (big blind) collected ($6)
Seat 5: king10clubs folded before Flop (didn't bet)
Seat 6: Naebushkin folded before Flop (didn't bet)


PokerStars Game #102594159229:  Hold'em No Limit ($3/$6 USD) - 2013/08/11 2:58:23 ET
Table 'Klemola 40-100 bb' 6-max Seat #3 is the button
Seat 1: rusdronenv ($1067.59 in chips) 
Seat 2: Taimuraz63 ($457.37 in chips) 
Seat 3: garougary ($72.18 in chips) 
Seat 4: mrienader ($614.78 in chips) 
Seat 5: king10clubs ($646.52 in chips) 
Seat 6: Naebushkin ($1310.25 in chips) 
mrienader: posts small blind $3
king10clubs: posts big blind $6
*** HOLE CARDS ***
Naebushkin: raises $12 to $18
rusdronenv: folds 
Taimuraz63: folds 
garougary: calls $18
mrienader: calls $15
king10clubs: folds 
*** FLOP *** [Qc 7h Ac]
mrienader: checks 
Naebushkin: checks 
garougary: checks 
*** TURN *** [Qc 7h Ac] [7d]
mrienader: checks 
Naebushkin: bets $33
garougary: raises $21.18 to $54.18 and is all-in
mrienader: folds 
Naebushkin: calls $21.18
*** RIVER *** [Qc 7h Ac 7d] [8s]
*** SHOW DOWN ***
Naebushkin: shows [Ts Qs] (two pair, Queens and Sevens)
garougary: shows [Ad As] (a full house, Aces full of Sevens)
garougary collected $165.56 from pot
*** SUMMARY ***
Total pot $168.36 | Rake $2.80 
Board [Qc 7h Ac 7d 8s]
Seat 1: rusdronenv folded before Flop (didn't bet)
Seat 2: Taimuraz63 folded before Flop (didn't bet)
Seat 3: garougary (button) showed [Ad As] and won ($165.56) with a full house, Aces full of Sevens
Seat 4: mrienader (small blind) folded on the Turn
Seat 5: king10clubs (big blind) folded before Flop
Seat 6: Naebushkin showed [Ts Qs] and lost with two pair, Queens and Sevens


PokerStars Game #102594180627:  Hold'em No Limit ($3/$6 USD) - 2013/08/11 3:00:00 ET
Table 'Klemola 40-100 bb' 6-max Seat #4 is the button
Seat 1: rusdronenv ($1067.59 in chips) 
Seat 2: Taimuraz63 ($457.37 in chips) 
Seat 3: garougary ($165.56 in chips) 
Seat 4: mrienader ($600 in chips) 
Seat 5: king10clubs ($640.52 in chips) 
Seat 6: Naebushkin ($1238.07 in chips) 
king10clubs: posts small blind $3
Naebushkin: posts big blind $6
*** HOLE CARDS ***
rusdronenv: folds 
Taimuraz63: folds 
garougary: raises $6 to $12
mrienader: folds 
king10clubs: folds 
Naebushkin: folds 
Uncalled bet ($6) returned to garougary
garougary collected $15 from pot
garougary: doesn't show hand 
*** SUMMARY ***
Total pot $15 | Rake $0 
Seat 1: rusdronenv folded before Flop (didn't bet)
Seat 2: Taimuraz63 folded before Flop (didn't bet)
Seat 3: garougary collected ($15)
Seat 4: mrienader (button) folded before Flop (didn't bet)
Seat 5: king10clubs (small blind) folded before Flop
Seat 6: Naebushkin (big blind) folded before Flop


PokerStars Game #102594185241:  Hold'em No Limit ($3/$6 USD) - 2013/08/11 3:00:20 ET
Table 'Klemola 40-100 bb' 6-max Seat #5 is the button
Seat 1: rusdronenv ($1067.59 in chips) 
Seat 2: Taimuraz63 ($457.37 in chips) 
Seat 3: garougary ($174.56 in chips) 
Seat 4: mrienader ($600 in chips) 
Seat 5: king10clubs ($637.52 in chips) 
Seat 6: Naebushkin ($1232.07 in chips) 
Naebushkin: posts small blind $3
rusdronenv: posts big blind $6
*** HOLE CARDS ***
Taimuraz63: raises $6 to $12
garougary: folds 
mrienader: folds 
king10clubs: folds 
Naebushkin: folds 
rusdronenv: folds 
Uncalled bet ($6) returned to Taimuraz63
Taimuraz63 collected $15 from pot
*** SUMMARY ***
Total pot $15 | Rake $0 
Seat 1: rusdronenv (big blind) folded before Flop
Seat 2: Taimuraz63 collected ($15)
Seat 3: garougary folded before Flop (didn't bet)
Seat 4: mrienader folded before Flop (didn't bet)
Seat 5: king10clubs (button) folded before Flop (didn't bet)
Seat 6: Naebushkin (small blind) folded before Flop


PokerStars Game #102594191778:  Hold'em No Limit ($3/$6 USD) - 2013/08/11 3:00:48 ET
Table 'Klemola 40-100 bb' 6-max Seat #6 is the button
Seat 1: rusdronenv ($1061.59 in chips) 
Seat 2: Taimuraz63 ($466.37 in chips) 
Seat 3: garougary ($174.56 in chips) 
Seat 4: mrienader ($600 in chips) 
Seat 5: king10clubs ($637.52 in chips) 
Seat 6: Naebushkin ($1229.07 in chips) 
rusdronenv: posts small blind $3
Taimuraz63: posts big blind $6
*** HOLE CARDS ***
garougary: folds 
mrienader: folds 
king10clubs: raises $6 to $12
Naebushkin: folds 
rusdronenv: folds 
Taimuraz63: folds 
Uncalled bet ($6) returned to king10clubs
king10clubs collected $15 from pot
king10clubs: doesn't show hand 
*** SUMMARY ***
Total pot $15 | Rake $0 
Seat 1: rusdronenv (small blind) folded before Flop
Seat 2: Taimuraz63 (big blind) folded before Flop
Seat 3: garougary folded before Flop (didn't bet)
Seat 4: mrienader folded before Flop (didn't bet)
Seat 5: king10clubs collected ($15)
Seat 6: Naebushkin (button) folded before Flop (didn't bet)


PokerStars Game #102594195961:  Hold'em No Limit ($3/$6 USD) - 2013/08/11 3:01:04 ET
Table 'Klemola 40-100 bb' 6-max Seat #1 is the button
Seat 1: rusdronenv ($1058.59 in chips) 
Seat 2: Taimuraz63 ($460.37 in chips) 
Seat 3: garougary ($174.56 in chips) 
Seat 4: mrienader ($600 in chips) 
Seat 5: king10clubs ($646.52 in chips) 
Seat 6: Naebushkin ($1229.07 in chips) 
Taimuraz63: posts small blind $3
garougary: posts big blind $6
*** HOLE CARDS ***
mrienader: folds 
king10clubs: folds 
Naebushkin: folds 
rusdronenv: raises $6 to $12
Taimuraz63: calls $9
garougary: folds 
*** FLOP *** [Kd 2d 9h]
Taimuraz63: checks 
rusdronenv: bets $18
Taimuraz63: raises $18 to $36
rusdronenv: folds 
Uncalled bet ($18) returned to Taimuraz63
Taimuraz63 collected $63.20 from pot
*** SUMMARY ***
Total pot $66 | Rake $2.80 
Board [Kd 2d 9h]
Seat 1: rusdronenv (button) folded on the Flop
Seat 2: Taimuraz63 (small blind) collected ($63.20)
Seat 3: garougary (big blind) folded before Flop
Seat 4: mrienader folded before Flop (didn't bet)
Seat 5: king10clubs folded before Flop (didn't bet)
Seat 6: Naebushkin folded before Flop (didn't bet)


PokerStars Game #102594208080:  Hold'em No Limit ($3/$6 USD) - 2013/08/11 3:01:51 ET
Table 'Klemola 40-100 bb' 6-max Seat #2 is the button
Seat 1: rusdronenv ($1028.59 in chips) 
Seat 2: Taimuraz63 ($493.57 in chips) 
Seat 3: garougary ($168.56 in chips) 
Seat 5: king10clubs ($646.52 in chips) 
Seat 6: Naebushkin ($1229.07 in chips) 
garougary: posts small blind $3
mrienader: is sitting out 
king10clubs: posts big blind $6
*** HOLE CARDS ***
Naebushkin: folds 
rusdronenv: folds 
Taimuraz63: raises $6 to $12
garougary: folds 
king10clubs: calls $6
*** FLOP *** [Jd 8s Th]
king10clubs: checks 
Taimuraz63: checks 
*** TURN *** [Jd 8s Th] [Ts]
king10clubs: checks 
Taimuraz63: bets $12
king10clubs: raises $42 to $54
Taimuraz63: folds 
Uncalled bet ($42) returned to king10clubs
king10clubs collected $48.70 from pot
king10clubs: doesn't show hand 
*** SUMMARY ***
Total pot $51 | Rake $2.30 
Board [Jd 8s Th Ts]
Seat 1: rusdronenv folded before Flop (didn't bet)
Seat 2: Taimuraz63 (button) folded on the Turn
Seat 3: garougary (small blind) folded before Flop
Seat 5: king10clubs (big blind) collected ($48.70)
Seat 6: Naebushkin folded before Flop (didn't bet)


PokerStars Game #102594223876:  Hold'em No Limit ($3/$6 USD) - 2013/08/11 3:02:49 ET
Table 'Klemola 40-100 bb' 6-max Seat #3 is the button
Seat 1: rusdronenv ($1028.59 in chips) 
Seat 2: Taimuraz63 ($469.57 in chips) 
Seat 3: garougary ($165.56 in chips) 
Seat 5: king10clubs ($671.22 in chips) 
Seat 6: Naebushkin ($1229.07 in chips) 
king10clubs: posts small blind $3
Naebushkin: posts big blind $6
*** HOLE CARDS ***
rusdronenv: folds 
Taimuraz63: raises $6 to $12
garougary: calls $12
king10clubs: folds 
Naebushkin: raises $36 to $48
Taimuraz63: folds 
garougary: folds 
Uncalled bet ($36) returned to Naebushkin
Naebushkin collected $39 from pot
Naebushkin: doesn't show hand 
*** SUMMARY ***
Total pot $39 | Rake $0 
Seat 1: rusdronenv folded before Flop (didn't bet)
Seat 2: Taimuraz63 folded before Flop
Seat 3: garougary (button) folded before Flop
Seat 5: king10clubs (small blind) folded before Flop
Seat 6: Naebushkin (big blind) collected ($39)


PokerStars Game #102594230701:  Hold'em No Limit ($3/$6 USD) - 2013/08/11 3:03:14 ET
Table 'Klemola 40-100 bb' 6-max Seat #5 is the button
Seat 1: rusdronenv ($1028.59 in chips) 
Seat 2: Taimuraz63 ($457.57 in chips) 
Seat 3: garougary ($153.56 in chips) 
Seat 5: king10clubs ($668.22 in chips) 
Seat 6: Naebushkin ($1256.07 in chips) 
Naebushkin: posts small blind $3
rusdronenv: posts big blind $6
*** HOLE CARDS ***
mrienader leaves the table
Taimuraz63: raises $6 to $12
garougary: folds 
king10clubs: folds 
pacopil joins the table at seat #4 
Naebushkin: folds 
rusdronenv: calls $6
*** FLOP *** [Qc 3c 2h]
rusdronenv: checks 
Taimuraz63: checks 
*** TURN *** [Qc 3c 2h] [6s]
rusdronenv: checks 
Taimuraz63: checks 
*** RIVER *** [Qc 3c 2h 6s] [6d]
rusdronenv: checks 
Taimuraz63: checks 
*** SHOW DOWN ***
rusdronenv: shows [Js Kh] (a pair of Sixes)
Taimuraz63: mucks hand 
rusdronenv collected $25.78 from pot
*** SUMMARY ***
Total pot $27 | Rake $1.22 
Board [Qc 3c 2h 6s 6d]
Seat 1: rusdronenv (big blind) showed [Js Kh] and won ($25.78) with a pair of Sixes
Seat 2: Taimuraz63 mucked
Seat 3: garougary folded before Flop (didn't bet)
Seat 5: king10clubs (button) folded before Flop (didn't bet)
Seat 6: Naebushkin (small blind) folded before Flop


PokerStars Game #102594247035:  Hold'em No Limit ($3/$6 USD) - 2013/08/11 3:04:11 ET
Table 'Klemola 40-100 bb' 6-max Seat #6 is the button
Seat 1: rusdronenv ($1042.37 in chips) 
Seat 2: Taimuraz63 ($445.57 in chips) 
Seat 3: garougary ($153.56 in chips) 
Seat 5: king10clubs ($668.22 in chips) 
Seat 6: Naebushkin ($1253.07 in chips) 
rusdronenv: posts small blind $3
Taimuraz63: posts big blind $6
pacopil: sits out 
*** HOLE CARDS ***
garougary: folds 
king10clubs: folds 
Naebushkin: raises $9 to $15
rusdronenv: folds 
Taimuraz63: folds 
Uncalled bet ($9) returned to Naebushkin
Naebushkin collected $15 from pot
Naebushkin: doesn't show hand 
*** SUMMARY ***
Total pot $15 | Rake $0 
Seat 1: rusdronenv (small blind) folded before Flop
Seat 2: Taimuraz63 (big blind) folded before Flop
Seat 3: garougary folded before Flop (didn't bet)
Seat 5: king10clubs folded before Flop (didn't bet)
Seat 6: Naebushkin (button) collected ($15)


PokerStars Game #102594251173:  Hold'em No Limit ($3/$6 USD) - 2013/08/11 3:04:26 ET
Table 'Klemola 40-100 bb' 6-max Seat #1 is the button
Seat 1: rusdronenv ($1039.37 in chips) 
Seat 2: Taimuraz63 ($439.57 in chips) 
Seat 3: garougary ($153.56 in chips) 
Seat 5: king10clubs ($668.22 in chips) 
Seat 6: Naebushkin ($1262.07 in chips) 
Taimuraz63: posts small blind $3
garougary: posts big blind $6
pacopil: sits out 
*** HOLE CARDS ***
king10clubs: folds 
Naebushkin: folds 
rusdronenv: raises $6 to $12
Taimuraz63: calls $9
garougary: folds 
*** FLOP *** [Ad 5d 5s]
Taimuraz63: checks 
rusdronenv: bets $18
Taimuraz63: calls $18
*** TURN *** [Ad 5d 5s] [9h]
Taimuraz63: checks 
rusdronenv: checks 
*** RIVER *** [Ad 5d 5s 9h] [7h]
Taimuraz63: bets $18
rusdronenv: folds 
Uncalled bet ($18) returned to Taimuraz63
Taimuraz63 collected $63.20 from pot
*** SUMMARY ***
Total pot $66 | Rake $2.80 
Board [Ad 5d 5s 9h 7h]
Seat 1: rusdronenv (button) folded on the River
Seat 2: Taimuraz63 (small blind) collected ($63.20)
Seat 3: garougary (big blind) folded before Flop
Seat 5: king10clubs folded before Flop (didn't bet)
Seat 6: Naebushkin folded before Flop (didn't bet)


PokerStars Game #102594642983:  Hold'em No Limit ($3/$6 USD) - 2013/08/11 3:25:46 ET
Table 'Klemola 40-100 bb' 6-max Seat #2 is the button
Seat 1: rusdronenv ($990.35 in chips) 
Seat 2: NutPopper ($271.90 in chips) 
Seat 3: garougary ($123.58 in chips) 
Seat 4: mustanggino ($463.78 in chips) 
Seat 5: king10clubs ($768.22 in chips) 
Seat 6: vjxbkf ($600 in chips) 
garougary: posts small blind $3
mustanggino: posts big blind $6
*** HOLE CARDS ***
king10clubs: folds 
vjxbkf: folds 
rusdronenv: raises $12 to $18
NutPopper: folds 
garougary: folds 
mustanggino: folds 
Uncalled bet ($12) returned to rusdronenv
rusdronenv collected $15 from pot
rusdronenv: doesn't show hand 
*** SUMMARY ***
Total pot $15 | Rake $0 
Seat 1: rusdronenv collected ($15)
Seat 2: NutPopper (button) folded before Flop (didn't bet)
Seat 3: garougary (small blind) folded before Flop
Seat 4: mustanggino (big blind) folded before Flop
Seat 5: king10clubs folded before Flop (didn't bet)
Seat 6: vjxbkf folded before Flop (didn't bet)


PokerStars Game #102594661450:  Hold'em No Limit ($3/$6 USD) - 2013/08/11 3:26:41 ET
Table 'Klemola 40-100 bb' 6-max Seat #3 is the button
Seat 1: rusdronenv ($999.35 in chips) 
Seat 2: NutPopper ($271.90 in chips) 
Seat 3: garougary ($120.58 in chips) 
Seat 4: mustanggino ($457.78 in chips) 
Seat 5: king10clubs ($768.22 in chips) 
Seat 6: vjxbkf ($600 in chips) 
mustanggino: posts small blind $3
king10clubs: posts big blind $6
*** HOLE CARDS ***
vjxbkf: folds 
rusdronenv: folds 
NutPopper: folds 
garougary: folds 
mustanggino: raises $6 to $12
king10clubs: calls $6
*** FLOP *** [Ah Jd Js]
mustanggino: bets $12
king10clubs: folds 
Uncalled bet ($12) returned to mustanggino
mustanggino collected $22.92 from pot
mustanggino: doesn't show hand 
*** SUMMARY ***
Total pot $24 | Rake $1.08 
Board [Ah Jd Js]
Seat 1: rusdronenv folded before Flop (didn't bet)
Seat 2: NutPopper folded before Flop (didn't bet)
Seat 3: garougary (button) folded before Flop (didn't bet)
Seat 4: mustanggino (small blind) collected ($22.92)
Seat 5: king10clubs (big blind) folded on the Flop
Seat 6: vjxbkf folded before Flop (didn't bet)


PokerStars Game #102594679279:  Hold'em No Limit ($3/$6 USD) - 2013/08/11 3:27:35 ET
Table 'Klemola 40-100 bb' 6-max Seat #4 is the button
Seat 1: rusdronenv ($999.35 in chips) 
Seat 2: NutPopper ($271.90 in chips) 
Seat 3: garougary ($120.58 in chips) 
Seat 4: mustanggino ($468.70 in chips) 
Seat 5: king10clubs ($756.22 in chips) 
Seat 6: vjxbkf ($600 in chips) 
king10clubs: posts small blind $3
vjxbkf: posts big blind $6
*** HOLE CARDS ***
rusdronenv: folds 
NutPopper: folds 
garougary: folds 
mustanggino: folds 
king10clubs: raises $9 to $15
vjxbkf: calls $9
*** FLOP *** [7h 7c 2d]
king10clubs: bets $14
vjxbkf: folds 
Uncalled bet ($14) returned to king10clubs
king10clubs collected $28.65 from pot
king10clubs: doesn't show hand 
*** SUMMARY ***
Total pot $30 | Rake $1.35 
Board [7h 7c 2d]
Seat 1: rusdronenv folded before Flop (didn't bet)
Seat 2: NutPopper folded before Flop (didn't bet)
Seat 3: garougary folded before Flop (didn't bet)
Seat 4: mustanggino (button) folded before Flop (didn't bet)
Seat 5: king10clubs (small blind) collected ($28.65)
Seat 6: vjxbkf (big blind) folded on the Flop


PokerStars Game #102594691352:  Hold'em No Limit ($3/$6 USD) - 2013/08/11 3:28:11 ET
Table 'Klemola 40-100 bb' 6-max Seat #5 is the button
Seat 1: rusdronenv ($999.35 in chips) 
Seat 2: NutPopper ($271.90 in chips) 
Seat 3: garougary ($120.58 in chips) 
Seat 4: mustanggino ($468.70 in chips) 
Seat 5: king10clubs ($769.87 in chips) 
Seat 6: vjxbkf ($600 in chips) 
vjxbkf: posts small blind $3
rusdronenv: posts big blind $6
*** HOLE CARDS ***
NutPopper: folds 
garougary: raises $6 to $12
mustanggino: raises $27 to $39
king10clubs: folds 
vjxbkf: folds 
rusdronenv: folds 
garougary: calls $27
*** FLOP *** [2h 3s Kd]
garougary: checks 
mustanggino: bets $54
garougary: folds 
Uncalled bet ($54) returned to mustanggino
mustanggino collected $84.20 from pot
mustanggino: doesn't show hand 
*** SUMMARY ***
Total pot $87 | Rake $2.80 
Board [2h 3s Kd]
Seat 1: rusdronenv (big blind) folded before Flop
Seat 2: NutPopper folded before Flop (didn't bet)
Seat 3: garougary folded on the Flop
Seat 4: mustanggino collected ($84.20)
Seat 5: king10clubs (button) folded before Flop (didn't bet)
Seat 6: vjxbkf (small blind) folded before Flop


PokerStars Game #102594716097:  Hold'em No Limit ($3/$6 USD) - 2013/08/11 3:29:26 ET
Table 'Klemola 40-100 bb' 6-max Seat #6 is the button
Seat 1: rusdronenv ($993.35 in chips) 
Seat 2: NutPopper ($271.90 in chips) 
Seat 3: garougary ($81.58 in chips) 
Seat 4: mustanggino ($513.90 in chips) 
Seat 5: king10clubs ($769.87 in chips) 
Seat 6: vjxbkf ($600 in chips) 
rusdronenv: posts small blind $3
NutPopper: posts big blind $6
*** HOLE CARDS ***
garougary: folds 
mustanggino: raises $6 to $12
king10clubs: calls $12
vjxbkf: folds 
rusdronenv: folds 
NutPopper: folds 
*** FLOP *** [Qd 8c 4d]
mustanggino: bets $18
king10clubs: calls $18
*** TURN *** [Qd 8c 4d] [9c]
mustanggino: bets $45
king10clubs: calls $45
*** RIVER *** [Qd 8c 4d 9c] [Ts]
mustanggino: checks 
king10clubs: bets $90
mustanggino: folds 
Uncalled bet ($90) returned to king10clubs
king10clubs collected $156.20 from pot
king10clubs: doesn't show hand 
*** SUMMARY ***
Total pot $159 | Rake $2.80 
Board [Qd 8c 4d 9c Ts]
Seat 1: rusdronenv (small blind) folded before Flop
Seat 2: NutPopper (big blind) folded before Flop
Seat 3: garougary folded before Flop (didn't bet)
Seat 4: mustanggino folded on the River
Seat 5: king10clubs collected ($156.20)
Seat 6: vjxbkf (button) folded before Flop (didn't bet)


PokerStars Game #102594540069:  Hold'em No Limit ($3/$6 USD) - 2013/08/11 3:20:30 ET
Table 'Klemola 40-100 bb' 6-max Seat #1 is the button
Seat 1: rusdronenv ($995.65 in chips) 
Seat 2: NutPopper ($211.50 in chips) 
Seat 3: garougary ($177.58 in chips) 
Seat 4: mustanggino ($463.78 in chips) 
Seat 5: king10clubs ($777.22 in chips) 
Seat 6: vjxbkf ($600 in chips) 
NutPopper: posts small blind $3
garougary: posts big blind $6
*** HOLE CARDS ***
mustanggino: folds 
king10clubs: folds 
vjxbkf: folds 
rusdronenv: raises $6 to $12
NutPopper: calls $9
garougary: folds 
*** FLOP *** [Qd 3h 5c]
NutPopper: checks 
rusdronenv: bets $18
NutPopper: raises $20 to $38
rusdronenv: folds 
Uncalled bet ($20) returned to NutPopper
NutPopper collected $63.20 from pot
NutPopper: doesn't show hand 
*** SUMMARY ***
Total pot $66 | Rake $2.80 
Board [Qd 3h 5c]
Seat 1: rusdronenv (button) folded on the Flop
Seat 2: NutPopper (small blind) collected ($63.20)
Seat 3: garougary (big blind) folded before Flop
Seat 4: mustanggino folded before Flop (didn't bet)
Seat 5: king10clubs folded before Flop (didn't bet)
Seat 6: vjxbkf folded before Flop (didn't bet)


PokerStars Game #102594564551:  Hold'em No Limit ($3/$6 USD) - 2013/08/11 3:21:49 ET
Table 'Klemola 40-100 bb' 6-max Seat #2 is the button
Seat 1: rusdronenv ($965.65 in chips) 
Seat 2: NutPopper ($244.70 in chips) 
Seat 3: garougary ($171.58 in chips) 
Seat 4: mustanggino ($463.78 in chips) 
Seat 5: king10clubs ($777.22 in chips) 
Seat 6: vjxbkf ($600 in chips) 
garougary: posts small blind $3
mustanggino: posts big blind $6
*** HOLE CARDS ***
king10clubs: folds 
vjxbkf: folds 
rusdronenv: raises $12 to $18
NutPopper: folds 
garougary: folds 
mustanggino: folds 
Uncalled bet ($12) returned to rusdronenv
rusdronenv collected $15 from pot
rusdronenv: doesn't show hand 
*** SUMMARY ***
Total pot $15 | Rake $0 
Seat 1: rusdronenv collected ($15)
Seat 2: NutPopper (button) folded before Flop (didn't bet)
Seat 3: garougary (small blind) folded before Flop
Seat 4: mustanggino (big blind) folded before Flop
Seat 5: king10clubs folded before Flop (didn't bet)
Seat 6: vjxbkf folded before Flop (didn't bet)


PokerStars Game #102594577451:  Hold'em No Limit ($3/$6 USD) - 2013/08/11 3:22:27 ET
Table 'Klemola 40-100 bb' 6-max Seat #3 is the button
Seat 1: rusdronenv ($974.65 in chips) 
Seat 2: NutPopper ($244.70 in chips) 
Seat 3: garougary ($168.58 in chips) 
Seat 4: mustanggino ($457.78 in chips) 
Seat 5: king10clubs ($777.22 in chips) 
Seat 6: vjxbkf ($600 in chips) 
mustanggino: posts small blind $3
king10clubs: posts big blind $6
*** HOLE CARDS ***
vjxbkf: folds 
rusdronenv: folds 
NutPopper: folds 
garougary: folds 
mustanggino: raises $6 to $12
king10clubs: folds 
Uncalled bet ($6) returned to mustanggino
mustanggino collected $12 from pot
mustanggino: doesn't show hand 
*** SUMMARY ***
Total pot $12 | Rake $0 
Seat 1: rusdronenv folded before Flop (didn't bet)
Seat 2: NutPopper folded before Flop (didn't bet)
Seat 3: garougary (button) folded before Flop (didn't bet)
Seat 4: mustanggino (small blind) collected ($12)
Seat 5: king10clubs (big blind) folded before Flop
Seat 6: vjxbkf folded before Flop (didn't bet)


PokerStars Game #102594583688:  Hold'em No Limit ($3/$6 USD) - 2013/08/11 3:22:47 ET
Table 'Klemola 40-100 bb' 6-max Seat #4 is the button
Seat 1: rusdronenv ($974.65 in chips) 
Seat 2: NutPopper ($244.70 in chips) 
Seat 3: garougary ($168.58 in chips) 
Seat 4: mustanggino ($463.78 in chips) 
Seat 5: king10clubs ($771.22 in chips) 
Seat 6: vjxbkf ($600 in chips) 
king10clubs: posts small blind $3
vjxbkf: posts big blind $6
*** HOLE CARDS ***
rusdronenv: folds 
NutPopper: folds 
garougary: folds 
mustanggino: folds 
king10clubs: folds 
Uncalled bet ($3) returned to vjxbkf
vjxbkf collected $6 from pot
vjxbkf: doesn't show hand 
*** SUMMARY ***
Total pot $6 | Rake $0 
Seat 1: rusdronenv folded before Flop (didn't bet)
Seat 2: NutPopper folded before Flop (didn't bet)
Seat 3: garougary folded before Flop (didn't bet)
Seat 4: mustanggino (button) folded before Flop (didn't bet)
Seat 5: king10clubs (small blind) folded before Flop
Seat 6: vjxbkf (big blind) collected ($6)


PokerStars Game #102594593256:  Hold'em No Limit ($3/$6 USD) - 2013/08/11 3:23:16 ET
Table 'Klemola 40-100 bb' 6-max Seat #5 is the button
Seat 1: rusdronenv ($974.65 in chips) 
Seat 2: NutPopper ($244.70 in chips) 
Seat 3: garougary ($168.58 in chips) 
Seat 4: mustanggino ($463.78 in chips) 
Seat 5: king10clubs ($768.22 in chips) 
Seat 6: vjxbkf ($603 in chips) 
vjxbkf: posts small blind $3
rusdronenv: posts big blind $6
*** HOLE CARDS ***
NutPopper: raises $6 to $12
garougary: calls $12
mustanggino: folds 
king10clubs: folds 
vjxbkf: folds 
rusdronenv: folds 
*** FLOP *** [3d Jc 3c]
NutPopper: bets $18
garougary: calls $18
*** TURN *** [3d Jc 3c] [Ah]
NutPopper: bets $42
garougary: folds 
Uncalled bet ($42) returned to NutPopper
NutPopper collected $66.20 from pot
NutPopper: doesn't show hand 
*** SUMMARY ***
Total pot $69 | Rake $2.80 
Board [3d Jc 3c Ah]
Seat 1: rusdronenv (big blind) folded before Flop
Seat 2: NutPopper collected ($66.20)
Seat 3: garougary folded on the Turn
Seat 4: mustanggino folded before Flop (didn't bet)
Seat 5: king10clubs (button) folded before Flop (didn't bet)
Seat 6: vjxbkf (small blind) folded before Flop


PokerStars Game #102594608258:  Hold'em No Limit ($3/$6 USD) - 2013/08/11 3:24:02 ET
Table 'Klemola 40-100 bb' 6-max Seat #6 is the button
Seat 1: rusdronenv ($968.65 in chips) 
Seat 2: NutPopper ($280.90 in chips) 
Seat 3: garougary ($138.58 in chips) 
Seat 4: mustanggino ($463.78 in chips) 
Seat 5: king10clubs ($768.22 in chips) 
Seat 6: vjxbkf ($600 in chips) 
rusdronenv: posts small blind $3
NutPopper: posts big blind $6
*** HOLE CARDS ***
garougary: raises $6 to $12
mustanggino: folds 
king10clubs: folds 
vjxbkf: folds 
rusdronenv: folds 
NutPopper: folds 
Uncalled bet ($6) returned to garougary
garougary collected $15 from pot
garougary: doesn't show hand 
*** SUMMARY ***
Total pot $15 | Rake $0 
Seat 1: rusdronenv (small blind) folded before Flop
Seat 2: NutPopper (big blind) folded before Flop
Seat 3: garougary collected ($15)
Seat 4: mustanggino folded before Flop (didn't bet)
Seat 5: king10clubs folded before Flop (didn't bet)
Seat 6: vjxbkf (button) folded before Flop (didn't bet)


PokerStars Game #102594618634:  Hold'em No Limit ($3/$6 USD) - 2013/08/11 3:24:33 ET
Table 'Klemola 40-100 bb' 6-max Seat #1 is the button
Seat 1: rusdronenv ($965.65 in chips) 
Seat 2: NutPopper ($274.90 in chips) 
Seat 3: garougary ($147.58 in chips) 
Seat 4: mustanggino ($463.78 in chips) 
Seat 5: king10clubs ($768.22 in chips) 
Seat 6: vjxbkf ($600 in chips) 
NutPopper: posts small blind $3
garougary: posts big blind $6
*** HOLE CARDS ***
mustanggino: folds 
king10clubs: folds 
vjxbkf: folds 
rusdronenv: raises $6 to $12
NutPopper: folds 
garougary: calls $6
*** FLOP *** [Ks Js Jc]
garougary: checks 
rusdronenv: checks 
*** TURN *** [Ks Js Jc] [4s]
garougary: checks 
rusdronenv: checks 
*** RIVER *** [Ks Js Jc 4s] [2h]
garougary: bets $12
rusdronenv: calls $12
*** SHOW DOWN ***
garougary: shows [Ad 9s] (a pair of Jacks)
rusdronenv: shows [4c 5c] (two pair, Jacks and Fours)
rusdronenv collected $48.70 from pot
*** SUMMARY ***
Total pot $51 | Rake $2.30 
Board [Ks Js Jc 4s 2h]
Seat 1: rusdronenv (button) showed [4c 5c] and won ($48.70) with two pair, Jacks and Fours
Seat 2: NutPopper (small blind) folded before Flop
Seat 3: garougary (big blind) showed [Ad 9s] and lost with a pair of Jacks
Seat 4: mustanggino folded before Flop (didn't bet)
Seat 5: king10clubs folded before Flop (didn't bet)
Seat 6: vjxbkf folded before Flop (didn't bet)


PokerStars Game #102594437973:  Hold'em No Limit ($3/$6 USD) - 2013/08/11 3:15:01 ET
Table 'Klemola 40-100 bb' 6-max Seat #5 is the button
Seat 1: rusdronenv ($984.87 in chips) 
Seat 2: NutPopper ($217.50 in chips) 
Seat 3: garougary ($177.58 in chips) 
Seat 5: king10clubs ($744.02 in chips) 
Seat 6: vjxbkf ($600 in chips) 
vjxbkf: posts small blind $3
rusdronenv: posts big blind $6
mustanggino: sits out 
*** HOLE CARDS ***
NutPopper: folds 
garougary: folds 
king10clubs: raises $6 to $12
vjxbkf: raises $30 to $42
rusdronenv: folds 
king10clubs: calls $30
*** FLOP *** [2c 7d Ac]
vjxbkf: checks 
king10clubs: checks 
*** TURN *** [2c 7d Ac] [Kc]
vjxbkf: checks 
king10clubs: checks 
*** RIVER *** [2c 7d Ac Kc] [9d]
vjxbkf: checks 
king10clubs: checks 
*** SHOW DOWN ***
vjxbkf: shows [8s Qc] (high card Ace)
king10clubs: shows [4d 4s] (a pair of Fours)
king10clubs collected $87.20 from pot
*** SUMMARY ***
Total pot $90 | Rake $2.80 
Board [2c 7d Ac Kc 9d]
Seat 1: rusdronenv (big blind) folded before Flop
Seat 2: NutPopper folded before Flop (didn't bet)
Seat 3: garougary folded before Flop (didn't bet)
Seat 5: king10clubs (button) showed [4d 4s] and won ($87.20) with a pair of Fours
Seat 6: vjxbkf (small blind) showed [8s Qc] and lost with high card Ace


PokerStars Game #102594464915:  Hold'em No Limit ($3/$6 USD) - 2013/08/11 3:16:29 ET
Table 'Klemola 40-100 bb' 6-max Seat #6 is the button
Seat 1: rusdronenv ($978.87 in chips) 
Seat 2: NutPopper ($217.50 in chips) 
Seat 3: garougary ($177.58 in chips) 
Seat 5: king10clubs ($789.22 in chips) 
Seat 6: vjxbkf ($600 in chips) 
rusdronenv: posts small blind $3
NutPopper: posts big blind $6
mustanggino: sits out 
*** HOLE CARDS ***
garougary: folds 
king10clubs: raises $9 to $15
vjxbkf: folds 
rusdronenv: folds 
NutPopper: folds 
Uncalled bet ($9) returned to king10clubs
king10clubs collected $15 from pot
king10clubs: doesn't show hand 
*** SUMMARY ***
Total pot $15 | Rake $0 
Seat 1: rusdronenv (small blind) folded before Flop
Seat 2: NutPopper (big blind) folded before Flop
Seat 3: garougary folded before Flop (didn't bet)
Seat 5: king10clubs collected ($15)
Seat 6: vjxbkf (button) folded before Flop (didn't bet)


PokerStars Game #102594472853:  Hold'em No Limit ($3/$6 USD) - 2013/08/11 3:16:55 ET
Table 'Klemola 40-100 bb' 6-max Seat #1 is the button
Seat 1: rusdronenv ($975.87 in chips) 
Seat 2: NutPopper ($211.50 in chips) 
Seat 3: garougary ($177.58 in chips) 
Seat 5: king10clubs ($798.22 in chips) 
Seat 6: vjxbkf ($600 in chips) 
NutPopper: posts small blind $3
garougary: posts big blind $6
mustanggino: sits out 
*** HOLE CARDS ***
king10clubs: folds 
vjxbkf: raises $12 to $18
rusdronenv: folds 
NutPopper: folds 
garougary: folds 
Uncalled bet ($12) returned to vjxbkf
vjxbkf collected $15 from pot
vjxbkf: doesn't show hand 
*** SUMMARY ***
Total pot $15 | Rake $0 
Seat 1: rusdronenv (button) folded before Flop (didn't bet)
Seat 2: NutPopper (small blind) folded before Flop
Seat 3: garougary (big blind) folded before Flop
Seat 5: king10clubs folded before Flop (didn't bet)
Seat 6: vjxbkf collected ($15)


PokerStars Game #102594481417:  Hold'em No Limit ($3/$6 USD) - 2013/08/11 3:17:22 ET
Table 'Klemola 40-100 bb' 6-max Seat #2 is the button
Seat 1: rusdronenv ($975.87 in chips) 
Seat 2: NutPopper ($208.50 in chips) 
Seat 3: garougary ($171.58 in chips) 
Seat 4: mustanggino ($463.78 in chips) 
Seat 5: king10clubs ($798.22 in chips) 
Seat 6: vjxbkf ($609 in chips) 
garougary: posts small blind $3
mustanggino: posts big blind $6
*** HOLE CARDS ***
king10clubs: folds 
vjxbkf: folds 
rusdronenv: folds 
NutPopper: folds 
garougary: raises $6 to $12
mustanggino: folds 
Uncalled bet ($6) returned to garougary
garougary collected $12 from pot
garougary: doesn't show hand 
*** SUMMARY ***
Total pot $12 | Rake $0 
Seat 1: rusdronenv folded before Flop (didn't bet)
Seat 2: NutPopper (button) folded before Flop (didn't bet)
Seat 3: garougary (small blind) collected ($12)
Seat 4: mustanggino (big blind) folded before Flop
Seat 5: king10clubs folded before Flop (didn't bet)
Seat 6: vjxbkf folded before Flop (didn't bet)


PokerStars Game #102594492048:  Hold'em No Limit ($3/$6 USD) - 2013/08/11 3:17:57 ET
Table 'Klemola 40-100 bb' 6-max Seat #3 is the button
Seat 1: rusdronenv ($975.87 in chips) 
Seat 2: NutPopper ($208.50 in chips) 
Seat 3: garougary ($177.58 in chips) 
Seat 4: mustanggino ($457.78 in chips) 
Seat 5: king10clubs ($798.22 in chips) 
Seat 6: vjxbkf ($609 in chips) 
mustanggino: posts small blind $3
king10clubs: posts big blind $6
*** HOLE CARDS ***
vjxbkf: folds 
rusdronenv: folds 
NutPopper: raises $6 to $12
garougary: folds 
mustanggino: folds 
king10clubs: folds 
Uncalled bet ($6) returned to NutPopper
NutPopper collected $15 from pot
NutPopper: doesn't show hand 
*** SUMMARY ***
Total pot $15 | Rake $0 
Seat 1: rusdronenv folded before Flop (didn't bet)
Seat 2: NutPopper collected ($15)
Seat 3: garougary (button) folded before Flop (didn't bet)
Seat 4: mustanggino (small blind) folded before Flop
Seat 5: king10clubs (big blind) folded before Flop
Seat 6: vjxbkf folded before Flop (didn't bet)


PokerStars Game #102594502674:  Hold'em No Limit ($3/$6 USD) - 2013/08/11 3:18:30 ET
Table 'Klemola 40-100 bb' 6-max Seat #4 is the button
Seat 1: rusdronenv ($975.87 in chips) 
Seat 2: NutPopper ($217.50 in chips) 
Seat 3: garougary ($177.58 in chips) 
Seat 4: mustanggino ($454.78 in chips) 
Seat 5: king10clubs ($792.22 in chips) 
Seat 6: vjxbkf ($609 in chips) 
king10clubs: posts small blind $3
vjxbkf: posts big blind $6
*** HOLE CARDS ***
rusdronenv: raises $12 to $18
NutPopper: folds 
garougary: folds 
mustanggino: folds 
king10clubs: folds 
vjxbkf: folds 
Uncalled bet ($12) returned to rusdronenv
rusdronenv collected $15 from pot
rusdronenv: doesn't show hand 
*** SUMMARY ***
Total pot $15 | Rake $0 
Seat 1: rusdronenv collected ($15)
Seat 2: NutPopper folded before Flop (didn't bet)
Seat 3: garougary folded before Flop (didn't bet)
Seat 4: mustanggino (button) folded before Flop (didn't bet)
Seat 5: king10clubs (small blind) folded before Flop
Seat 6: vjxbkf (big blind) folded before Flop


PokerStars Game #102594512448:  Hold'em No Limit ($3/$6 USD) - 2013/08/11 3:19:02 ET
Table 'Klemola 40-100 bb' 6-max Seat #5 is the button
Seat 1: rusdronenv ($984.87 in chips) 
Seat 2: NutPopper ($217.50 in chips) 
Seat 3: garougary ($177.58 in chips) 
Seat 4: mustanggino ($454.78 in chips) 
Seat 5: king10clubs ($789.22 in chips) 
Seat 6: vjxbkf ($603 in chips) 
vjxbkf: posts small blind $3
rusdronenv: posts big blind $6
*** HOLE CARDS ***
NutPopper: folds 
garougary: folds 
mustanggino: folds 
king10clubs: raises $6 to $12
vjxbkf: folds 
rusdronenv: calls $6
*** FLOP *** [5c Tc 9d]
rusdronenv: checks 
king10clubs: checks 
*** TURN *** [5c Tc 9d] [Qc]
rusdronenv: checks 
king10clubs: checks 
*** RIVER *** [5c Tc 9d Qc] [7s]
rusdronenv: checks 
king10clubs: checks 
*** SHOW DOWN ***
rusdronenv: shows [9h Kc] (a pair of Nines)
king10clubs: mucks hand 
rusdronenv collected $25.78 from pot
*** SUMMARY ***
Total pot $27 | Rake $1.22 
Board [5c Tc 9d Qc 7s]
Seat 1: rusdronenv (big blind) showed [9h Kc] and won ($25.78) with a pair of Nines
Seat 2: NutPopper folded before Flop (didn't bet)
Seat 3: garougary folded before Flop (didn't bet)
Seat 4: mustanggino folded before Flop (didn't bet)
Seat 5: king10clubs (button) mucked
Seat 6: vjxbkf (small blind) folded before Flop


PokerStars Game #102594528430:  Hold'em No Limit ($3/$6 USD) - 2013/08/11 3:19:53 ET
Table 'Klemola 40-100 bb' 6-max Seat #6 is the button
Seat 1: rusdronenv ($998.65 in chips) 
Seat 2: NutPopper ($217.50 in chips) 
Seat 3: garougary ($177.58 in chips) 
Seat 4: mustanggino ($454.78 in chips) 
Seat 5: king10clubs ($777.22 in chips) 
Seat 6: vjxbkf ($600 in chips) 
rusdronenv: posts small blind $3
NutPopper: posts big blind $6
*** HOLE CARDS ***
garougary: folds 
mustanggino: raises $6 to $12
king10clubs: folds 
vjxbkf: folds 
rusdronenv: folds 
NutPopper: folds 
Uncalled bet ($6) returned to mustanggino
mustanggino collected $15 from pot
mustanggino: doesn't show hand 
*** SUMMARY ***
Total pot $15 | Rake $0 
Seat 1: rusdronenv (small blind) folded before Flop
Seat 2: NutPopper (big blind) folded before Flop
Seat 3: garougary folded before Flop (didn't bet)
Seat 4: mustanggino collected ($15)
Seat 5: king10clubs folded before Flop (didn't bet)
Seat 6: vjxbkf (button) folded before Flop (didn't bet)


PokerStars Game #102594953767:  Hold'em No Limit ($3/$6 USD) - 2013/08/11 3:41:06 ET
Table 'Klemola 40-100 bb' 6-max Seat #5 is the button
Seat 1: rusdronenv ($963.35 in chips) 
Seat 2: NutPopper ($332.10 in chips) 
Seat 3: garougary ($97.82 in chips) 
Seat 4: mustanggino ($519.20 in chips) 
Seat 5: king10clubs ($776.07 in chips) 
Seat 6: vjxbkf ($600 in chips) 
vjxbkf: posts small blind $3
rusdronenv: posts big blind $6
*** HOLE CARDS ***
NutPopper: raises $6 to $12
garougary: calls $12
mustanggino: folds 
king10clubs: folds 
vjxbkf: folds 
rusdronenv: folds 
*** FLOP *** [6d 8s 3d]
NutPopper: checks 
garougary: checks 
*** TURN *** [6d 8s 3d] [Qh]
NutPopper: checks 
garougary: bets $18
NutPopper: folds 
Uncalled bet ($18) returned to garougary
garougary collected $31.52 from pot
garougary: doesn't show hand 
*** SUMMARY ***
Total pot $33 | Rake $1.48 
Board [6d 8s 3d Qh]
Seat 1: rusdronenv (big blind) folded before Flop
Seat 2: NutPopper folded on the Turn
Seat 3: garougary collected ($31.52)
Seat 4: mustanggino folded before Flop (didn't bet)
Seat 5: king10clubs (button) folded before Flop (didn't bet)
Seat 6: vjxbkf (small blind) folded before Flop


PokerStars Game #102594974168:  Hold'em No Limit ($3/$6 USD) - 2013/08/11 3:42:04 ET
Table 'Klemola 40-100 bb' 6-max Seat #6 is the button
Seat 1: rusdronenv ($957.35 in chips) 
Seat 2: NutPopper ($320.10 in chips) 
Seat 3: garougary ($117.34 in chips) 
Seat 4: mustanggino ($519.20 in chips) 
Seat 5: king10clubs ($776.07 in chips) 
Seat 6: vjxbkf ($600 in chips) 
rusdronenv: posts small blind $3
NutPopper: posts big blind $6
*** HOLE CARDS ***
garougary: folds 
mustanggino: folds 
king10clubs: raises $9 to $15
vjxbkf: folds 
rusdronenv: folds 
NutPopper: folds 
Uncalled bet ($9) returned to king10clubs
king10clubs collected $15 from pot
king10clubs: doesn't show hand 
*** SUMMARY ***
Total pot $15 | Rake $0 
Seat 1: rusdronenv (small blind) folded before Flop
Seat 2: NutPopper (big blind) folded before Flop
Seat 3: garougary folded before Flop (didn't bet)
Seat 4: mustanggino folded before Flop (didn't bet)
Seat 5: king10clubs collected ($15)
Seat 6: vjxbkf (button) folded before Flop (didn't bet)


PokerStars Game #102594981275:  Hold'em No Limit ($3/$6 USD) - 2013/08/11 3:42:25 ET
Table 'Klemola 40-100 bb' 6-max Seat #1 is the button
Seat 1: rusdronenv ($954.35 in chips) 
Seat 2: NutPopper ($314.10 in chips) 
Seat 3: garougary ($117.34 in chips) 
Seat 4: mustanggino ($519.20 in chips) 
Seat 5: king10clubs ($785.07 in chips) 
Seat 6: vjxbkf ($600 in chips) 
NutPopper: posts small blind $3
garougary: posts big blind $6
*** HOLE CARDS ***
mustanggino: folds 
king10clubs: raises $9 to $15
vjxbkf: folds 
rusdronenv: folds 
NutPopper: folds 
garougary: folds 
Uncalled bet ($9) returned to king10clubs
king10clubs collected $15 from pot
king10clubs: doesn't show hand 
*** SUMMARY ***
Total pot $15 | Rake $0 
Seat 1: rusdronenv (button) folded before Flop (didn't bet)
Seat 2: NutPopper (small blind) folded before Flop
Seat 3: garougary (big blind) folded before Flop
Seat 4: mustanggino folded before Flop (didn't bet)
Seat 5: king10clubs collected ($15)
Seat 6: vjxbkf folded before Flop (didn't bet)


PokerStars Game #102594992118:  Hold'em No Limit ($3/$6 USD) - 2013/08/11 3:42:56 ET
Table 'Klemola 40-100 bb' 6-max Seat #2 is the button
Seat 1: rusdronenv ($954.35 in chips) 
Seat 2: NutPopper ($311.10 in chips) 
Seat 3: garougary ($111.34 in chips) 
Seat 4: mustanggino ($519.20 in chips) 
Seat 5: king10clubs ($794.07 in chips) 
Seat 6: vjxbkf ($600 in chips) 
garougary: posts small blind $3
mustanggino: posts big blind $6
*** HOLE CARDS ***
king10clubs: folds 
vjxbkf: folds 
rusdronenv: calls $6
NutPopper: folds 
garougary: calls $3
mustanggino: checks 
*** FLOP *** [5d 8d Kd]
garougary: checks 
mustanggino: checks 
rusdronenv: checks 
*** TURN *** [5d 8d Kd] [Ac]
garougary: bets $6
mustanggino: folds 
rusdronenv: folds 
Uncalled bet ($6) returned to garougary
garougary collected $17.19 from pot
garougary: doesn't show hand 
*** SUMMARY ***
Total pot $18 | Rake $0.81 
Board [5d 8d Kd Ac]
Seat 1: rusdronenv folded on the Turn
Seat 2: NutPopper (button) folded before Flop (didn't bet)
Seat 3: garougary (small blind) collected ($17.19)
Seat 4: mustanggino (big blind) folded on the Turn
Seat 5: king10clubs folded before Flop (didn't bet)
Seat 6: vjxbkf folded before Flop (didn't bet)


PokerStars Game #102595018239:  Hold'em No Limit ($3/$6 USD) - 2013/08/11 3:44:12 ET
Table 'Klemola 40-100 bb' 6-max Seat #3 is the button
Seat 1: rusdronenv ($948.35 in chips) 
Seat 2: NutPopper ($311.10 in chips) 
Seat 3: garougary ($122.53 in chips) 
Seat 4: mustanggino ($513.20 in chips) 
Seat 5: king10clubs ($794.07 in chips) 
Seat 6: vjxbkf ($600 in chips) 
mustanggino: posts small blind $3
king10clubs: posts big blind $6
*** HOLE CARDS ***
vjxbkf: folds 
rusdronenv: folds 
NutPopper: folds 
garougary: folds 
mustanggino: raises $6 to $12
king10clubs: calls $6
*** FLOP *** [9c 4h 7h]
mustanggino: bets $12
king10clubs: raises $28 to $40
mustanggino: folds 
Uncalled bet ($28) returned to king10clubs
king10clubs collected $45.84 from pot
king10clubs: doesn't show hand 
*** SUMMARY ***
Total pot $48 | Rake $2.16 
Board [9c 4h 7h]
Seat 1: rusdronenv folded before Flop (didn't bet)
Seat 2: NutPopper folded before Flop (didn't bet)
Seat 3: garougary (button) folded before Flop (didn't bet)
Seat 4: mustanggino (small blind) folded on the Flop
Seat 5: king10clubs (big blind) collected ($45.84)
Seat 6: vjxbkf folded before Flop (didn't bet)


PokerStars Game #102594828399:  Hold'em No Limit ($3/$6 USD) - 2013/08/11 3:35:00 ET
Table 'Klemola 40-100 bb' 6-max Seat #4 is the button
Seat 1: rusdronenv ($990.35 in chips) 
Seat 2: NutPopper ($271.90 in chips) 
Seat 3: garougary ($72.58 in chips) 
Seat 4: mustanggino ($519.20 in chips) 
Seat 5: king10clubs ($788.07 in chips) 
Seat 6: vjxbkf ($600 in chips) 
king10clubs: posts small blind $3
vjxbkf: posts big blind $6
*** HOLE CARDS ***
rusdronenv: folds 
NutPopper: folds 
garougary: folds 
mustanggino: folds 
king10clubs: folds 
Uncalled bet ($3) returned to vjxbkf
vjxbkf collected $6 from pot
vjxbkf: doesn't show hand 
*** SUMMARY ***
Total pot $6 | Rake $0 
Seat 1: rusdronenv folded before Flop (didn't bet)
Seat 2: NutPopper folded before Flop (didn't bet)
Seat 3: garougary folded before Flop (didn't bet)
Seat 4: mustanggino (button) folded before Flop (didn't bet)
Seat 5: king10clubs (small blind) folded before Flop
Seat 6: vjxbkf (big blind) collected ($6)


PokerStars Game #102594837205:  Hold'em No Limit ($3/$6 USD) - 2013/08/11 3:35:27 ET
Table 'Klemola 40-100 bb' 6-max Seat #5 is the button
Seat 1: rusdronenv ($990.35 in chips) 
Seat 2: NutPopper ($271.90 in chips) 
Seat 3: garougary ($72.58 in chips) 
Seat 4: mustanggino ($519.20 in chips) 
Seat 5: king10clubs ($785.07 in chips) 
Seat 6: vjxbkf ($603 in chips) 
vjxbkf: posts small blind $3
rusdronenv: posts big blind $6
*** HOLE CARDS ***
NutPopper: raises $6 to $12
garougary: folds 
mustanggino: folds 
king10clubs: folds 
vjxbkf: folds 
rusdronenv: folds 
Uncalled bet ($6) returned to NutPopper
NutPopper collected $15 from pot
NutPopper: doesn't show hand 
*** SUMMARY ***
Total pot $15 | Rake $0 
Seat 1: rusdronenv (big blind) folded before Flop
Seat 2: NutPopper collected ($15)
Seat 3: garougary folded before Flop (didn't bet)
Seat 4: mustanggino folded before Flop (didn't bet)
Seat 5: king10clubs (button) folded before Flop (didn't bet)
Seat 6: vjxbkf (small blind) folded before Flop


PokerStars Game #102594851133:  Hold'em No Limit ($3/$6 USD) - 2013/08/11 3:36:08 ET
Table 'Klemola 40-100 bb' 6-max Seat #6 is the button
Seat 1: rusdronenv ($984.35 in chips) 
Seat 2: NutPopper ($280.90 in chips) 
Seat 3: garougary ($72.58 in chips) 
Seat 4: mustanggino ($519.20 in chips) 
Seat 5: king10clubs ($785.07 in chips) 
Seat 6: vjxbkf ($600 in chips) 
rusdronenv: posts small blind $3
NutPopper: posts big blind $6
*** HOLE CARDS ***
garougary: folds 
mustanggino: folds 
king10clubs: folds 
vjxbkf: raises $6 to $12
rusdronenv: folds 
NutPopper: folds 
Uncalled bet ($6) returned to vjxbkf
vjxbkf collected $15 from pot
vjxbkf: doesn't show hand 
*** SUMMARY ***
Total pot $15 | Rake $0 
Seat 1: rusdronenv (small blind) folded before Flop
Seat 2: NutPopper (big blind) folded before Flop
Seat 3: garougary folded before Flop (didn't bet)
Seat 4: mustanggino folded before Flop (didn't bet)
Seat 5: king10clubs folded before Flop (didn't bet)
Seat 6: vjxbkf (button) collected ($15)


PokerStars Game #102594862748:  Hold'em No Limit ($3/$6 USD) - 2013/08/11 3:36:41 ET
Table 'Klemola 40-100 bb' 6-max Seat #1 is the button
Seat 1: rusdronenv ($981.35 in chips) 
Seat 2: NutPopper ($274.90 in chips) 
Seat 3: garougary ($72.58 in chips) 
Seat 4: mustanggino ($519.20 in chips) 
Seat 5: king10clubs ($785.07 in chips) 
Seat 6: vjxbkf ($609 in chips) 
NutPopper: posts small blind $3
garougary: posts big blind $6
*** HOLE CARDS ***
mustanggino: folds 
king10clubs: folds 
vjxbkf: folds 
rusdronenv: raises $6 to $12
NutPopper: folds 
garougary: calls $6
*** FLOP *** [7h 8s Qh]
garougary: checks 
rusdronenv: checks 
*** TURN *** [7h 8s Qh] [Th]
garougary: bets $6
rusdronenv: calls $6
*** RIVER *** [7h 8s Qh Th] [6d]
garougary: bets $12
rusdronenv: folds 
Uncalled bet ($12) returned to garougary
garougary collected $37.24 from pot
garougary: doesn't show hand 
*** SUMMARY ***
Total pot $39 | Rake $1.76 
Board [7h 8s Qh Th 6d]
Seat 1: rusdronenv (button) folded on the River
Seat 2: NutPopper (small blind) folded before Flop
Seat 3: garougary (big blind) collected ($37.24)
Seat 4: mustanggino folded before Flop (didn't bet)
Seat 5: king10clubs folded before Flop (didn't bet)
Seat 6: vjxbkf folded before Flop (didn't bet)


PokerStars Game #102594884220:  Hold'em No Limit ($3/$6 USD) - 2013/08/11 3:37:44 ET
Table 'Klemola 40-100 bb' 6-max Seat #2 is the button
Seat 1: rusdronenv ($963.35 in chips) 
Seat 2: NutPopper ($271.90 in chips) 
Seat 3: garougary ($91.82 in chips) 
Seat 4: mustanggino ($519.20 in chips) 
Seat 5: king10clubs ($785.07 in chips) 
Seat 6: vjxbkf ($609 in chips) 
garougary: posts small blind $3
mustanggino: posts big blind $6
*** HOLE CARDS ***
king10clubs: folds 
vjxbkf: folds 
rusdronenv: folds 
NutPopper: folds 
garougary: folds 
Uncalled bet ($3) returned to mustanggino
mustanggino collected $6 from pot
mustanggino: doesn't show hand 
*** SUMMARY ***
Total pot $6 | Rake $0 
Seat 1: rusdronenv folded before Flop (didn't bet)
Seat 2: NutPopper (button) folded before Flop (didn't bet)
Seat 3: garougary (small blind) folded before Flop
Seat 4: mustanggino (big blind) collected ($6)
Seat 5: king10clubs folded before Flop (didn't bet)
Seat 6: vjxbkf folded before Flop (didn't bet)


PokerStars Game #102594896745:  Hold'em No Limit ($3/$6 USD) - 2013/08/11 3:38:20 ET
Table 'Klemola 40-100 bb' 6-max Seat #3 is the button
Seat 1: rusdronenv ($963.35 in chips) 
Seat 2: NutPopper ($271.90 in chips) 
Seat 3: garougary ($88.82 in chips) 
Seat 4: mustanggino ($522.20 in chips) 
Seat 5: king10clubs ($785.07 in chips) 
Seat 6: vjxbkf ($609 in chips) 
mustanggino: posts small blind $3
king10clubs: posts big blind $6
*** HOLE CARDS ***
vjxbkf: folds 
rusdronenv: folds 
NutPopper: folds 
garougary: raises $6 to $12
mustanggino: folds 
king10clubs: folds 
Uncalled bet ($6) returned to garougary
garougary collected $15 from pot
garougary: doesn't show hand 
*** SUMMARY ***
Total pot $15 | Rake $0 
Seat 1: rusdronenv folded before Flop (didn't bet)
Seat 2: NutPopper folded before Flop (didn't bet)
Seat 3: garougary (button) collected ($15)
Seat 4: mustanggino (small blind) folded before Flop
Seat 5: king10clubs (big blind) folded before Flop
Seat 6: vjxbkf folded before Flop (didn't bet)


PokerStars Game #102594907651:  Hold'em No Limit ($3/$6 USD) - 2013/08/11 3:38:52 ET
Table 'Klemola 40-100 bb' 6-max Seat #4 is the button
Seat 1: rusdronenv ($963.35 in chips) 
Seat 2: NutPopper ($271.90 in chips) 
Seat 3: garougary ($97.82 in chips) 
Seat 4: mustanggino ($519.20 in chips) 
Seat 5: king10clubs ($779.07 in chips) 
Seat 6: vjxbkf ($609 in chips) 
king10clubs: posts small blind $3
vjxbkf: posts big blind $6
*** HOLE CARDS ***
rusdronenv: folds 
NutPopper: raises $6 to $12
garougary: folds 
mustanggino: folds 
king10clubs: folds 
vjxbkf: calls $6
*** FLOP *** [Qh Js 3c]
vjxbkf: bets $21
NutPopper: raises $27 to $48
vjxbkf: calls $27
*** TURN *** [Qh Js 3c] [3s]
vjxbkf: checks 
NutPopper: bets $96
vjxbkf: folds 
Uncalled bet ($96) returned to NutPopper
NutPopper collected $120.20 from pot
NutPopper: doesn't show hand 
*** SUMMARY ***
Total pot $123 | Rake $2.80 
Board [Qh Js 3c 3s]
Seat 1: rusdronenv folded before Flop (didn't bet)
Seat 2: NutPopper collected ($120.20)
Seat 3: garougary folded before Flop (didn't bet)
Seat 4: mustanggino (button) folded before Flop (didn't bet)
Seat 5: king10clubs (small blind) folded before Flop
Seat 6: vjxbkf (big blind) folded on the Turn


PokerStars Game #102594755497:  Hold'em No Limit ($3/$6 USD) - 2013/08/11 3:31:24 ET
Table 'Klemola 40-100 bb' 6-max Seat #1 is the button
Seat 1: rusdronenv ($990.35 in chips) 
Seat 2: NutPopper ($265.90 in chips) 
Seat 3: garougary ($81.58 in chips) 
Seat 4: mustanggino ($450 in chips) 
Seat 5: king10clubs ($851.07 in chips) 
Seat 6: vjxbkf ($600 in chips) 
NutPopper: posts small blind $3
garougary: posts big blind $6
*** HOLE CARDS ***
mustanggino: folds 
king10clubs: raises $9 to $15
vjxbkf: folds 
rusdronenv: folds 
NutPopper: folds 
garougary: folds 
Uncalled bet ($9) returned to king10clubs
king10clubs collected $15 from pot
king10clubs: doesn't show hand 
*** SUMMARY ***
Total pot $15 | Rake $0 
Seat 1: rusdronenv (button) folded before Flop (didn't bet)
Seat 2: NutPopper (small blind) folded before Flop
Seat 3: garougary (big blind) folded before Flop
Seat 4: mustanggino folded before Flop (didn't bet)
Seat 5: king10clubs collected ($15)
Seat 6: vjxbkf folded before Flop (didn't bet)


PokerStars Game #102594767833:  Hold'em No Limit ($3/$6 USD) - 2013/08/11 3:32:01 ET
Table 'Klemola 40-100 bb' 6-max Seat #2 is the button
Seat 1: rusdronenv ($990.35 in chips) 
Seat 2: NutPopper ($262.90 in chips) 
Seat 3: garougary ($75.58 in chips) 
Seat 4: mustanggino ($450 in chips) 
Seat 5: king10clubs ($860.07 in chips) 
Seat 6: vjxbkf ($600 in chips) 
garougary: posts small blind $3
mustanggino: posts big blind $6
*** HOLE CARDS ***
king10clubs: folds 
vjxbkf: folds 
rusdronenv: folds 
NutPopper: raises $6 to $12
garougary: folds 
mustanggino: folds 
Uncalled bet ($6) returned to NutPopper
NutPopper collected $15 from pot
NutPopper: doesn't show hand 
*** SUMMARY ***
Total pot $15 | Rake $0 
Seat 1: rusdronenv folded before Flop (didn't bet)
Seat 2: NutPopper (button) collected ($15)
Seat 3: garougary (small blind) folded before Flop
Seat 4: mustanggino (big blind) folded before Flop
Seat 5: king10clubs folded before Flop (didn't bet)
Seat 6: vjxbkf folded before Flop (didn't bet)


PokerStars Game #102594779306:  Hold'em No Limit ($3/$6 USD) - 2013/08/11 3:32:35 ET
Table 'Klemola 40-100 bb' 6-max Seat #3 is the button
Seat 1: rusdronenv ($990.35 in chips) 
Seat 2: NutPopper ($271.90 in chips) 
Seat 3: garougary ($72.58 in chips) 
Seat 4: mustanggino ($450 in chips) 
Seat 5: king10clubs ($860.07 in chips) 
Seat 6: vjxbkf ($600 in chips) 
mustanggino: posts small blind $3
king10clubs: posts big blind $6
*** HOLE CARDS ***
vjxbkf: folds 
rusdronenv: folds 
NutPopper: folds 
garougary: folds 
mustanggino: raises $6 to $12
king10clubs: raises $30 to $42
mustanggino: calls $30
*** FLOP *** [2c 6s Ah]
mustanggino: checks 
king10clubs: bets $30
mustanggino: raises $54 to $84
king10clubs: folds 
Uncalled bet ($54) returned to mustanggino
mustanggino collected $141.20 from pot
mustanggino: doesn't show hand 
*** SUMMARY ***
Total pot $144 | Rake $2.80 
Board [2c 6s Ah]
Seat 1: rusdronenv folded before Flop (didn't bet)
Seat 2: NutPopper folded before Flop (didn't bet)
Seat 3: garougary (button) folded before Flop (didn't bet)
Seat 4: mustanggino (small blind) collected ($141.20)
Seat 5: king10clubs (big blind) folded on the Flop
Seat 6: vjxbkf folded before Flop (didn't bet)


PokerStars Game #102595166338:  Hold'em No Limit ($3/$6 USD) - 2013/08/11 3:51:15 ET
Table 'Klemola 40-100 bb' 6-max Seat #4 is the button
Seat 1: rusdronenv ($939.35 in chips) 
Seat 2: NutPopper ($305.20 in chips) 
Seat 3: garougary ($119.63 in chips) 
Seat 4: mustanggino ($460.98 in chips) 
Seat 5: king10clubs ($809.91 in chips) 
Seat 6: vjxbkf ($645.20 in chips) 
king10clubs: posts small blind $3
vjxbkf: posts big blind $6
*** HOLE CARDS ***
rusdronenv: folds 
NutPopper: folds 
garougary: raises $6 to $12
mustanggino: folds 
king10clubs: raises $36 to $48
vjxbkf: folds 
garougary: folds 
Uncalled bet ($36) returned to king10clubs
king10clubs collected $30 from pot
king10clubs: doesn't show hand 
*** SUMMARY ***
Total pot $30 | Rake $0 
Seat 1: rusdronenv folded before Flop (didn't bet)
Seat 2: NutPopper folded before Flop (didn't bet)
Seat 3: garougary folded before Flop
Seat 4: mustanggino (button) folded before Flop (didn't bet)
Seat 5: king10clubs (small blind) collected ($30)
Seat 6: vjxbkf (big blind) folded before Flop


PokerStars Game #102595178507:  Hold'em No Limit ($3/$6 USD) - 2013/08/11 3:51:50 ET
Table 'Klemola 40-100 bb' 6-max Seat #5 is the button
Seat 1: rusdronenv ($939.35 in chips) 
Seat 2: NutPopper ($305.20 in chips) 
Seat 3: garougary ($107.63 in chips) 
Seat 4: mustanggino ($460.98 in chips) 
Seat 5: king10clubs ($827.91 in chips) 
Seat 6: vjxbkf ($639.20 in chips) 
vjxbkf: posts small blind $3
rusdronenv: posts big blind $6
*** HOLE CARDS ***
NutPopper: raises $6 to $12
garougary: folds 
mustanggino: folds 
king10clubs: folds 
vjxbkf: folds 
rusdronenv: calls $6
*** FLOP *** [6d Kd Qh]
rusdronenv: checks 
NutPopper: bets $18
rusdronenv: raises $36 to $54
NutPopper: raises $48 to $102
rusdronenv: raises $636 to $738
NutPopper: calls $191.20 and is all-in
Uncalled bet ($444.80) returned to rusdronenv
*** TURN *** [6d Kd Qh] [Ah]
*** RIVER *** [6d Kd Qh Ah] [Th]
*** SHOW DOWN ***
rusdronenv: shows [Kh Qc] (two pair, Kings and Queens)
NutPopper: shows [Qd Jd] (a straight, Ten to Ace)
NutPopper collected $610.60 from pot
*** SUMMARY ***
Total pot $613.40 | Rake $2.80 
Board [6d Kd Qh Ah Th]
Seat 1: rusdronenv (big blind) showed [Kh Qc] and lost with two pair, Kings and Queens
Seat 2: NutPopper showed [Qd Jd] and won ($610.60) with a straight, Ten to Ace
Seat 3: garougary folded before Flop (didn't bet)
Seat 4: mustanggino folded before Flop (didn't bet)
Seat 5: king10clubs (button) folded before Flop (didn't bet)
Seat 6: vjxbkf (small blind) folded before Flop


PokerStars Game #102595203634:  Hold'em No Limit ($3/$6 USD) - 2013/08/11 3:53:01 ET
Table 'Klemola 40-100 bb' 6-max Seat #6 is the button
Seat 1: rusdronenv ($634.15 in chips) 
Seat 2: NutPopper ($610.60 in chips) 
Seat 3: garougary ($107.63 in chips) 
Seat 4: mustanggino ($460.98 in chips) 
Seat 5: king10clubs ($827.91 in chips) 
Seat 6: vjxbkf ($636.20 in chips) 
rusdronenv: posts small blind $3
NutPopper: posts big blind $6
*** HOLE CARDS ***
garougary: folds 
mustanggino: folds 
king10clubs: raises $9 to $15
vjxbkf: calls $15
rusdronenv: folds 
NutPopper: folds 
*** FLOP *** [6s Jc 5h]
king10clubs: checks 
vjxbkf: bets $21
king10clubs: calls $21
*** TURN *** [6s Jc 5h] [3h]
king10clubs: checks 
vjxbkf: bets $54
king10clubs: calls $54
*** RIVER *** [6s Jc 5h 3h] [Ac]
king10clubs: checks 
vjxbkf: checks 
*** SHOW DOWN ***
king10clubs: shows [6c 9c] (a pair of Sixes)
vjxbkf: mucks hand 
king10clubs collected $186.20 from pot
*** SUMMARY ***
Total pot $189 | Rake $2.80 
Board [6s Jc 5h 3h Ac]
Seat 1: rusdronenv (small blind) folded before Flop
Seat 2: NutPopper (big blind) folded before Flop
Seat 3: garougary folded before Flop (didn't bet)
Seat 4: mustanggino folded before Flop (didn't bet)
Seat 5: king10clubs showed [6c 9c] and won ($186.20) with a pair of Sixes
Seat 6: vjxbkf (button) mucked


PokerStars Game #102595041424:  Hold'em No Limit ($3/$6 USD) - 2013/08/11 3:45:19 ET
Table 'Klemola 40-100 bb' 6-max Seat #4 is the button
Seat 1: rusdronenv ($948.35 in chips) 
Seat 2: NutPopper ($311.10 in chips) 
Seat 3: garougary ($122.53 in chips) 
Seat 4: mustanggino ($489.20 in chips) 
Seat 6: vjxbkf ($600 in chips) 
vjxbkf: posts small blind $3
rusdronenv: posts big blind $6
*** HOLE CARDS ***
NutPopper: folds 
garougary: folds 
mustanggino: folds 
vjxbkf: raises $18 to $24
rusdronenv: folds 
Uncalled bet ($18) returned to vjxbkf
vjxbkf collected $12 from pot
vjxbkf: doesn't show hand 
*** SUMMARY ***
Total pot $12 | Rake $0 
Seat 1: rusdronenv (big blind) folded before Flop
Seat 2: NutPopper folded before Flop (didn't bet)
Seat 3: garougary folded before Flop (didn't bet)
Seat 4: mustanggino (button) folded before Flop (didn't bet)
Seat 6: vjxbkf (small blind) collected ($12)


PokerStars Game #102595060570:  Hold'em No Limit ($3/$6 USD) - 2013/08/11 3:46:13 ET
Table 'Klemola 40-100 bb' 6-max Seat #6 is the button
Seat 1: rusdronenv ($942.35 in chips) 
Seat 2: NutPopper ($311.10 in chips) 
Seat 3: garougary ($122.53 in chips) 
Seat 4: mustanggino ($489.20 in chips) 
Seat 6: vjxbkf ($606 in chips) 
rusdronenv: posts small blind $3
NutPopper: posts big blind $6
*** HOLE CARDS ***
garougary: raises $6 to $12
mustanggino: folds 
vjxbkf: folds 
rusdronenv: folds 
NutPopper: folds 
Uncalled bet ($6) returned to garougary
garougary collected $15 from pot
garougary: doesn't show hand 
*** SUMMARY ***
Total pot $15 | Rake $0 
Seat 1: rusdronenv (small blind) folded before Flop
Seat 2: NutPopper (big blind) folded before Flop
Seat 3: garougary collected ($15)
Seat 4: mustanggino folded before Flop (didn't bet)
Seat 6: vjxbkf (button) folded before Flop (didn't bet)


PokerStars Game #102595072909:  Hold'em No Limit ($3/$6 USD) - 2013/08/11 3:46:48 ET
Table 'Klemola 40-100 bb' 6-max Seat #1 is the button
Seat 1: rusdronenv ($939.35 in chips) 
Seat 2: NutPopper ($305.10 in chips) 
Seat 3: garougary ($131.53 in chips) 
Seat 4: mustanggino ($489.20 in chips) 
Seat 6: vjxbkf ($606 in chips) 
NutPopper: posts small blind $3
garougary: posts big blind $6
*** HOLE CARDS ***
mustanggino: raises $6 to $12
vjxbkf: folds 
rusdronenv: folds 
NutPopper: folds 
garougary: calls $6
*** FLOP *** [Ks 6c 2h]
garougary: checks 
mustanggino: bets $12
garougary: folds 
Uncalled bet ($12) returned to mustanggino
mustanggino collected $25.78 from pot
mustanggino: doesn't show hand 
*** SUMMARY ***
Total pot $27 | Rake $1.22 
Board [Ks 6c 2h]
Seat 1: rusdronenv (button) folded before Flop (didn't bet)
Seat 2: NutPopper (small blind) folded before Flop
Seat 3: garougary (big blind) folded on the Flop
Seat 4: mustanggino collected ($25.78)
Seat 6: vjxbkf folded before Flop (didn't bet)


PokerStars Game #102595088379:  Hold'em No Limit ($3/$6 USD) - 2013/08/11 3:47:33 ET
Table 'Klemola 40-100 bb' 6-max Seat #2 is the button
Seat 1: rusdronenv ($939.35 in chips) 
Seat 2: NutPopper ($302.10 in chips) 
Seat 3: garougary ($119.53 in chips) 
Seat 4: mustanggino ($502.98 in chips) 
Seat 6: vjxbkf ($606 in chips) 
garougary: posts small blind $3
mustanggino: posts big blind $6
king10clubs: sits out 
*** HOLE CARDS ***
vjxbkf: raises $12 to $18
rusdronenv: folds 
NutPopper: folds 
garougary: folds 
mustanggino: calls $12
*** FLOP *** [Js 2h 9h]
mustanggino: checks 
vjxbkf: bets $21
mustanggino: calls $21
*** TURN *** [Js 2h 9h] [2d]
mustanggino: checks 
vjxbkf: bets $54
mustanggino: folds 
Uncalled bet ($54) returned to vjxbkf
vjxbkf collected $78.20 from pot
vjxbkf: doesn't show hand 
*** SUMMARY ***
Total pot $81 | Rake $2.80 
Board [Js 2h 9h 2d]
Seat 1: rusdronenv folded before Flop (didn't bet)
Seat 2: NutPopper (button) folded before Flop (didn't bet)
Seat 3: garougary (small blind) folded before Flop
Seat 4: mustanggino (big blind) folded on the Turn
Seat 6: vjxbkf collected ($78.20)


PokerStars Game #102595137322:  Hold'em No Limit ($3/$6 USD) - 2013/08/11 3:49:53 ET
Table 'Klemola 40-100 bb' 6-max Seat #3 is the button
Seat 1: rusdronenv ($939.35 in chips) 
Seat 2: NutPopper ($302.10 in chips) 
Seat 3: garougary ($116.53 in chips) 
Seat 4: mustanggino ($463.98 in chips) 
Seat 5: king10clubs ($815.91 in chips) 
Seat 6: vjxbkf ($645.20 in chips) 
mustanggino: posts small blind $3
king10clubs: posts big blind $6
*** HOLE CARDS ***
vjxbkf: folds 
rusdronenv: folds 
NutPopper: raises $6 to $12
garougary: raises $12 to $24
mustanggino: folds 
king10clubs: folds 
NutPopper: raises $48 to $72
garougary: calls $48
*** FLOP *** [Qd Td 4h]
NutPopper: bets $230.10 and is all-in
garougary: calls $44.53 and is all-in
Uncalled bet ($185.57) returned to NutPopper
*** FIRST TURN *** [Qd Td 4h] [5c]
*** FIRST RIVER *** [Qd Td 4h 5c] [8d]
*** SECOND TURN *** [Qd Td 4h] [8s]
*** SECOND RIVER *** [Qd Td 4h 8s] [Ks]
*** FIRST SHOW DOWN ***
NutPopper: shows [Kc Ad] (high card Ace)
garougary: shows [Tc 7c] (a pair of Tens)
garougary collected $119.63 from pot
*** SECOND SHOW DOWN ***
NutPopper: shows [Kc Ad] (a pair of Kings)
garougary: shows [Tc 7c] (a pair of Tens)
NutPopper collected $119.63 from pot
*** SUMMARY ***
Total pot $242.06 | Rake $2.80 
Hand was run twice
FIRST Board [Qd Td 4h 5c 8d]
SECOND Board [Qd Td 4h 8s Ks]
Seat 1: rusdronenv folded before Flop (didn't bet)
Seat 2: NutPopper showed [Kc Ad] and lost with high card Ace, and won ($119.63) with a pair of Kings
Seat 3: garougary (button) showed [Tc 7c] and won ($119.63) with a pair of Tens, and lost with a pair of Tens
Seat 4: mustanggino (small blind) folded before Flop
Seat 5: king10clubs (big blind) folded before Flop
Seat 6: vjxbkf folded before Flop (didn't bet)


PokerStars Game #102595558880:  Hold'em No Limit ($3/$6 USD) - 2013/08/11 4:10:01 ET
Table 'Klemola 40-100 bb' 6-max Seat #2 is the button
Seat 1: checkitout12 ($283.68 in chips) 
Seat 2: Nemo & co ($351.82 in chips) 
Seat 5: king10clubs ($1093.61 in chips) 
Seat 6: floriiiiider ($600 in chips) 
king10clubs: posts small blind $3
floriiiiider: posts big blind $6
*** HOLE CARDS ***
checkitout12: folds 
Nemo & co: raises $12 to $18
king10clubs: folds 
floriiiiider: folds 
Uncalled bet ($12) returned to Nemo & co
Nemo & co collected $15 from pot
*** SUMMARY ***
Total pot $15 | Rake $0 
Seat 1: checkitout12 folded before Flop (didn't bet)
Seat 2: Nemo & co (button) collected ($15)
Seat 5: king10clubs (small blind) folded before Flop
Seat 6: floriiiiider (big blind) folded before Flop


PokerStars Game #102595566604:  Hold'em No Limit ($3/$6 USD) - 2013/08/11 4:10:22 ET
Table 'Klemola 40-100 bb' 6-max Seat #5 is the button
Seat 2: Nemo & co ($360.82 in chips) 
Seat 5: king10clubs ($1090.61 in chips) 
Seat 6: floriiiiider ($600 in chips) 
floriiiiider: posts small blind $3
checkitout12: is sitting out 
Nemo & co: posts big blind $6
*** HOLE CARDS ***
king10clubs: raises $6 to $12
floriiiiider: folds 
Nemo & co: calls $6
*** FLOP *** [6d Th 6c]
Nemo & co: checks 
king10clubs: bets $18
Nemo & co: folds 
Uncalled bet ($18) returned to king10clubs
king10clubs collected $25.78 from pot
king10clubs: doesn't show hand 
*** SUMMARY ***
Total pot $27 | Rake $1.22 
Board [6d Th 6c]
Seat 2: Nemo & co (big blind) folded on the Flop
Seat 5: king10clubs (button) collected ($25.78)
Seat 6: floriiiiider (small blind) folded before Flop


PokerStars Game #102595579246:  Hold'em No Limit ($3/$6 USD) - 2013/08/11 4:10:58 ET
Table 'Klemola 40-100 bb' 6-max Seat #6 is the button
Seat 2: Nemo & co ($348.82 in chips) 
Seat 4: mustanggino ($465 in chips) 
Seat 5: king10clubs ($1104.39 in chips) 
Seat 6: floriiiiider ($600 in chips) 
Nemo & co: posts small blind $3
mustanggino: posts big blind $6
*** HOLE CARDS ***
king10clubs: folds 
floriiiiider: folds 
checkitout12 leaves the table
Nemo & co: raises $6 to $12
ZarubaNT joins the table at seat #1 
mustanggino: calls $6
*** FLOP *** [6d 3s Qh]
Nemo & co: checks 
mustanggino: bets $12
Nemo & co: calls $12
*** TURN *** [6d 3s Qh] [5c]
Nemo & co: checks 
mustanggino: checks 
*** RIVER *** [6d 3s Qh 5c] [Kc]
Nemo & co: bets $18
mustanggino: folds 
Uncalled bet ($18) returned to Nemo & co
Nemo & co collected $46.50 from pot
*** SUMMARY ***
Total pot $48 | Rake $1.50 
Board [6d 3s Qh 5c Kc]
Seat 2: Nemo & co (small blind) collected ($46.50)
Seat 4: mustanggino (big blind) folded on the River
Seat 5: king10clubs folded before Flop (didn't bet)
Seat 6: floriiiiider (button) folded before Flop (didn't bet)


PokerStars Game #102595609106:  Hold'em No Limit ($3/$6 USD) - 2013/08/11 4:12:22 ET
Table 'Klemola 40-100 bb' 6-max Seat #2 is the button
Seat 2: Nemo & co ($371.32 in chips) 
Seat 4: mustanggino ($450 in chips) 
Seat 5: king10clubs ($1104.39 in chips) 
Seat 6: floriiiiider ($600 in chips) 
mustanggino: posts small blind $3
king10clubs: posts big blind $6
ZarubaNT: sits out 
*** HOLE CARDS ***
floriiiiider: folds 
Nemo & co: raises $6 to $12
mustanggino: folds 
king10clubs: folds 
Uncalled bet ($6) returned to Nemo & co
Nemo & co collected $15 from pot
*** SUMMARY ***
Total pot $15 | Rake $0 
Seat 2: Nemo & co (button) collected ($15)
Seat 4: mustanggino (small blind) folded before Flop
Seat 5: king10clubs (big blind) folded before Flop
Seat 6: floriiiiider folded before Flop (didn't bet)


PokerStars Game #102595620194:  Hold'em No Limit ($3/$6 USD) - 2013/08/11 4:12:53 ET
Table 'Klemola 40-100 bb' 6-max Seat #4 is the button
Seat 2: Nemo & co ($380.32 in chips) 
Seat 4: mustanggino ($450 in chips) 
Seat 5: king10clubs ($1098.39 in chips) 
Seat 6: floriiiiider ($600 in chips) 
king10clubs: posts small blind $3
floriiiiider: posts big blind $6
ZarubaNT: sits out 
*** HOLE CARDS ***
Nemo & co: folds 
mustanggino: raises $6 to $12
king10clubs: folds 
floriiiiider: folds 
Uncalled bet ($6) returned to mustanggino
mustanggino collected $15 from pot
mustanggino: doesn't show hand 
*** SUMMARY ***
Total pot $15 | Rake $0 
Seat 2: Nemo & co folded before Flop (didn't bet)
Seat 4: mustanggino (button) collected ($15)
Seat 5: king10clubs (small blind) folded before Flop
Seat 6: floriiiiider (big blind) folded before Flop


PokerStars Game #102595626896:  Hold'em No Limit ($3/$6 USD) - 2013/08/11 4:13:12 ET
Table 'Klemola 40-100 bb' 6-max Seat #5 is the button
Seat 1: ZarubaNT ($600 in chips) 
Seat 2: Nemo & co ($380.32 in chips) 
Seat 4: mustanggino ($459 in chips) 
Seat 5: king10clubs ($1095.39 in chips) 
Seat 6: floriiiiider ($600 in chips) 
floriiiiider: posts small blind $3
ZarubaNT: posts big blind $6
*** HOLE CARDS ***
Nemo & co: folds 
mustanggino: raises $6 to $12
king10clubs: folds 
floriiiiider: folds 
ZarubaNT: calls $6
*** FLOP *** [Kh Qd 5s]
ZarubaNT: checks 
mustanggino: bets $12
ZarubaNT: folds 
Uncalled bet ($12) returned to mustanggino
mustanggino collected $25.78 from pot
mustanggino: doesn't show hand 
*** SUMMARY ***
Total pot $27 | Rake $1.22 
Board [Kh Qd 5s]
Seat 1: ZarubaNT (big blind) folded on the Flop
Seat 2: Nemo & co folded before Flop (didn't bet)
Seat 4: mustanggino collected ($25.78)
Seat 5: king10clubs (button) folded before Flop (didn't bet)
Seat 6: floriiiiider (small blind) folded before Flop


PokerStars Game #102595647704:  Hold'em No Limit ($3/$6 USD) - 2013/08/11 4:14:11 ET
Table 'Klemola 40-100 bb' 6-max Seat #6 is the button
Seat 1: ZarubaNT ($600 in chips) 
Seat 2: Nemo & co ($380.32 in chips) 
Seat 4: mustanggino ($472.78 in chips) 
Seat 5: king10clubs ($1095.39 in chips) 
Seat 6: floriiiiider ($600 in chips) 
ZarubaNT: posts small blind $3
Nemo & co: posts big blind $6
*** HOLE CARDS ***
mustanggino: raises $6 to $12
king10clubs: folds 
floriiiiider: calls $12
ZarubaNT: folds 
Nemo & co: folds 
*** FLOP *** [Qs 6s 2s]
mustanggino: bets $18
floriiiiider: folds 
Uncalled bet ($18) returned to mustanggino
mustanggino collected $31.52 from pot
mustanggino: doesn't show hand 
*** SUMMARY ***
Total pot $33 | Rake $1.48 
Board [Qs 6s 2s]
Seat 1: ZarubaNT (small blind) folded before Flop
Seat 2: Nemo & co (big blind) folded before Flop
Seat 4: mustanggino collected ($31.52)
Seat 5: king10clubs folded before Flop (didn't bet)
Seat 6: floriiiiider (button) folded on the Flop


PokerStars Game #102595659983:  Hold'em No Limit ($3/$6 USD) - 2013/08/11 4:14:45 ET
Table 'Klemola 40-100 bb' 6-max Seat #1 is the button
Seat 1: ZarubaNT ($600 in chips) 
Seat 2: Nemo & co ($374.32 in chips) 
Seat 4: mustanggino ($492.30 in chips) 
Seat 5: king10clubs ($1095.39 in chips) 
Seat 6: floriiiiider ($600 in chips) 
Nemo & co: posts small blind $3
mustanggino: posts big blind $6
*** HOLE CARDS ***
king10clubs: folds 
floriiiiider: folds 
ZarubaNT: folds 
Nemo & co: folds 
Uncalled bet ($3) returned to mustanggino
mustanggino collected $6 from pot
mustanggino: doesn't show hand 
*** SUMMARY ***
Total pot $6 | Rake $0 
Seat 1: ZarubaNT (button) folded before Flop (didn't bet)
Seat 2: Nemo & co (small blind) folded before Flop
Seat 4: mustanggino (big blind) collected ($6)
Seat 5: king10clubs folded before Flop (didn't bet)
Seat 6: floriiiiider folded before Flop (didn't bet)


PokerStars Game #102595505826:  Hold'em No Limit ($3/$6 USD) - 2013/08/11 4:07:35 ET
Table 'Klemola 40-100 bb' 6-max Seat #6 is the button
Seat 1: checkitout12 ($240 in chips) 
Seat 2: Nemo & co ($400 in chips) 
Seat 5: king10clubs ($1099.61 in chips) 
Seat 6: vjxbkf ($600 in chips) 
checkitout12: posts small blind $3
Nemo & co: posts big blind $6
mustanggino: sits out 
*** HOLE CARDS ***
king10clubs: folds 
vjxbkf: folds 
checkitout12: raises $6.18 to $12.18
Nemo & co: calls $6.18
*** FLOP *** [Jh 2c 3h]
checkitout12: bets $16.28
Nemo & co: raises $25.72 to $42
checkitout12: raises $185.82 to $227.82 and is all-in
Nemo & co: folds 
Uncalled bet ($185.82) returned to checkitout12
checkitout12 collected $106.86 from pot
checkitout12: doesn't show hand 
*** SUMMARY ***
Total pot $108.36 | Rake $1.50 
Board [Jh 2c 3h]
Seat 1: checkitout12 (small blind) collected ($106.86)
Seat 2: Nemo & co (big blind) folded on the Flop
Seat 5: king10clubs folded before Flop (didn't bet)
Seat 6: vjxbkf (button) folded before Flop (didn't bet)


PokerStars Game #102595525303:  Hold'em No Limit ($3/$6 USD) - 2013/08/11 4:08:28 ET
Table 'Klemola 40-100 bb' 6-max Seat #1 is the button
Seat 1: checkitout12 ($292.68 in chips) 
Seat 2: Nemo & co ($345.82 in chips) 
Seat 4: mustanggino ($450 in chips) 
Seat 5: king10clubs ($1099.61 in chips) 
Seat 6: vjxbkf ($600 in chips) 
Nemo & co: posts small blind $3
mustanggino: posts big blind $6
*** HOLE CARDS ***
king10clubs: folds 
vjxbkf: folds 
checkitout12: folds 
Nemo & co: raises $6 to $12
mustanggino: folds 
Uncalled bet ($6) returned to Nemo & co
Nemo & co collected $12 from pot
*** SUMMARY ***
Total pot $12 | Rake $0 
Seat 1: checkitout12 (button) folded before Flop (didn't bet)
Seat 2: Nemo & co (small blind) collected ($12)
Seat 4: mustanggino (big blind) folded before Flop
Seat 5: king10clubs folded before Flop (didn't bet)
Seat 6: vjxbkf folded before Flop (didn't bet)


PokerStars Game #102595534481:  Hold'em No Limit ($3/$6 USD) - 2013/08/11 4:08:54 ET
Table 'Klemola 40-100 bb' 6-max Seat #2 is the button
Seat 1: checkitout12 ($292.68 in chips) 
Seat 2: Nemo & co ($351.82 in chips) 
Seat 4: mustanggino ($450 in chips) 
Seat 5: king10clubs ($1099.61 in chips) 
Seat 6: vjxbkf ($600 in chips) 
mustanggino: posts small blind $3
king10clubs: posts big blind $6
*** HOLE CARDS ***
vjxbkf: folds 
checkitout12: folds 
Nemo & co: folds 
mustanggino: raises $6 to $12
king10clubs: folds 
Uncalled bet ($6) returned to mustanggino
mustanggino collected $12 from pot
mustanggino: doesn't show hand 
*** SUMMARY ***
Total pot $12 | Rake $0 
Seat 1: checkitout12 folded before Flop (didn't bet)
Seat 2: Nemo & co (button) folded before Flop (didn't bet)
Seat 4: mustanggino (small blind) collected ($12)
Seat 5: king10clubs (big blind) folded before Flop
Seat 6: vjxbkf folded before Flop (didn't bet)


PokerStars Game #102595541427:  Hold'em No Limit ($3/$6 USD) - 2013/08/11 4:09:12 ET
Table 'Klemola 40-100 bb' 6-max Seat #4 is the button
Seat 1: checkitout12 ($292.68 in chips) 
Seat 2: Nemo & co ($351.82 in chips) 
Seat 4: mustanggino ($456 in chips) 
Seat 5: king10clubs ($1093.61 in chips) 
king10clubs: posts small blind $3
vjxbkf: is sitting out 
checkitout12: posts big blind $6
*** HOLE CARDS ***
vjxbkf leaves the table
Nemo & co: raises $12 to $18
mustanggino: folds 
king10clubs: folds 
checkitout12: folds 
Uncalled bet ($12) returned to Nemo & co
Nemo & co collected $15 from pot
floriiiiider joins the table at seat #6 
*** SUMMARY ***
Total pot $15 | Rake $0 
Seat 1: checkitout12 (big blind) folded before Flop
Seat 2: Nemo & co collected ($15)
Seat 4: mustanggino (button) folded before Flop (didn't bet)
Seat 5: king10clubs (small blind) folded before Flop


PokerStars Game #102595549085:  Hold'em No Limit ($3/$6 USD) - 2013/08/11 4:09:34 ET
Table 'Klemola 40-100 bb' 6-max Seat #5 is the button
Seat 1: checkitout12 ($286.68 in chips) 
Seat 2: Nemo & co ($360.82 in chips) 
Seat 4: mustanggino ($456 in chips) 
Seat 5: king10clubs ($1090.61 in chips) 
floriiiiider will be allowed to play after the button
checkitout12: posts small blind $3
Nemo & co: posts big blind $6
*** HOLE CARDS ***
mustanggino: raises $6 to $12
king10clubs: folds 
checkitout12: folds 
Nemo & co: folds 
Uncalled bet ($6) returned to mustanggino
mustanggino collected $15 from pot
mustanggino: doesn't show hand 
*** SUMMARY ***
Total pot $15 | Rake $0 
Seat 1: checkitout12 (small blind) folded before Flop
Seat 2: Nemo & co (big blind) folded before Flop
Seat 4: mustanggino collected ($15)
Seat 5: king10clubs (button) folded before Flop (didn't bet)


PokerStars Game #102595556636:  Hold'em No Limit ($3/$6 USD) - 2013/08/11 4:09:55 ET
Table 'Klemola 40-100 bb' 6-max Seat #1 is the button
Seat 1: checkitout12 ($283.68 in chips) 
Seat 2: Nemo & co ($354.82 in chips) 
Seat 5: king10clubs ($1090.61 in chips) 
Nemo & co: posts small blind $3
mustanggino: is sitting out 
king10clubs: posts big blind $6
floriiiiider: sits out 
*** HOLE CARDS ***
checkitout12: folds 
Nemo & co: folds 
Uncalled bet ($3) returned to king10clubs
king10clubs collected $6 from pot
king10clubs: doesn't show hand 
*** SUMMARY ***
Total pot $6 | Rake $0 
Seat 1: checkitout12 (button) folded before Flop (didn't bet)
Seat 2: Nemo & co (small blind) folded before Flop
Seat 5: king10clubs (big blind) collected ($6)


PokerStars Game #102595363166:  Hold'em No Limit ($3/$6 USD) - 2013/08/11 4:01:14 ET
Table 'Klemola 40-100 bb' 6-max Seat #5 is the button
Seat 3: garougary ($319.14 in chips) 
Seat 4: mustanggino ($450 in chips) 
Seat 5: king10clubs ($915.11 in chips) 
Seat 6: vjxbkf ($600 in chips) 
vjxbkf: posts small blind $3
rusdronenv: is sitting out 
NutPopper: is sitting out 
garougary: posts big blind $6
*** HOLE CARDS ***
rusdronenv leaves the table
NutPopper leaves the table
mustanggino: folds 
checkitout12 joins the table at seat #1 
king10clubs: raises $6 to $12
vjxbkf: calls $9
garougary: calls $6
*** FLOP *** [Td 5c 3h]
vjxbkf: bets $27
garougary: folds 
king10clubs: folds 
Uncalled bet ($27) returned to vjxbkf
vjxbkf collected $34.50 from pot
vjxbkf: doesn't show hand 
*** SUMMARY ***
Total pot $36 | Rake $1.50 
Board [Td 5c 3h]
Seat 3: garougary (big blind) folded on the Flop
Seat 4: mustanggino folded before Flop (didn't bet)
Seat 5: king10clubs (button) folded on the Flop
Seat 6: vjxbkf (small blind) collected ($34.50)


PokerStars Game #102595374756:  Hold'em No Limit ($3/$6 USD) - 2013/08/11 4:01:46 ET
Table 'Klemola 40-100 bb' 6-max Seat #6 is the button
Seat 3: garougary ($307.14 in chips) 
Seat 5: king10clubs ($903.11 in chips) 
Seat 6: vjxbkf ($622.50 in chips) 
checkitout12 will be allowed to play after the button
garougary: posts small blind $3
mustanggino: is sitting out 
king10clubs: posts big blind $6
*** HOLE CARDS ***
vjxbkf: folds 
garougary: folds 
Uncalled bet ($3) returned to king10clubs
king10clubs collected $6 from pot
king10clubs: doesn't show hand 
*** SUMMARY ***
Total pot $6 | Rake $0 
Seat 3: garougary (small blind) folded before Flop
Seat 5: king10clubs (big blind) collected ($6)
Seat 6: vjxbkf (button) folded before Flop (didn't bet)


PokerStars Game #102595377442:  Hold'em No Limit ($3/$6 USD) - 2013/08/11 4:01:53 ET
Table 'Klemola 40-100 bb' 6-max Seat #3 is the button
Seat 3: garougary ($304.14 in chips) 
Seat 5: king10clubs ($906.11 in chips) 
Seat 6: vjxbkf ($622.50 in chips) 
king10clubs: posts small blind $3
vjxbkf: posts big blind $6
checkitout12: sits out 
*** HOLE CARDS ***
garougary: folds 
king10clubs: folds 
Uncalled bet ($3) returned to vjxbkf
vjxbkf collected $6 from pot
vjxbkf: doesn't show hand 
*** SUMMARY ***
Total pot $6 | Rake $0 
Seat 3: garougary (button) folded before Flop (didn't bet)
Seat 5: king10clubs (small blind) folded before Flop
Seat 6: vjxbkf (big blind) collected ($6)


PokerStars Game #102595380659:  Hold'em No Limit ($3/$6 USD) - 2013/08/11 4:02:01 ET
Table 'Klemola 40-100 bb' 6-max Seat #5 is the button
Seat 1: checkitout12 ($240 in chips) 
Seat 3: garougary ($304.14 in chips) 
Seat 5: king10clubs ($903.11 in chips) 
Seat 6: vjxbkf ($625.50 in chips) 
vjxbkf: posts small blind $3
checkitout12: posts big blind $6
*** HOLE CARDS ***
garougary: raises $6 to $12
king10clubs: folds 
vjxbkf: folds 
checkitout12: folds 
Uncalled bet ($6) returned to garougary
garougary collected $15 from pot
garougary: doesn't show hand 
*** SUMMARY ***
Total pot $15 | Rake $0 
Seat 1: checkitout12 (big blind) folded before Flop
Seat 3: garougary collected ($15)
Seat 5: king10clubs (button) folded before Flop (didn't bet)
Seat 6: vjxbkf (small blind) folded before Flop


PokerStars Game #102595389758:  Hold'em No Limit ($3/$6 USD) - 2013/08/11 4:02:26 ET
Table 'Klemola 40-100 bb' 6-max Seat #6 is the button
Seat 1: checkitout12 ($240 in chips) 
Seat 3: garougary ($313.14 in chips) 
Seat 5: king10clubs ($903.11 in chips) 
Seat 6: vjxbkf ($622.50 in chips) 
checkitout12: posts small blind $3
garougary: posts big blind $6
*** HOLE CARDS ***
king10clubs: raises $9 to $15
vjxbkf: folds 
checkitout12: folds 
garougary: calls $9
*** FLOP *** [Ad 9c 5d]
garougary: checks 
Nemo & co joins the table at seat #2 
king10clubs: bets $18
garougary: calls $18
*** TURN *** [Ad 9c 5d] [5c]
garougary: checks 
king10clubs: checks 
*** RIVER *** [Ad 9c 5d 5c] [6s]
garougary: bets $48
king10clubs: folds 
Uncalled bet ($48) returned to garougary
garougary collected $67.50 from pot
garougary: doesn't show hand 
Nemo & co is disconnected 
*** SUMMARY ***
Total pot $69 | Rake $1.50 
Board [Ad 9c 5d 5c 6s]
Seat 1: checkitout12 (small blind) folded before Flop
Seat 3: garougary (big blind) collected ($67.50)
Seat 5: king10clubs folded on the River
Seat 6: vjxbkf (button) folded before Flop (didn't bet)


PokerStars Game #102595408080:  Hold'em No Limit ($3/$6 USD) - 2013/08/11 4:03:14 ET
Table 'Klemola 40-100 bb' 6-max Seat #1 is the button
Seat 1: checkitout12 ($240 in chips) 
Seat 3: garougary ($347.64 in chips) 
Seat 5: king10clubs ($870.11 in chips) 
Seat 6: vjxbkf ($622.50 in chips) 
Nemo & co will be allowed to play after the button
garougary: posts small blind $3
king10clubs: posts big blind $6
*** HOLE CARDS ***
vjxbkf: folds 
checkitout12: raises $6.18 to $12.18
garougary: raises $11.82 to $24
king10clubs: folds 
checkitout12: calls $11.82
*** FLOP *** [Tc 8s 3s]
garougary: bets $22
checkitout12: folds 
Uncalled bet ($22) returned to garougary
garougary collected $52.50 from pot
garougary: doesn't show hand 
*** SUMMARY ***
Total pot $54 | Rake $1.50 
Board [Tc 8s 3s]
Seat 1: checkitout12 (button) folded on the Flop
Seat 3: garougary (small blind) collected ($52.50)
Seat 5: king10clubs (big blind) folded before Flop
Seat 6: vjxbkf folded before Flop (didn't bet)


PokerStars Game #102595423927:  Hold'em No Limit ($3/$6 USD) - 2013/08/11 4:03:57 ET
Table 'Klemola 40-100 bb' 6-max Seat #3 is the button
Seat 1: checkitout12 ($240 in chips) 
Seat 3: garougary ($376.14 in chips) 
Seat 5: king10clubs ($864.11 in chips) 
Seat 6: vjxbkf ($622.50 in chips) 
mustanggino will be allowed to play after the button
king10clubs: posts small blind $3
vjxbkf: posts big blind $6
Nemo & co has timed out while disconnected
Nemo & co: is sitting out 
*** HOLE CARDS ***
checkitout12: folds 
garougary: raises $6 to $12
king10clubs: folds 
vjxbkf: folds 
Uncalled bet ($6) returned to garougary
garougary collected $15 from pot
garougary: doesn't show hand 
*** SUMMARY ***
Total pot $15 | Rake $0 
Seat 1: checkitout12 folded before Flop (didn't bet)
Seat 3: garougary (button) collected ($15)
Seat 5: king10clubs (small blind) folded before Flop
Seat 6: vjxbkf (big blind) folded before Flop


PokerStars Game #102595436805:  Hold'em No Limit ($3/$6 USD) - 2013/08/11 4:04:31 ET
Table 'Klemola 40-100 bb' 6-max Seat #5 is the button
Seat 1: checkitout12 ($240 in chips) 
Seat 3: garougary ($385.14 in chips) 
Seat 5: king10clubs ($861.11 in chips) 
Seat 6: vjxbkf ($616.50 in chips) 
vjxbkf: posts small blind $3
checkitout12: posts big blind $6
mustanggino: sits out 
*** HOLE CARDS ***
garougary: folds 
king10clubs: raises $6 to $12
vjxbkf: raises $30 to $42
checkitout12: folds 
king10clubs: calls $30
*** FLOP *** [7h 9d 9h]
vjxbkf: bets $66
king10clubs: calls $66
*** TURN *** [7h 9d 9h] [3c]
vjxbkf: bets $126
king10clubs: calls $126
*** RIVER *** [7h 9d 9h 3c] [5c]
vjxbkf: checks 
king10clubs: bets $450
vjxbkf: folds 
Uncalled bet ($450) returned to king10clubs
king10clubs collected $472.50 from pot
king10clubs: doesn't show hand 
*** SUMMARY ***
Total pot $474 | Rake $1.50 
Board [7h 9d 9h 3c 5c]
Seat 1: checkitout12 (big blind) folded before Flop
Seat 3: garougary folded before Flop (didn't bet)
Seat 5: king10clubs (button) collected ($472.50)
Seat 6: vjxbkf (small blind) folded on the River


PokerStars Game #102595261425:  Hold'em No Limit ($3/$6 USD) - 2013/08/11 3:55:49 ET
Table 'Klemola 40-100 bb' 6-max Seat #1 is the button
Seat 1: rusdronenv ($631.15 in chips) 
Seat 2: NutPopper ($604.60 in chips) 
Seat 3: garougary ($107.63 in chips) 
Seat 4: mustanggino ($460.98 in chips) 
Seat 5: king10clubs ($924.11 in chips) 
Seat 6: vjxbkf ($600 in chips) 
NutPopper: posts small blind $3
garougary: posts big blind $6
*** HOLE CARDS ***
mustanggino: folds 
king10clubs: folds 
vjxbkf: raises $12 to $18
rusdronenv: folds 
NutPopper: folds 
garougary: calls $12
*** FLOP *** [6d 8s 7s]
garougary: checks 
vjxbkf: checks 
*** TURN *** [6d 8s 7s] [Kc]
garougary: checks 
vjxbkf: checks 
*** RIVER *** [6d 8s 7s Kc] [8h]
garougary: bets $19
vjxbkf: folds 
Uncalled bet ($19) returned to garougary
garougary collected $37.24 from pot
garougary: doesn't show hand 
*** SUMMARY ***
Total pot $39 | Rake $1.76 
Board [6d 8s 7s Kc 8h]
Seat 1: rusdronenv (button) folded before Flop (didn't bet)
Seat 2: NutPopper (small blind) folded before Flop
Seat 3: garougary (big blind) collected ($37.24)
Seat 4: mustanggino folded before Flop (didn't bet)
Seat 5: king10clubs folded before Flop (didn't bet)
Seat 6: vjxbkf folded on the River


PokerStars Game #102595291441:  Hold'em No Limit ($3/$6 USD) - 2013/08/11 3:57:29 ET
Table 'Klemola 40-100 bb' 6-max Seat #2 is the button
Seat 1: rusdronenv ($631.15 in chips) 
Seat 2: NutPopper ($601.60 in chips) 
Seat 3: garougary ($126.87 in chips) 
Seat 4: mustanggino ($460.98 in chips) 
Seat 5: king10clubs ($924.11 in chips) 
Seat 6: vjxbkf ($600 in chips) 
garougary: posts small blind $3
mustanggino: posts big blind $6
*** HOLE CARDS ***
king10clubs: folds 
vjxbkf: folds 
rusdronenv: raises $12 to $18
NutPopper: folds 
garougary: folds 
mustanggino: raises $30 to $48
rusdronenv: calls $30
*** FLOP *** [2h 3h 9h]
mustanggino: checks 
rusdronenv: bets $60
mustanggino: folds 
Uncalled bet ($60) returned to rusdronenv
rusdronenv collected $96.20 from pot
rusdronenv: doesn't show hand 
*** SUMMARY ***
Total pot $99 | Rake $2.80 
Board [2h 3h 9h]
Seat 1: rusdronenv collected ($96.20)
Seat 2: NutPopper (button) folded before Flop (didn't bet)
Seat 3: garougary (small blind) folded before Flop
Seat 4: mustanggino (big blind) folded on the Flop
Seat 5: king10clubs folded before Flop (didn't bet)
Seat 6: vjxbkf folded before Flop (didn't bet)


PokerStars Game #102595321473:  Hold'em No Limit ($3/$6 USD) - 2013/08/11 3:59:09 ET
Table 'Klemola 40-100 bb' 6-max Seat #3 is the button
Seat 1: rusdronenv ($679.35 in chips) 
Seat 2: NutPopper ($601.60 in chips) 
Seat 3: garougary ($123.87 in chips) 
Seat 4: mustanggino ($450 in chips) 
Seat 5: king10clubs ($924.11 in chips) 
Seat 6: vjxbkf ($600 in chips) 
mustanggino: posts small blind $3
king10clubs: posts big blind $6
*** HOLE CARDS ***
vjxbkf: folds 
rusdronenv: raises $12 to $18
NutPopper: folds 
garougary: raises $24 to $42
mustanggino: folds 
king10clubs: folds 
rusdronenv: raises $384 to $426
garougary: calls $81.87 and is all-in
Uncalled bet ($302.13) returned to rusdronenv
*** FLOP *** [5h As Ac]
*** TURN *** [5h As Ac] [6c]
*** RIVER *** [5h As Ac 6c] [Th]
*** SHOW DOWN ***
rusdronenv: shows [Js Jc] (two pair, Aces and Jacks)
garougary: shows [Qs Qd] (two pair, Aces and Queens)
garougary collected $253.94 from pot
*** SUMMARY ***
Total pot $256.74 | Rake $2.80 
Board [5h As Ac 6c Th]
Seat 1: rusdronenv showed [Js Jc] and lost with two pair, Aces and Jacks
Seat 2: NutPopper folded before Flop (didn't bet)
Seat 3: garougary (button) showed [Qs Qd] and won ($253.94) with two pair, Aces and Queens
Seat 4: mustanggino (small blind) folded before Flop
Seat 5: king10clubs (big blind) folded before Flop
Seat 6: vjxbkf folded before Flop (didn't bet)


PokerStars Game #102595336338:  Hold'em No Limit ($3/$6 USD) - 2013/08/11 3:59:56 ET
Table 'Klemola 40-100 bb' 6-max Seat #4 is the button
Seat 1: rusdronenv ($600 in chips) 
Seat 2: NutPopper ($601.60 in chips) 
Seat 3: garougary ($253.94 in chips) 
Seat 4: mustanggino ($450 in chips) 
Seat 5: king10clubs ($918.11 in chips) 
Seat 6: vjxbkf ($600 in chips) 
king10clubs: posts small blind $3
vjxbkf: posts big blind $6
*** HOLE CARDS ***
rusdronenv: folds 
NutPopper: folds 
garougary: raises $6 to $12
mustanggino: calls $12
king10clubs: folds 
vjxbkf: folds 
*** FLOP *** [7h Ac 8s]
garougary: bets $11
mustanggino: calls $11
*** TURN *** [7h Ac 8s] [3d]
garougary: checks 
mustanggino: bets $36
garougary: calls $36
*** RIVER *** [7h Ac 8s 3d] [Ad]
garougary: checks 
mustanggino: checks 
*** SHOW DOWN ***
garougary: shows [6h 9h] (a pair of Aces)
mustanggino: mucks hand 
garougary collected $124.20 from pot
*** SUMMARY ***
Total pot $127 | Rake $2.80 
Board [7h Ac 8s 3d Ad]
Seat 1: rusdronenv folded before Flop (didn't bet)
Seat 2: NutPopper folded before Flop (didn't bet)
Seat 3: garougary showed [6h 9h] and won ($124.20) with a pair of Aces
Seat 4: mustanggino (button) mucked
Seat 5: king10clubs (small blind) folded before Flop
Seat 6: vjxbkf (big blind) folded before Flop


PokerStars Game #102595890251:  Hold'em No Limit ($3/$6 USD) - 2013/08/11 4:25:38 ET
Table 'Klemola 40-100 bb' 6-max Seat #6 is the button
Seat 1: ZarubaNT ($600 in chips) 
Seat 2: Nemo & co ($356.52 in chips) 
Seat 3: garougary ($340.14 in chips) 
Seat 4: mustanggino ($496 in chips) 
Seat 5: king10clubs ($1167.79 in chips) 
Seat 6: floriiiiider ($609 in chips) 
ZarubaNT: posts small blind $3
Nemo & co: posts big blind $6
*** HOLE CARDS ***
garougary: folds 
mustanggino: folds 
king10clubs: folds 
floriiiiider: folds 
ZarubaNT: folds 
Uncalled bet ($3) returned to Nemo & co
Nemo & co collected $6 from pot
*** SUMMARY ***
Total pot $6 | Rake $0 
Seat 1: ZarubaNT (small blind) folded before Flop
Seat 2: Nemo & co (big blind) collected ($6)
Seat 3: garougary folded before Flop (didn't bet)
Seat 4: mustanggino folded before Flop (didn't bet)
Seat 5: king10clubs folded before Flop (didn't bet)
Seat 6: floriiiiider (button) folded before Flop (didn't bet)


PokerStars Game #102595895646:  Hold'em No Limit ($3/$6 USD) - 2013/08/11 4:25:53 ET
Table 'Klemola 40-100 bb' 6-max Seat #1 is the button
Seat 1: ZarubaNT ($600 in chips) 
Seat 2: Nemo & co ($359.52 in chips) 
Seat 3: garougary ($340.14 in chips) 
Seat 4: mustanggino ($496 in chips) 
Seat 5: king10clubs ($1167.79 in chips) 
Seat 6: floriiiiider ($609 in chips) 
Nemo & co: posts small blind $3
garougary: posts big blind $6
*** HOLE CARDS ***
mustanggino: folds 
king10clubs: raises $9 to $15
floriiiiider: calls $15
ZarubaNT: folds 
Nemo & co: folds 
garougary: folds 
*** FLOP *** [8d 4c 7h]
king10clubs: checks 
floriiiiider: bets $24
king10clubs: calls $24
*** TURN *** [8d 4c 7h] [Th]
king10clubs: checks 
floriiiiider: bets $54
king10clubs: folds 
Uncalled bet ($54) returned to floriiiiider
floriiiiider collected $84.20 from pot
floriiiiider: doesn't show hand 
*** SUMMARY ***
Total pot $87 | Rake $2.80 
Board [8d 4c 7h Th]
Seat 1: ZarubaNT (button) folded before Flop (didn't bet)
Seat 2: Nemo & co (small blind) folded before Flop
Seat 3: garougary (big blind) folded before Flop
Seat 4: mustanggino folded before Flop (didn't bet)
Seat 5: king10clubs folded on the Turn
Seat 6: floriiiiider collected ($84.20)


PokerStars Game #102595914360:  Hold'em No Limit ($3/$6 USD) - 2013/08/11 4:26:47 ET
Table 'Klemola 40-100 bb' 6-max Seat #2 is the button
Seat 1: ZarubaNT ($600 in chips) 
Seat 2: Nemo & co ($356.52 in chips) 
Seat 3: garougary ($334.14 in chips) 
Seat 4: mustanggino ($496 in chips) 
Seat 5: king10clubs ($1128.79 in chips) 
Seat 6: floriiiiider ($654.20 in chips) 
garougary: posts small blind $3
mustanggino: posts big blind $6
*** HOLE CARDS ***
king10clubs: folds 
floriiiiider: raises $12 to $18
ZarubaNT: raises $30 to $48
Nemo & co: folds 
garougary: folds 
mustanggino: folds 
floriiiiider: calls $30
*** FLOP *** [6s 7s Kd]
floriiiiider: checks 
ZarubaNT: bets $54
floriiiiider: calls $54
*** TURN *** [6s 7s Kd] [5d]
floriiiiider: checks 
ZarubaNT: bets $123
floriiiiider: raises $429.20 to $552.20 and is all-in
ZarubaNT: calls $375 and is all-in
Uncalled bet ($54.20) returned to floriiiiider
*** RIVER *** [6s 7s Kd 5d] [As]
*** SHOW DOWN ***
floriiiiider: shows [9s Ts] (a flush, Ace high)
ZarubaNT: shows [6c 4c] (a pair of Sixes)
floriiiiider collected $1206.20 from pot
*** SUMMARY ***
Total pot $1209 | Rake $2.80 
Board [6s 7s Kd 5d As]
Seat 1: ZarubaNT showed [6c 4c] and lost with a pair of Sixes
Seat 2: Nemo & co (button) folded before Flop (didn't bet)
Seat 3: garougary (small blind) folded before Flop
Seat 4: mustanggino (big blind) folded before Flop
Seat 5: king10clubs folded before Flop (didn't bet)
Seat 6: floriiiiider showed [9s Ts] and won ($1206.20) with a flush, Ace high


PokerStars Game #102595943993:  Hold'em No Limit ($3/$6 USD) - 2013/08/11 4:28:12 ET
Table 'Klemola 40-100 bb' 6-max Seat #3 is the button
Seat 1: ZarubaNT ($600 in chips) 
Seat 2: Nemo & co ($356.52 in chips) 
Seat 3: garougary ($331.14 in chips) 
Seat 4: mustanggino ($490 in chips) 
Seat 5: king10clubs ($1128.79 in chips) 
Seat 6: floriiiiider ($1260.40 in chips) 
mustanggino: posts small blind $3
king10clubs: posts big blind $6
*** HOLE CARDS ***
floriiiiider: raises $12 to $18
ZarubaNT: folds 
Nemo & co: folds 
garougary: folds 
mustanggino: calls $15
king10clubs: folds 
*** FLOP *** [9c 6d Qc]
mustanggino: checks 
floriiiiider: checks 
*** TURN *** [9c 6d Qc] [7s]
mustanggino: bets $30
floriiiiider: calls $30
*** RIVER *** [9c 6d Qc 7s] [3h]
mustanggino: bets $72
floriiiiider: folds 
Uncalled bet ($72) returned to mustanggino
mustanggino collected $99.20 from pot
mustanggino: doesn't show hand 
*** SUMMARY ***
Total pot $102 | Rake $2.80 
Board [9c 6d Qc 7s 3h]
Seat 1: ZarubaNT folded before Flop (didn't bet)
Seat 2: Nemo & co folded before Flop (didn't bet)
Seat 3: garougary (button) folded before Flop (didn't bet)
Seat 4: mustanggino (small blind) collected ($99.20)
Seat 5: king10clubs (big blind) folded before Flop
Seat 6: floriiiiider folded on the River


PokerStars Game #102595975022:  Hold'em No Limit ($3/$6 USD) - 2013/08/11 4:29:42 ET
Table 'Klemola 40-100 bb' 6-max Seat #4 is the button
Seat 1: ZarubaNT ($600 in chips) 
Seat 2: Nemo & co ($356.52 in chips) 
Seat 3: garougary ($331.14 in chips) 
Seat 4: mustanggino ($541.20 in chips) 
Seat 5: king10clubs ($1122.79 in chips) 
Seat 6: floriiiiider ($1212.40 in chips) 
king10clubs: posts small blind $3
floriiiiider: posts big blind $6
*** HOLE CARDS ***
ZarubaNT: folds 
Nemo & co: folds 
garougary: folds 
mustanggino: raises $6 to $12
king10clubs: folds 
floriiiiider: raises $30 to $42
mustanggino: folds 
Uncalled bet ($30) returned to floriiiiider
floriiiiider collected $27 from pot
floriiiiider: doesn't show hand 
*** SUMMARY ***
Total pot $27 | Rake $0 
Seat 1: ZarubaNT folded before Flop (didn't bet)
Seat 2: Nemo & co folded before Flop (didn't bet)
Seat 3: garougary folded before Flop (didn't bet)
Seat 4: mustanggino (button) folded before Flop
Seat 5: king10clubs (small blind) folded before Flop
Seat 6: floriiiiider (big blind) collected ($27)


PokerStars Game #102595778031:  Hold'em No Limit ($3/$6 USD) - 2013/08/11 4:20:16 ET
Table 'Klemola 40-100 bb' 6-max Seat #4 is the button
Seat 1: ZarubaNT ($609 in chips) 
Seat 2: Nemo & co ($356.32 in chips) 
Seat 3: garougary ($376.14 in chips) 
Seat 4: mustanggino ($478 in chips) 
Seat 5: king10clubs ($1140.59 in chips) 
Seat 6: floriiiiider ($600 in chips) 
king10clubs: posts small blind $3
floriiiiider: posts big blind $6
*** HOLE CARDS ***
ZarubaNT: folds 
Nemo & co: raises $12 to $18
garougary: folds 
mustanggino: folds 
king10clubs: folds 
floriiiiider: folds 
Uncalled bet ($12) returned to Nemo & co
Nemo & co collected $15 from pot
*** SUMMARY ***
Total pot $15 | Rake $0 
Seat 1: ZarubaNT folded before Flop (didn't bet)
Seat 2: Nemo & co collected ($15)
Seat 3: garougary folded before Flop (didn't bet)
Seat 4: mustanggino (button) folded before Flop (didn't bet)
Seat 5: king10clubs (small blind) folded before Flop
Seat 6: floriiiiider (big blind) folded before Flop


PokerStars Game #102595790818:  Hold'em No Limit ($3/$6 USD) - 2013/08/11 4:20:52 ET
Table 'Klemola 40-100 bb' 6-max Seat #5 is the button
Seat 1: ZarubaNT ($609 in chips) 
Seat 2: Nemo & co ($365.32 in chips) 
Seat 3: garougary ($376.14 in chips) 
Seat 4: mustanggino ($478 in chips) 
Seat 5: king10clubs ($1137.59 in chips) 
Seat 6: floriiiiider ($600 in chips) 
floriiiiider: posts small blind $3
ZarubaNT: posts big blind $6
*** HOLE CARDS ***
Nemo & co: raises $12 to $18
garougary: calls $18
mustanggino: folds 
king10clubs: calls $18
floriiiiider: folds 
ZarubaNT: folds 
*** FLOP *** [Ts 3s 7c]
Nemo & co: bets $36
garougary: folds 
king10clubs: folds 
Uncalled bet ($36) returned to Nemo & co
Nemo & co collected $60.20 from pot
*** SUMMARY ***
Total pot $63 | Rake $2.80 
Board [Ts 3s 7c]
Seat 1: ZarubaNT (big blind) folded before Flop
Seat 2: Nemo & co collected ($60.20)
Seat 3: garougary folded on the Flop
Seat 4: mustanggino folded before Flop (didn't bet)
Seat 5: king10clubs (button) folded on the Flop
Seat 6: floriiiiider (small blind) folded before Flop


PokerStars Game #102595809640:  Hold'em No Limit ($3/$6 USD) - 2013/08/11 4:21:45 ET
Table 'Klemola 40-100 bb' 6-max Seat #6 is the button
Seat 1: ZarubaNT ($603 in chips) 
Seat 2: Nemo & co ($407.52 in chips) 
Seat 3: garougary ($358.14 in chips) 
Seat 4: mustanggino ($478 in chips) 
Seat 5: king10clubs ($1119.59 in chips) 
Seat 6: floriiiiider ($600 in chips) 
ZarubaNT: posts small blind $3
Nemo & co: posts big blind $6
*** HOLE CARDS ***
garougary: folds 
mustanggino: raises $6 to $12
king10clubs: folds 
floriiiiider: folds 
ZarubaNT: folds 
Nemo & co: folds 
Uncalled bet ($6) returned to mustanggino
mustanggino collected $15 from pot
mustanggino: doesn't show hand 
*** SUMMARY ***
Total pot $15 | Rake $0 
Seat 1: ZarubaNT (small blind) folded before Flop
Seat 2: Nemo & co (big blind) folded before Flop
Seat 3: garougary folded before Flop (didn't bet)
Seat 4: mustanggino collected ($15)
Seat 5: king10clubs folded before Flop (didn't bet)
Seat 6: floriiiiider (button) folded before Flop (didn't bet)


PokerStars Game #102595818869:  Hold'em No Limit ($3/$6 USD) - 2013/08/11 4:22:12 ET
Table 'Klemola 40-100 bb' 6-max Seat #1 is the button
Seat 1: ZarubaNT ($600 in chips) 
Seat 2: Nemo & co ($401.52 in chips) 
Seat 3: garougary ($358.14 in chips) 
Seat 4: mustanggino ($487 in chips) 
Seat 5: king10clubs ($1119.59 in chips) 
Seat 6: floriiiiider ($600 in chips) 
Nemo & co: posts small blind $3
garougary: posts big blind $6
*** HOLE CARDS ***
mustanggino: folds 
king10clubs: raises $9 to $15
floriiiiider: folds 
ZarubaNT: folds 
Nemo & co: folds 
garougary: folds 
Uncalled bet ($9) returned to king10clubs
king10clubs collected $15 from pot
king10clubs: doesn't show hand 
*** SUMMARY ***
Total pot $15 | Rake $0 
Seat 1: ZarubaNT (button) folded before Flop (didn't bet)
Seat 2: Nemo & co (small blind) folded before Flop
Seat 3: garougary (big blind) folded before Flop
Seat 4: mustanggino folded before Flop (didn't bet)
Seat 5: king10clubs collected ($15)
Seat 6: floriiiiider folded before Flop (didn't bet)


PokerStars Game #102595831802:  Hold'em No Limit ($3/$6 USD) - 2013/08/11 4:22:49 ET
Table 'Klemola 40-100 bb' 6-max Seat #2 is the button
Seat 1: ZarubaNT ($600 in chips) 
Seat 2: Nemo & co ($398.52 in chips) 
Seat 3: garougary ($352.14 in chips) 
Seat 4: mustanggino ($487 in chips) 
Seat 5: king10clubs ($1128.59 in chips) 
Seat 6: floriiiiider ($600 in chips) 
garougary: posts small blind $3
mustanggino: posts big blind $6
*** HOLE CARDS ***
king10clubs: folds 
floriiiiider: folds 
ZarubaNT: folds 
Nemo & co: folds 
garougary: raises $6 to $12
mustanggino: raises $30 to $42
garougary: folds 
Uncalled bet ($30) returned to mustanggino
mustanggino collected $24 from pot
mustanggino: doesn't show hand 
*** SUMMARY ***
Total pot $24 | Rake $0 
Seat 1: ZarubaNT folded before Flop (didn't bet)
Seat 2: Nemo & co (button) folded before Flop (didn't bet)
Seat 3: garougary (small blind) folded before Flop
Seat 4: mustanggino (big blind) collected ($24)
Seat 5: king10clubs folded before Flop (didn't bet)
Seat 6: floriiiiider folded before Flop (didn't bet)


PokerStars Game #102595848937:  Hold'em No Limit ($3/$6 USD) - 2013/08/11 4:23:39 ET
Table 'Klemola 40-100 bb' 6-max Seat #3 is the button
Seat 1: ZarubaNT ($600 in chips) 
Seat 2: Nemo & co ($398.52 in chips) 
Seat 3: garougary ($340.14 in chips) 
Seat 4: mustanggino ($499 in chips) 
Seat 5: king10clubs ($1128.59 in chips) 
Seat 6: floriiiiider ($600 in chips) 
mustanggino: posts small blind $3
king10clubs: posts big blind $6
*** HOLE CARDS ***
floriiiiider: raises $12 to $18
ZarubaNT: folds 
Nemo & co: folds 
garougary: folds 
mustanggino: folds 
king10clubs: folds 
Uncalled bet ($12) returned to floriiiiider
floriiiiider collected $15 from pot
floriiiiider: doesn't show hand 
*** SUMMARY ***
Total pot $15 | Rake $0 
Seat 1: ZarubaNT folded before Flop (didn't bet)
Seat 2: Nemo & co folded before Flop (didn't bet)
Seat 3: garougary (button) folded before Flop (didn't bet)
Seat 4: mustanggino (small blind) folded before Flop
Seat 5: king10clubs (big blind) folded before Flop
Seat 6: floriiiiider collected ($15)


PokerStars Game #102595859428:  Hold'em No Limit ($3/$6 USD) - 2013/08/11 4:24:09 ET
Table 'Klemola 40-100 bb' 6-max Seat #4 is the button
Seat 1: ZarubaNT ($600 in chips) 
Seat 2: Nemo & co ($398.52 in chips) 
Seat 3: garougary ($340.14 in chips) 
Seat 4: mustanggino ($496 in chips) 
Seat 5: king10clubs ($1122.59 in chips) 
Seat 6: floriiiiider ($609 in chips) 
king10clubs: posts small blind $3
floriiiiider: posts big blind $6
*** HOLE CARDS ***
ZarubaNT: folds 
Nemo & co: folds 
garougary: folds 
mustanggino: folds 
king10clubs: folds 
Uncalled bet ($3) returned to floriiiiider
floriiiiider collected $6 from pot
floriiiiider: doesn't show hand 
*** SUMMARY ***
Total pot $6 | Rake $0 
Seat 1: ZarubaNT folded before Flop (didn't bet)
Seat 2: Nemo & co folded before Flop (didn't bet)
Seat 3: garougary folded before Flop (didn't bet)
Seat 4: mustanggino (button) folded before Flop (didn't bet)
Seat 5: king10clubs (small blind) folded before Flop
Seat 6: floriiiiider (big blind) collected ($6)


PokerStars Game #102595866967:  Hold'em No Limit ($3/$6 USD) - 2013/08/11 4:24:31 ET
Table 'Klemola 40-100 bb' 6-max Seat #5 is the button
Seat 1: ZarubaNT ($600 in chips) 
Seat 2: Nemo & co ($398.52 in chips) 
Seat 3: garougary ($340.14 in chips) 
Seat 4: mustanggino ($496 in chips) 
Seat 5: king10clubs ($1119.59 in chips) 
Seat 6: floriiiiider ($612 in chips) 
floriiiiider: posts small blind $3
ZarubaNT: posts big blind $6
*** HOLE CARDS ***
Nemo & co: raises $12 to $18
garougary: folds 
mustanggino: folds 
king10clubs: calls $18
floriiiiider: folds 
ZarubaNT: folds 
*** FLOP *** [4d Jd Kc]
Nemo & co: bets $24
king10clubs: calls $24
*** TURN *** [4d Jd Kc] [9s]
Nemo & co: checks 
king10clubs: bets $72
Nemo & co: folds 
Uncalled bet ($72) returned to king10clubs
king10clubs collected $90.20 from pot
king10clubs: doesn't show hand 
*** SUMMARY ***
Total pot $93 | Rake $2.80 
Board [4d Jd Kc 9s]
Seat 1: ZarubaNT (big blind) folded before Flop
Seat 2: Nemo & co folded on the Turn
Seat 3: garougary folded before Flop (didn't bet)
Seat 4: mustanggino folded before Flop (didn't bet)
Seat 5: king10clubs (button) collected ($90.20)
Seat 6: floriiiiider (small blind) folded before Flop


PokerStars Game #102595665416:  Hold'em No Limit ($3/$6 USD) - 2013/08/11 4:15:00 ET
Table 'Klemola 40-100 bb' 6-max Seat #2 is the button
Seat 1: ZarubaNT ($600 in chips) 
Seat 2: Nemo & co ($371.32 in chips) 
Seat 4: mustanggino ($495.30 in chips) 
Seat 5: king10clubs ($1095.39 in chips) 
Seat 6: floriiiiider ($600 in chips) 
mustanggino: posts small blind $3
king10clubs: posts big blind $6
*** HOLE CARDS ***
floriiiiider: folds 
ZarubaNT: folds 
Nemo & co: folds 
mustanggino: raises $6 to $12
king10clubs: calls $6
*** FLOP *** [Td 2c 2d]
mustanggino: bets $12
king10clubs: folds 
Uncalled bet ($12) returned to mustanggino
mustanggino collected $22.92 from pot
mustanggino: doesn't show hand 
*** SUMMARY ***
Total pot $24 | Rake $1.08 
Board [Td 2c 2d]
Seat 1: ZarubaNT folded before Flop (didn't bet)
Seat 2: Nemo & co (button) folded before Flop (didn't bet)
Seat 4: mustanggino (small blind) collected ($22.92)
Seat 5: king10clubs (big blind) folded on the Flop
Seat 6: floriiiiider folded before Flop (didn't bet)


PokerStars Game #102595683297:  Hold'em No Limit ($3/$6 USD) - 2013/08/11 4:15:50 ET
Table 'Klemola 40-100 bb' 6-max Seat #4 is the button
Seat 1: ZarubaNT ($600 in chips) 
Seat 2: Nemo & co ($371.32 in chips) 
Seat 4: mustanggino ($506.22 in chips) 
Seat 5: king10clubs ($1083.39 in chips) 
Seat 6: floriiiiider ($600 in chips) 
king10clubs: posts small blind $3
floriiiiider: posts big blind $6
*** HOLE CARDS ***
ZarubaNT: folds 
Nemo & co: folds 
mustanggino: raises $6 to $12
king10clubs: folds 
floriiiiider: folds 
Uncalled bet ($6) returned to mustanggino
mustanggino collected $15 from pot
mustanggino: doesn't show hand 
*** SUMMARY ***
Total pot $15 | Rake $0 
Seat 1: ZarubaNT folded before Flop (didn't bet)
Seat 2: Nemo & co folded before Flop (didn't bet)
Seat 4: mustanggino (button) collected ($15)
Seat 5: king10clubs (small blind) folded before Flop
Seat 6: floriiiiider (big blind) folded before Flop


PokerStars Game #102595690894:  Hold'em No Limit ($3/$6 USD) - 2013/08/11 4:16:11 ET
Table 'Klemola 40-100 bb' 6-max Seat #5 is the button
Seat 1: ZarubaNT ($600 in chips) 
Seat 2: Nemo & co ($371.32 in chips) 
Seat 4: mustanggino ($515.22 in chips) 
Seat 5: king10clubs ($1080.39 in chips) 
Seat 6: floriiiiider ($600 in chips) 
floriiiiider: posts small blind $3
ZarubaNT: posts big blind $6
*** HOLE CARDS ***
Nemo & co: folds 
mustanggino: raises $6 to $12
king10clubs: raises $30 to $42
floriiiiider: folds 
ZarubaNT: folds 
mustanggino: folds 
Uncalled bet ($30) returned to king10clubs
king10clubs collected $33 from pot
king10clubs: doesn't show hand 
*** SUMMARY ***
Total pot $33 | Rake $0 
Seat 1: ZarubaNT (big blind) folded before Flop
Seat 2: Nemo & co folded before Flop (didn't bet)
Seat 4: mustanggino folded before Flop
Seat 5: king10clubs (button) collected ($33)
Seat 6: floriiiiider (small blind) folded before Flop


PokerStars Game #102595703457:  Hold'em No Limit ($3/$6 USD) - 2013/08/11 4:16:47 ET
Table 'Klemola 40-100 bb' 6-max Seat #6 is the button
Seat 1: ZarubaNT ($600 in chips) 
Seat 2: Nemo & co ($371.32 in chips) 
Seat 4: mustanggino ($503.22 in chips) 
Seat 5: king10clubs ($1101.39 in chips) 
Seat 6: floriiiiider ($600 in chips) 
ZarubaNT: posts small blind $3
Nemo & co: posts big blind $6
*** HOLE CARDS ***
mustanggino: raises $6 to $12
king10clubs: folds 
floriiiiider: folds 
ZarubaNT: folds 
Nemo & co: calls $6
*** FLOP *** [7d 8d 4h]
Nemo & co: checks 
mustanggino: bets $12
Nemo & co: folds 
Uncalled bet ($12) returned to mustanggino
mustanggino collected $25.78 from pot
mustanggino: doesn't show hand 
*** SUMMARY ***
Total pot $27 | Rake $1.22 
Board [7d 8d 4h]
Seat 1: ZarubaNT (small blind) folded before Flop
Seat 2: Nemo & co (big blind) folded on the Flop
Seat 4: mustanggino collected ($25.78)
Seat 5: king10clubs folded before Flop (didn't bet)
Seat 6: floriiiiider (button) folded before Flop (didn't bet)


PokerStars Game #102595731393:  Hold'em No Limit ($3/$6 USD) - 2013/08/11 4:18:05 ET
Table 'Klemola 40-100 bb' 6-max Seat #1 is the button
Seat 1: ZarubaNT ($600 in chips) 
Seat 2: Nemo & co ($359.32 in chips) 
Seat 3: garougary ($385.14 in chips) 
Seat 4: mustanggino ($517 in chips) 
Seat 5: king10clubs ($1101.39 in chips) 
Seat 6: floriiiiider ($600 in chips) 
Nemo & co: posts small blind $3
garougary: posts big blind $6
*** HOLE CARDS ***
mustanggino: folds 
king10clubs: folds 
floriiiiider: folds 
ZarubaNT: raises $6 to $12
Nemo & co: folds 
garougary: folds 
Uncalled bet ($6) returned to ZarubaNT
ZarubaNT collected $15 from pot
ZarubaNT: doesn't show hand 
*** SUMMARY ***
Total pot $15 | Rake $0 
Seat 1: ZarubaNT (button) collected ($15)
Seat 2: Nemo & co (small blind) folded before Flop
Seat 3: garougary (big blind) folded before Flop
Seat 4: mustanggino folded before Flop (didn't bet)
Seat 5: king10clubs folded before Flop (didn't bet)
Seat 6: floriiiiider folded before Flop (didn't bet)


PokerStars Game #102595742665:  Hold'em No Limit ($3/$6 USD) - 2013/08/11 4:18:36 ET
Table 'Klemola 40-100 bb' 6-max Seat #2 is the button
Seat 1: ZarubaNT ($609 in chips) 
Seat 2: Nemo & co ($356.32 in chips) 
Seat 3: garougary ($379.14 in chips) 
Seat 4: mustanggino ($517 in chips) 
Seat 5: king10clubs ($1101.39 in chips) 
Seat 6: floriiiiider ($600 in chips) 
garougary: posts small blind $3
mustanggino: posts big blind $6
*** HOLE CARDS ***
king10clubs: folds 
floriiiiider: folds 
ZarubaNT: folds 
Nemo & co: folds 
garougary: folds 
Uncalled bet ($3) returned to mustanggino
mustanggino collected $6 from pot
mustanggino: doesn't show hand 
*** SUMMARY ***
Total pot $6 | Rake $0 
Seat 1: ZarubaNT folded before Flop (didn't bet)
Seat 2: Nemo & co (button) folded before Flop (didn't bet)
Seat 3: garougary (small blind) folded before Flop
Seat 4: mustanggino (big blind) collected ($6)
Seat 5: king10clubs folded before Flop (didn't bet)
Seat 6: floriiiiider folded before Flop (didn't bet)


PokerStars Game #102595746780:  Hold'em No Limit ($3/$6 USD) - 2013/08/11 4:18:48 ET
Table 'Klemola 40-100 bb' 6-max Seat #3 is the button
Seat 1: ZarubaNT ($609 in chips) 
Seat 2: Nemo & co ($356.32 in chips) 
Seat 3: garougary ($376.14 in chips) 
Seat 4: mustanggino ($520 in chips) 
Seat 5: king10clubs ($1101.39 in chips) 
Seat 6: floriiiiider ($600 in chips) 
mustanggino: posts small blind $3
king10clubs: posts big blind $6
*** HOLE CARDS ***
floriiiiider: folds 
ZarubaNT: folds 
Nemo & co: folds 
garougary: folds 
mustanggino: raises $6 to $12
king10clubs: raises $30 to $42
mustanggino: calls $30
*** FLOP *** [6c 7s Ad]
mustanggino: checks 
king10clubs: bets $35
mustanggino: folds 
Uncalled bet ($35) returned to king10clubs
king10clubs collected $81.20 from pot
king10clubs: doesn't show hand 
*** SUMMARY ***
Total pot $84 | Rake $2.80 
Board [6c 7s Ad]
Seat 1: ZarubaNT folded before Flop (didn't bet)
Seat 2: Nemo & co folded before Flop (didn't bet)
Seat 3: garougary (button) folded before Flop (didn't bet)
Seat 4: mustanggino (small blind) folded on the Flop
Seat 5: king10clubs (big blind) collected ($81.20)
Seat 6: floriiiiider folded before Flop (didn't bet)


PokerStars Game #102596209344:  Hold'em No Limit ($3/$6 USD) - 2013/08/11 4:40:44 ET
Table 'Klemola 40-100 bb' 6-max Seat #1 is the button
Seat 1: ZarubaNT ($600 in chips) 
Seat 2: Nemo & co ($788.24 in chips) 
Seat 3: garougary ($280.14 in chips) 
Seat 4: mustanggino ($591.18 in chips) 
Seat 5: king10clubs ($1169.19 in chips) 
Seat 6: floriiiiider ($1140.40 in chips) 
Nemo & co: posts small blind $3
garougary: posts big blind $6
*** HOLE CARDS ***
mustanggino: folds 
king10clubs: raises $9 to $15
floriiiiider: folds 
ZarubaNT: folds 
Nemo & co: folds 
garougary: calls $9
*** FLOP *** [8c Qs Qd]
garougary: checks 
king10clubs: bets $21
garougary: calls $21
*** TURN *** [8c Qs Qd] [Tc]
garougary: checks 
king10clubs: checks 
*** RIVER *** [8c Qs Qd Tc] [8d]
garougary: bets $36
king10clubs: calls $36
*** SHOW DOWN ***
garougary: shows [As Kc] (two pair, Queens and Eights)
king10clubs: shows [Jc Jh] (two pair, Queens and Jacks)
king10clubs collected $144.20 from pot
*** SUMMARY ***
Total pot $147 | Rake $2.80 
Board [8c Qs Qd Tc 8d]
Seat 1: ZarubaNT (button) folded before Flop (didn't bet)
Seat 2: Nemo & co (small blind) folded before Flop
Seat 3: garougary (big blind) showed [As Kc] and lost with two pair, Queens and Eights
Seat 4: mustanggino folded before Flop (didn't bet)
Seat 5: king10clubs showed [Jc Jh] and won ($144.20) with two pair, Queens and Jacks
Seat 6: floriiiiider folded before Flop (didn't bet)


PokerStars Game #102596228291:  Hold'em No Limit ($3/$6 USD) - 2013/08/11 4:41:38 ET
Table 'Klemola 40-100 bb' 6-max Seat #2 is the button
Seat 1: ZarubaNT ($600 in chips) 
Seat 2: Nemo & co ($785.24 in chips) 
Seat 3: garougary ($208.14 in chips) 
Seat 4: mustanggino ($591.18 in chips) 
Seat 5: king10clubs ($1241.39 in chips) 
Seat 6: floriiiiider ($1140.40 in chips) 
garougary: posts small blind $3
mustanggino: posts big blind $6
*** HOLE CARDS ***
king10clubs: folds 
floriiiiider: folds 
ZarubaNT: folds 
Nemo & co: folds 
garougary: raises $6 to $12
mustanggino: folds 
Uncalled bet ($6) returned to garougary
garougary collected $12 from pot
garougary: doesn't show hand 
*** SUMMARY ***
Total pot $12 | Rake $0 
Seat 1: ZarubaNT folded before Flop (didn't bet)
Seat 2: Nemo & co (button) folded before Flop (didn't bet)
Seat 3: garougary (small blind) collected ($12)
Seat 4: mustanggino (big blind) folded before Flop
Seat 5: king10clubs folded before Flop (didn't bet)
Seat 6: floriiiiider folded before Flop (didn't bet)


PokerStars Game #102596243026:  Hold'em No Limit ($3/$6 USD) - 2013/08/11 4:42:18 ET
Table 'Klemola 40-100 bb' 6-max Seat #3 is the button
Seat 1: ZarubaNT ($600 in chips) 
Seat 2: Nemo & co ($785.24 in chips) 
Seat 3: garougary ($214.14 in chips) 
Seat 4: mustanggino ($585.18 in chips) 
Seat 5: king10clubs ($1241.39 in chips) 
Seat 6: floriiiiider ($1140.40 in chips) 
mustanggino: posts small blind $3
king10clubs: posts big blind $6
*** HOLE CARDS ***
floriiiiider: folds 
ZarubaNT: folds 
Nemo & co: raises $12 to $18
garougary: folds 
mustanggino: folds 
king10clubs: calls $12
*** FLOP *** [7h 8h Jc]
king10clubs: checks 
Nemo & co: bets $30
king10clubs: folds 
Uncalled bet ($30) returned to Nemo & co
Nemo & co collected $37.24 from pot
*** SUMMARY ***
Total pot $39 | Rake $1.76 
Board [7h 8h Jc]
Seat 1: ZarubaNT folded before Flop (didn't bet)
Seat 2: Nemo & co collected ($37.24)
Seat 3: garougary (button) folded before Flop (didn't bet)
Seat 4: mustanggino (small blind) folded before Flop
Seat 5: king10clubs (big blind) folded on the Flop
Seat 6: floriiiiider folded before Flop (didn't bet)


PokerStars Game #102596262146:  Hold'em No Limit ($3/$6 USD) - 2013/08/11 4:43:12 ET
Table 'Klemola 40-100 bb' 6-max Seat #4 is the button
Seat 1: ZarubaNT ($600 in chips) 
Seat 2: Nemo & co ($804.48 in chips) 
Seat 3: garougary ($214.14 in chips) 
Seat 4: mustanggino ($582.18 in chips) 
Seat 5: king10clubs ($1223.39 in chips) 
Seat 6: floriiiiider ($1140.40 in chips) 
king10clubs: posts small blind $3
floriiiiider: posts big blind $6
*** HOLE CARDS ***
ZarubaNT: folds 
Nemo & co: folds 
garougary: folds 
mustanggino: raises $6 to $12
king10clubs: folds 
floriiiiider: raises $33 to $45
mustanggino: folds 
Uncalled bet ($33) returned to floriiiiider
floriiiiider collected $27 from pot
floriiiiider: doesn't show hand 
*** SUMMARY ***
Total pot $27 | Rake $0 
Seat 1: ZarubaNT folded before Flop (didn't bet)
Seat 2: Nemo & co folded before Flop (didn't bet)
Seat 3: garougary folded before Flop (didn't bet)
Seat 4: mustanggino (button) folded before Flop
Seat 5: king10clubs (small blind) folded before Flop
Seat 6: floriiiiider (big blind) collected ($27)


PokerStars Game #102596275970:  Hold'em No Limit ($3/$6 USD) - 2013/08/11 4:43:50 ET
Table 'Klemola 40-100 bb' 6-max Seat #5 is the button
Seat 1: ZarubaNT ($600 in chips) 
Seat 2: Nemo & co ($804.48 in chips) 
Seat 3: garougary ($214.14 in chips) 
Seat 4: mustanggino ($570.18 in chips) 
Seat 5: king10clubs ($1220.39 in chips) 
Seat 6: floriiiiider ($1155.40 in chips) 
floriiiiider: posts small blind $3
ZarubaNT: posts big blind $6
*** HOLE CARDS ***
Nemo & co: folds 
garougary: folds 
mustanggino: folds 
king10clubs: raises $6 to $12
floriiiiider: calls $9
ZarubaNT: folds 
*** FLOP *** [Ah Tc 8s]
floriiiiider: checks 
king10clubs: checks 
*** TURN *** [Ah Tc 8s] [9c]
floriiiiider: bets $21
king10clubs: folds 
Uncalled bet ($21) returned to floriiiiider
floriiiiider collected $28.65 from pot
floriiiiider: doesn't show hand 
*** SUMMARY ***
Total pot $30 | Rake $1.35 
Board [Ah Tc 8s 9c]
Seat 1: ZarubaNT (big blind) folded before Flop
Seat 2: Nemo & co folded before Flop (didn't bet)
Seat 3: garougary folded before Flop (didn't bet)
Seat 4: mustanggino folded before Flop (didn't bet)
Seat 5: king10clubs (button) folded on the Turn
Seat 6: floriiiiider (small blind) collected ($28.65)


PokerStars Game #102596293834:  Hold'em No Limit ($3/$6 USD) - 2013/08/11 4:44:41 ET
Table 'Klemola 40-100 bb' 6-max Seat #6 is the button
Seat 1: ZarubaNT ($600 in chips) 
Seat 2: Nemo & co ($804.48 in chips) 
Seat 3: garougary ($214.14 in chips) 
Seat 4: mustanggino ($570.18 in chips) 
Seat 5: king10clubs ($1208.39 in chips) 
Seat 6: floriiiiider ($1172.05 in chips) 
ZarubaNT: posts small blind $3
Nemo & co: posts big blind $6
*** HOLE CARDS ***
garougary: folds 
mustanggino: folds 
king10clubs: raises $9 to $15
garougary leaves the table
floriiiiider: folds 
ZarubaNT: folds 
Nemo & co: calls $9
*** FLOP *** [Jd 6h 3d]
Nemo & co: checks 
king10clubs: bets $24
Nemo & co: folds 
Uncalled bet ($24) returned to king10clubs
king10clubs collected $31.52 from pot
king10clubs: doesn't show hand 
*** SUMMARY ***
Total pot $33 | Rake $1.48 
Board [Jd 6h 3d]
Seat 1: ZarubaNT (small blind) folded before Flop
Seat 2: Nemo & co (big blind) folded on the Flop
Seat 3: garougary folded before Flop (didn't bet)
Seat 4: mustanggino folded before Flop (didn't bet)
Seat 5: king10clubs collected ($31.52)
Seat 6: floriiiiider (button) folded before Flop (didn't bet)


PokerStars Game #102596091570:  Hold'em No Limit ($3/$6 USD) - 2013/08/11 4:35:12 ET
Table 'Klemola 40-100 bb' 6-max Seat #5 is the button
Seat 1: ZarubaNT ($600 in chips) 
Seat 2: Nemo & co ($347.52 in chips) 
Seat 3: garougary ($325.14 in chips) 
Seat 4: mustanggino ($582.18 in chips) 
Seat 5: king10clubs ($1164.41 in chips) 
Seat 6: floriiiiider ($1152.40 in chips) 
floriiiiider: posts small blind $3
ZarubaNT: posts big blind $6
*** HOLE CARDS ***
Nemo & co: folds 
garougary: folds 
mustanggino: folds 
king10clubs: raises $6 to $12
floriiiiider: folds 
ZarubaNT: calls $6
*** FLOP *** [6s As 6c]
ZarubaNT: checks 
king10clubs: bets $10
ZarubaNT: folds 
Uncalled bet ($10) returned to king10clubs
king10clubs collected $25.78 from pot
king10clubs: doesn't show hand 
*** SUMMARY ***
Total pot $27 | Rake $1.22 
Board [6s As 6c]
Seat 1: ZarubaNT (big blind) folded on the Flop
Seat 2: Nemo & co folded before Flop (didn't bet)
Seat 3: garougary folded before Flop (didn't bet)
Seat 4: mustanggino folded before Flop (didn't bet)
Seat 5: king10clubs (button) collected ($25.78)
Seat 6: floriiiiider (small blind) folded before Flop


PokerStars Game #102596105917:  Hold'em No Limit ($3/$6 USD) - 2013/08/11 4:35:52 ET
Table 'Klemola 40-100 bb' 6-max Seat #6 is the button
Seat 1: ZarubaNT ($600 in chips) 
Seat 2: Nemo & co ($347.52 in chips) 
Seat 3: garougary ($325.14 in chips) 
Seat 4: mustanggino ($582.18 in chips) 
Seat 5: king10clubs ($1178.19 in chips) 
Seat 6: floriiiiider ($1149.40 in chips) 
ZarubaNT: posts small blind $3
Nemo & co: posts big blind $6
*** HOLE CARDS ***
garougary: folds 
mustanggino: folds 
Nemo & co is disconnected 
king10clubs: folds 
floriiiiider: folds 
ZarubaNT: raises $12 to $18
Nemo & co: folds 
Uncalled bet ($12) returned to ZarubaNT
ZarubaNT collected $12 from pot
ZarubaNT: doesn't show hand 
*** SUMMARY ***
Total pot $12 | Rake $0 
Seat 1: ZarubaNT (small blind) collected ($12)
Seat 2: Nemo & co (big blind) folded before Flop
Seat 3: garougary folded before Flop (didn't bet)
Seat 4: mustanggino folded before Flop (didn't bet)
Seat 5: king10clubs folded before Flop (didn't bet)
Seat 6: floriiiiider (button) folded before Flop (didn't bet)


PokerStars Game #102596118366:  Hold'em No Limit ($3/$6 USD) - 2013/08/11 4:36:27 ET
Table 'Klemola 40-100 bb' 6-max Seat #1 is the button
Seat 1: ZarubaNT ($606 in chips) 
Seat 2: Nemo & co ($341.52 in chips) 
Seat 3: garougary ($325.14 in chips) 
Seat 4: mustanggino ($582.18 in chips) 
Seat 5: king10clubs ($1178.19 in chips) 
Seat 6: floriiiiider ($1149.40 in chips) 
Nemo & co: posts small blind $3
garougary: posts big blind $6
*** HOLE CARDS ***
mustanggino: folds 
king10clubs: folds 
floriiiiider: folds 
ZarubaNT: raises $6 to $12
Nemo & co: raises $24 to $36
garougary: folds 
ZarubaNT: folds 
Uncalled bet ($24) returned to Nemo & co
Nemo & co collected $30 from pot
*** SUMMARY ***
Total pot $30 | Rake $0 
Seat 1: ZarubaNT (button) folded before Flop
Seat 2: Nemo & co (small blind) collected ($30)
Seat 3: garougary (big blind) folded before Flop
Seat 4: mustanggino folded before Flop (didn't bet)
Seat 5: king10clubs folded before Flop (didn't bet)
Seat 6: floriiiiider folded before Flop (didn't bet)


PokerStars Game #102596133157:  Hold'em No Limit ($3/$6 USD) - 2013/08/11 4:37:08 ET
Table 'Klemola 40-100 bb' 6-max Seat #2 is the button
Seat 1: ZarubaNT ($600 in chips) 
Seat 2: Nemo & co ($359.52 in chips) 
Seat 3: garougary ($319.14 in chips) 
Seat 4: mustanggino ($582.18 in chips) 
Seat 5: king10clubs ($1178.19 in chips) 
Seat 6: floriiiiider ($1149.40 in chips) 
garougary: posts small blind $3
mustanggino: posts big blind $6
*** HOLE CARDS ***
king10clubs: folds 
floriiiiider: folds 
ZarubaNT: folds 
Nemo & co: folds 
garougary: folds 
Uncalled bet ($3) returned to mustanggino
mustanggino collected $6 from pot
mustanggino: doesn't show hand 
*** SUMMARY ***
Total pot $6 | Rake $0 
Seat 1: ZarubaNT folded before Flop (didn't bet)
Seat 2: Nemo & co (button) folded before Flop (didn't bet)
Seat 3: garougary (small blind) folded before Flop
Seat 4: mustanggino (big blind) collected ($6)
Seat 5: king10clubs folded before Flop (didn't bet)
Seat 6: floriiiiider folded before Flop (didn't bet)


PokerStars Game #102596136824:  Hold'em No Limit ($3/$6 USD) - 2013/08/11 4:37:18 ET
Table 'Klemola 40-100 bb' 6-max Seat #3 is the button
Seat 1: ZarubaNT ($600 in chips) 
Seat 2: Nemo & co ($359.52 in chips) 
Seat 3: garougary ($316.14 in chips) 
Seat 4: mustanggino ($585.18 in chips) 
Seat 5: king10clubs ($1178.19 in chips) 
Seat 6: floriiiiider ($1149.40 in chips) 
mustanggino: posts small blind $3
king10clubs: posts big blind $6
*** HOLE CARDS ***
floriiiiider: folds 
ZarubaNT: folds 
Nemo & co: raises $12 to $18
garougary: folds 
mustanggino: folds 
king10clubs: folds 
Uncalled bet ($12) returned to Nemo & co
Nemo & co collected $15 from pot
*** SUMMARY ***
Total pot $15 | Rake $0 
Seat 1: ZarubaNT folded before Flop (didn't bet)
Seat 2: Nemo & co collected ($15)
Seat 3: garougary (button) folded before Flop (didn't bet)
Seat 4: mustanggino (small blind) folded before Flop
Seat 5: king10clubs (big blind) folded before Flop
Seat 6: floriiiiider folded before Flop (didn't bet)


PokerStars Game #102596147097:  Hold'em No Limit ($3/$6 USD) - 2013/08/11 4:37:47 ET
Table 'Klemola 40-100 bb' 6-max Seat #4 is the button
Seat 1: ZarubaNT ($600 in chips) 
Seat 2: Nemo & co ($368.52 in chips) 
Seat 3: garougary ($316.14 in chips) 
Seat 4: mustanggino ($582.18 in chips) 
Seat 5: king10clubs ($1172.19 in chips) 
Seat 6: floriiiiider ($1149.40 in chips) 
king10clubs: posts small blind $3
floriiiiider: posts big blind $6
*** HOLE CARDS ***
ZarubaNT: folds 
Nemo & co: folds 
garougary: folds 
mustanggino: raises $6 to $12
king10clubs: folds 
floriiiiider: folds 
Uncalled bet ($6) returned to mustanggino
mustanggino collected $15 from pot
mustanggino: doesn't show hand 
*** SUMMARY ***
Total pot $15 | Rake $0 
Seat 1: ZarubaNT folded before Flop (didn't bet)
Seat 2: Nemo & co folded before Flop (didn't bet)
Seat 3: garougary folded before Flop (didn't bet)
Seat 4: mustanggino (button) collected ($15)
Seat 5: king10clubs (small blind) folded before Flop
Seat 6: floriiiiider (big blind) folded before Flop


PokerStars Game #102596157329:  Hold'em No Limit ($3/$6 USD) - 2013/08/11 4:38:16 ET
Table 'Klemola 40-100 bb' 6-max Seat #5 is the button
Seat 1: ZarubaNT ($600 in chips) 
Seat 2: Nemo & co ($368.52 in chips) 
Seat 3: garougary ($316.14 in chips) 
Seat 4: mustanggino ($591.18 in chips) 
Seat 5: king10clubs ($1169.19 in chips) 
Seat 6: floriiiiider ($1143.40 in chips) 
floriiiiider: posts small blind $3
ZarubaNT: posts big blind $6
*** HOLE CARDS ***
Nemo & co: raises $12 to $18
garougary: folds 
mustanggino: folds 
king10clubs: folds 
floriiiiider: folds 
ZarubaNT: folds 
Uncalled bet ($12) returned to Nemo & co
Nemo & co collected $15 from pot
*** SUMMARY ***
Total pot $15 | Rake $0 
Seat 1: ZarubaNT (big blind) folded before Flop
Seat 2: Nemo & co collected ($15)
Seat 3: garougary folded before Flop (didn't bet)
Seat 4: mustanggino folded before Flop (didn't bet)
Seat 5: king10clubs (button) folded before Flop (didn't bet)
Seat 6: floriiiiider (small blind) folded before Flop


PokerStars Game #102596164221:  Hold'em No Limit ($3/$6 USD) - 2013/08/11 4:38:36 ET
Table 'Klemola 40-100 bb' 6-max Seat #6 is the button
Seat 1: ZarubaNT ($600 in chips) 
Seat 2: Nemo & co ($377.52 in chips) 
Seat 3: garougary ($316.14 in chips) 
Seat 4: mustanggino ($591.18 in chips) 
Seat 5: king10clubs ($1169.19 in chips) 
Seat 6: floriiiiider ($1140.40 in chips) 
ZarubaNT: posts small blind $3
Nemo & co: posts big blind $6
*** HOLE CARDS ***
garougary: raises $6 to $12
mustanggino: folds 
king10clubs: folds 
floriiiiider: folds 
ZarubaNT: calls $9
Nemo & co is disconnected 
Nemo & co is connected 
Nemo & co: calls $6
*** FLOP *** [9s Kd 6d]
ZarubaNT: checks 
Nemo & co: checks 
garougary: bets $24
ZarubaNT: calls $24
Nemo & co: raises $42 to $66
garougary: folds 
ZarubaNT: calls $42
*** TURN *** [9s Kd 6d] [6h]
ZarubaNT: checks 
Nemo & co: bets $84
ZarubaNT: raises $438 to $522 and is all-in
Nemo & co: calls $215.52 and is all-in
Uncalled bet ($222.48) returned to ZarubaNT
*** RIVER *** [9s Kd 6d 6h] [Ac]
*** SHOW DOWN ***
ZarubaNT: shows [Qc Kh] (two pair, Kings and Sixes)
Nemo & co: shows [9d 9h] (a full house, Nines full of Sixes)
Nemo & co collected $788.24 from pot
*** SUMMARY ***
Total pot $791.04 | Rake $2.80 
Board [9s Kd 6d 6h Ac]
Seat 1: ZarubaNT (small blind) showed [Qc Kh] and lost with two pair, Kings and Sixes
Seat 2: Nemo & co (big blind) showed [9d 9h] and won ($788.24) with a full house, Nines full of Sixes
Seat 3: garougary folded on the Flop
Seat 4: mustanggino folded before Flop (didn't bet)
Seat 5: king10clubs folded before Flop (didn't bet)
Seat 6: floriiiiider (button) folded before Flop (didn't bet)


PokerStars Game #102595985776:  Hold'em No Limit ($3/$6 USD) - 2013/08/11 4:30:12 ET
Table 'Klemola 40-100 bb' 6-max Seat #5 is the button
Seat 1: ZarubaNT ($600 in chips) 
Seat 2: Nemo & co ($356.52 in chips) 
Seat 3: garougary ($331.14 in chips) 
Seat 4: mustanggino ($529.20 in chips) 
Seat 5: king10clubs ($1119.79 in chips) 
Seat 6: floriiiiider ($1227.40 in chips) 
floriiiiider: posts small blind $3
ZarubaNT: posts big blind $6
*** HOLE CARDS ***
Nemo & co: folds 
garougary: folds 
mustanggino: folds 
king10clubs: raises $6 to $12
floriiiiider: folds 
ZarubaNT: calls $6
*** FLOP *** [Jd 8s 2s]
ZarubaNT: checks 
king10clubs: bets $17.40
ZarubaNT: folds 
Uncalled bet ($17.40) returned to king10clubs
king10clubs collected $25.78 from pot
king10clubs: doesn't show hand 
*** SUMMARY ***
Total pot $27 | Rake $1.22 
Board [Jd 8s 2s]
Seat 1: ZarubaNT (big blind) folded on the Flop
Seat 2: Nemo & co folded before Flop (didn't bet)
Seat 3: garougary folded before Flop (didn't bet)
Seat 4: mustanggino folded before Flop (didn't bet)
Seat 5: king10clubs (button) collected ($25.78)
Seat 6: floriiiiider (small blind) folded before Flop


PokerStars Game #102595999359:  Hold'em No Limit ($3/$6 USD) - 2013/08/11 4:30:51 ET
Table 'Klemola 40-100 bb' 6-max Seat #6 is the button
Seat 1: ZarubaNT ($600 in chips) 
Seat 2: Nemo & co ($356.52 in chips) 
Seat 3: garougary ($331.14 in chips) 
Seat 4: mustanggino ($529.20 in chips) 
Seat 5: king10clubs ($1133.57 in chips) 
Seat 6: floriiiiider ($1224.40 in chips) 
ZarubaNT: posts small blind $3
Nemo & co: posts big blind $6
*** HOLE CARDS ***
garougary: raises $6 to $12
mustanggino: folds 
king10clubs: folds 
floriiiiider: folds 
ZarubaNT: folds 
Nemo & co: folds 
Uncalled bet ($6) returned to garougary
garougary collected $15 from pot
garougary: doesn't show hand 
*** SUMMARY ***
Total pot $15 | Rake $0 
Seat 1: ZarubaNT (small blind) folded before Flop
Seat 2: Nemo & co (big blind) folded before Flop
Seat 3: garougary collected ($15)
Seat 4: mustanggino folded before Flop (didn't bet)
Seat 5: king10clubs folded before Flop (didn't bet)
Seat 6: floriiiiider (button) folded before Flop (didn't bet)


PokerStars Game #102596004511:  Hold'em No Limit ($3/$6 USD) - 2013/08/11 4:31:06 ET
Table 'Klemola 40-100 bb' 6-max Seat #1 is the button
Seat 1: ZarubaNT ($600 in chips) 
Seat 2: Nemo & co ($350.52 in chips) 
Seat 3: garougary ($340.14 in chips) 
Seat 4: mustanggino ($529.20 in chips) 
Seat 5: king10clubs ($1133.57 in chips) 
Seat 6: floriiiiider ($1224.40 in chips) 
Nemo & co: posts small blind $3
garougary: posts big blind $6
*** HOLE CARDS ***
mustanggino: raises $6 to $12
king10clubs: folds 
floriiiiider: folds 
ZarubaNT: folds 
Nemo & co: folds 
garougary: calls $6
*** FLOP *** [Jd 2c 8d]
garougary: checks 
mustanggino: bets $12
garougary: folds 
Uncalled bet ($12) returned to mustanggino
mustanggino collected $25.78 from pot
mustanggino: doesn't show hand 
*** SUMMARY ***
Total pot $27 | Rake $1.22 
Board [Jd 2c 8d]
Seat 1: ZarubaNT (button) folded before Flop (didn't bet)
Seat 2: Nemo & co (small blind) folded before Flop
Seat 3: garougary (big blind) folded on the Flop
Seat 4: mustanggino collected ($25.78)
Seat 5: king10clubs folded before Flop (didn't bet)
Seat 6: floriiiiider folded before Flop (didn't bet)


PokerStars Game #102596023027:  Hold'em No Limit ($3/$6 USD) - 2013/08/11 4:31:58 ET
Table 'Klemola 40-100 bb' 6-max Seat #2 is the button
Seat 1: ZarubaNT ($600 in chips) 
Seat 2: Nemo & co ($347.52 in chips) 
Seat 3: garougary ($328.14 in chips) 
Seat 4: mustanggino ($542.98 in chips) 
Seat 5: king10clubs ($1133.57 in chips) 
Seat 6: floriiiiider ($1224.40 in chips) 
garougary: posts small blind $3
mustanggino: posts big blind $6
*** HOLE CARDS ***
king10clubs: raises $9 to $15
floriiiiider: calls $15
ZarubaNT: folds 
Nemo & co: folds 
garougary: folds 
mustanggino: calls $9
*** FLOP *** [9h 8d 6c]
mustanggino: checks 
king10clubs: checks 
floriiiiider: checks 
*** TURN *** [9h 8d 6c] [8c]
mustanggino: checks 
king10clubs: bets $30
floriiiiider: folds 
mustanggino: folds 
Uncalled bet ($30) returned to king10clubs
king10clubs collected $45.84 from pot
king10clubs: doesn't show hand 
*** SUMMARY ***
Total pot $48 | Rake $2.16 
Board [9h 8d 6c 8c]
Seat 1: ZarubaNT folded before Flop (didn't bet)
Seat 2: Nemo & co (button) folded before Flop (didn't bet)
Seat 3: garougary (small blind) folded before Flop
Seat 4: mustanggino (big blind) folded on the Turn
Seat 5: king10clubs collected ($45.84)
Seat 6: floriiiiider folded on the Turn


PokerStars Game #102596062455:  Hold'em No Limit ($3/$6 USD) - 2013/08/11 4:33:50 ET
Table 'Klemola 40-100 bb' 6-max Seat #3 is the button
Seat 1: ZarubaNT ($600 in chips) 
Seat 2: Nemo & co ($347.52 in chips) 
Seat 3: garougary ($325.14 in chips) 
Seat 4: mustanggino ($527.98 in chips) 
Seat 5: king10clubs ($1164.41 in chips) 
Seat 6: floriiiiider ($1209.40 in chips) 
mustanggino: posts small blind $3
king10clubs: posts big blind $6
*** HOLE CARDS ***
floriiiiider: folds 
ZarubaNT: folds 
Nemo & co: folds 
garougary: folds 
mustanggino: folds 
Uncalled bet ($3) returned to king10clubs
king10clubs collected $6 from pot
king10clubs: doesn't show hand 
*** SUMMARY ***
Total pot $6 | Rake $0 
Seat 1: ZarubaNT folded before Flop (didn't bet)
Seat 2: Nemo & co folded before Flop (didn't bet)
Seat 3: garougary (button) folded before Flop (didn't bet)
Seat 4: mustanggino (small blind) folded before Flop
Seat 5: king10clubs (big blind) collected ($6)
Seat 6: floriiiiider folded before Flop (didn't bet)


PokerStars Game #102596068193:  Hold'em No Limit ($3/$6 USD) - 2013/08/11 4:34:07 ET
Table 'Klemola 40-100 bb' 6-max Seat #4 is the button
Seat 1: ZarubaNT ($600 in chips) 
Seat 2: Nemo & co ($347.52 in chips) 
Seat 3: garougary ($325.14 in chips) 
Seat 4: mustanggino ($524.98 in chips) 
Seat 5: king10clubs ($1167.41 in chips) 
Seat 6: floriiiiider ($1209.40 in chips) 
king10clubs: posts small blind $3
floriiiiider: posts big blind $6
*** HOLE CARDS ***
ZarubaNT: folds 
Nemo & co: folds 
garougary: folds 
mustanggino: raises $6 to $12
king10clubs: folds 
floriiiiider: calls $6
*** FLOP *** [Jc 8c 8d]
floriiiiider: checks 
mustanggino: bets $12
floriiiiider: calls $12
*** TURN *** [Jc 8c 8d] [5d]
floriiiiider: checks 
mustanggino: checks 
*** RIVER *** [Jc 8c 8d 5d] [7h]
floriiiiider: bets $33
mustanggino: calls $33
*** SHOW DOWN ***
floriiiiider: shows [9h As] (a pair of Eights)
mustanggino: shows [5h 3h] (two pair, Eights and Fives)
mustanggino collected $114.20 from pot
*** SUMMARY ***
Total pot $117 | Rake $2.80 
Board [Jc 8c 8d 5d 7h]
Seat 1: ZarubaNT folded before Flop (didn't bet)
Seat 2: Nemo & co folded before Flop (didn't bet)
Seat 3: garougary folded before Flop (didn't bet)
Seat 4: mustanggino (button) showed [5h 3h] and won ($114.20) with two pair, Eights and Fives
Seat 5: king10clubs (small blind) folded before Flop
Seat 6: floriiiiider (big blind) showed [9h As] and lost with a pair of Eights


PokerStars Game #102596412033:  Hold'em No Limit ($3/$6 USD) - 2013/08/11 4:50:14 ET
Table 'Klemola 40-100 bb' 6-max Seat #5 is the button
Seat 1: ZarubaNT ($609 in chips) 
Seat 2: Nemo & co ($777.48 in chips) 
Seat 3: JulyShort ($270 in chips) 
Seat 4: mustanggino ($549.18 in chips) 
Seat 5: king10clubs ($1209.91 in chips) 
Seat 6: floriiiiider ($1179.70 in chips) 
floriiiiider: posts small blind $3
ZarubaNT: posts big blind $6
*** HOLE CARDS ***
Nemo & co: folds 
JulyShort: folds 
mustanggino: folds 
king10clubs: raises $6 to $12
floriiiiider: folds 
ZarubaNT: calls $6
*** FLOP *** [Ts 6s 2h]
ZarubaNT: checks 
king10clubs: bets $18
ZarubaNT: calls $18
*** TURN *** [Ts 6s 2h] [5s]
ZarubaNT: checks 
king10clubs: checks 
*** RIVER *** [Ts 6s 2h 5s] [6d]
ZarubaNT: checks 
king10clubs: checks 
*** SHOW DOWN ***
ZarubaNT: shows [Ac Tc] (two pair, Tens and Sixes)
king10clubs: mucks hand 
ZarubaNT collected $60.20 from pot
*** SUMMARY ***
Total pot $63 | Rake $2.80 
Board [Ts 6s 2h 5s 6d]
Seat 1: ZarubaNT (big blind) showed [Ac Tc] and won ($60.20) with two pair, Tens and Sixes
Seat 2: Nemo & co folded before Flop (didn't bet)
Seat 3: JulyShort folded before Flop (didn't bet)
Seat 4: mustanggino folded before Flop (didn't bet)
Seat 5: king10clubs (button) mucked
Seat 6: floriiiiider (small blind) folded before Flop


PokerStars Game #102596432795:  Hold'em No Limit ($3/$6 USD) - 2013/08/11 4:51:13 ET
Table 'Klemola 40-100 bb' 6-max Seat #6 is the button
Seat 1: ZarubaNT ($639.20 in chips) 
Seat 2: Nemo & co ($777.48 in chips) 
Seat 3: JulyShort ($270 in chips) 
Seat 4: mustanggino ($549.18 in chips) 
Seat 5: king10clubs ($1179.91 in chips) 
Seat 6: floriiiiider ($1176.70 in chips) 
ZarubaNT: posts small blind $3
Nemo & co: posts big blind $6
*** HOLE CARDS ***
JulyShort: folds 
mustanggino: folds 
king10clubs: raises $9 to $15
floriiiiider: raises $36 to $51
ZarubaNT: folds 
Nemo & co: folds 
king10clubs: folds 
Uncalled bet ($36) returned to floriiiiider
floriiiiider collected $39 from pot
floriiiiider: doesn't show hand 
*** SUMMARY ***
Total pot $39 | Rake $0 
Seat 1: ZarubaNT (small blind) folded before Flop
Seat 2: Nemo & co (big blind) folded before Flop
Seat 3: JulyShort folded before Flop (didn't bet)
Seat 4: mustanggino folded before Flop (didn't bet)
Seat 5: king10clubs folded before Flop
Seat 6: floriiiiider (button) collected ($39)


PokerStars Game #102596444527:  Hold'em No Limit ($3/$6 USD) - 2013/08/11 4:51:46 ET
Table 'Klemola 40-100 bb' 6-max Seat #1 is the button
Seat 1: ZarubaNT ($636.20 in chips) 
Seat 2: Nemo & co ($771.48 in chips) 
Seat 3: JulyShort ($270 in chips) 
Seat 4: mustanggino ($549.18 in chips) 
Seat 5: king10clubs ($1164.91 in chips) 
Seat 6: floriiiiider ($1200.70 in chips) 
Nemo & co: posts small blind $3
JulyShort: posts big blind $6
*** HOLE CARDS ***
mustanggino: raises $6 to $12
king10clubs: folds 
floriiiiider: calls $12
ZarubaNT: folds 
Nemo & co: folds 
JulyShort: folds 
*** FLOP *** [4d 9d 8c]
mustanggino: checks 
floriiiiider: bets $21
mustanggino: folds 
Uncalled bet ($21) returned to floriiiiider
floriiiiider collected $31.52 from pot
floriiiiider: doesn't show hand 
*** SUMMARY ***
Total pot $33 | Rake $1.48 
Board [4d 9d 8c]
Seat 1: ZarubaNT (button) folded before Flop (didn't bet)
Seat 2: Nemo & co (small blind) folded before Flop
Seat 3: JulyShort (big blind) folded before Flop
Seat 4: mustanggino folded on the Flop
Seat 5: king10clubs folded before Flop (didn't bet)
Seat 6: floriiiiider collected ($31.52)


PokerStars Game #102596456870:  Hold'em No Limit ($3/$6 USD) - 2013/08/11 4:52:21 ET
Table 'Klemola 40-100 bb' 6-max Seat #2 is the button
Seat 1: ZarubaNT ($636.20 in chips) 
Seat 2: Nemo & co ($768.48 in chips) 
Seat 3: JulyShort ($264 in chips) 
Seat 4: mustanggino ($537.18 in chips) 
Seat 5: king10clubs ($1164.91 in chips) 
Seat 6: floriiiiider ($1220.22 in chips) 
JulyShort: posts small blind $3
mustanggino: posts big blind $6
*** HOLE CARDS ***
king10clubs: folds 
floriiiiider: raises $12 to $18
ZarubaNT: folds 
Nemo & co: folds 
JulyShort: folds 
mustanggino: folds 
Uncalled bet ($12) returned to floriiiiider
floriiiiider collected $15 from pot
floriiiiider: doesn't show hand 
*** SUMMARY ***
Total pot $15 | Rake $0 
Seat 1: ZarubaNT folded before Flop (didn't bet)
Seat 2: Nemo & co (button) folded before Flop (didn't bet)
Seat 3: JulyShort (small blind) folded before Flop
Seat 4: mustanggino (big blind) folded before Flop
Seat 5: king10clubs folded before Flop (didn't bet)
Seat 6: floriiiiider collected ($15)


PokerStars Game #102596464455:  Hold'em No Limit ($3/$6 USD) - 2013/08/11 4:52:42 ET
Table 'Klemola 40-100 bb' 6-max Seat #3 is the button
Seat 1: ZarubaNT ($636.20 in chips) 
Seat 2: Nemo & co ($768.48 in chips) 
Seat 3: JulyShort ($261 in chips) 
Seat 4: mustanggino ($531.18 in chips) 
Seat 5: king10clubs ($1164.91 in chips) 
Seat 6: floriiiiider ($1229.22 in chips) 
mustanggino: posts small blind $3
king10clubs: posts big blind $6
*** HOLE CARDS ***
floriiiiider: folds 
ZarubaNT: folds 
Nemo & co: raises $12 to $18
JulyShort: folds 
mustanggino: folds 
king10clubs: raises $39 to $57
Nemo & co: folds 
Uncalled bet ($39) returned to king10clubs
king10clubs collected $39 from pot
king10clubs: doesn't show hand 
*** SUMMARY ***
Total pot $39 | Rake $0 
Seat 1: ZarubaNT folded before Flop (didn't bet)
Seat 2: Nemo & co folded before Flop
Seat 3: JulyShort (button) folded before Flop (didn't bet)
Seat 4: mustanggino (small blind) folded before Flop
Seat 5: king10clubs (big blind) collected ($39)
Seat 6: floriiiiider folded before Flop (didn't bet)


PokerStars Game #102596477163:  Hold'em No Limit ($3/$6 USD) - 2013/08/11 4:53:18 ET
Table 'Klemola 40-100 bb' 6-max Seat #4 is the button
Seat 1: ZarubaNT ($636.20 in chips) 
Seat 2: Nemo & co ($750.48 in chips) 
Seat 3: JulyShort ($261 in chips) 
Seat 4: mustanggino ($528.18 in chips) 
Seat 5: king10clubs ($1185.91 in chips) 
Seat 6: floriiiiider ($1229.22 in chips) 
king10clubs: posts small blind $3
floriiiiider: posts big blind $6
*** HOLE CARDS ***
ZarubaNT: raises $12 to $18
Nemo & co: folds 
JulyShort: folds 
mustanggino: folds 
king10clubs: folds 
floriiiiider: folds 
Uncalled bet ($12) returned to ZarubaNT
ZarubaNT collected $15 from pot
ZarubaNT: doesn't show hand 
*** SUMMARY ***
Total pot $15 | Rake $0 
Seat 1: ZarubaNT collected ($15)
Seat 2: Nemo & co folded before Flop (didn't bet)
Seat 3: JulyShort folded before Flop (didn't bet)
Seat 4: mustanggino (button) folded before Flop (didn't bet)
Seat 5: king10clubs (small blind) folded before Flop
Seat 6: floriiiiider (big blind) folded before Flop


PokerStars Game #102596486440:  Hold'em No Limit ($3/$6 USD) - 2013/08/11 4:53:44 ET
Table 'Klemola 40-100 bb' 6-max Seat #5 is the button
Seat 1: ZarubaNT ($645.20 in chips) 
Seat 2: Nemo & co ($750.48 in chips) 
Seat 3: JulyShort ($261 in chips) 
Seat 4: mustanggino ($528.18 in chips) 
Seat 5: king10clubs ($1182.91 in chips) 
Seat 6: floriiiiider ($1223.22 in chips) 
floriiiiider: posts small blind $3
ZarubaNT: posts big blind $6
*** HOLE CARDS ***
Nemo & co: folds 
JulyShort: folds 
mustanggino: folds 
king10clubs: raises $6 to $12
floriiiiider: folds 
ZarubaNT: calls $6
*** FLOP *** [Jd Ad 3h]
ZarubaNT: checks 
king10clubs: checks 
*** TURN *** [Jd Ad 3h] [2c]
ZarubaNT: checks 
king10clubs: bets $18
ZarubaNT: folds 
Uncalled bet ($18) returned to king10clubs
king10clubs collected $25.78 from pot
king10clubs: doesn't show hand 
*** SUMMARY ***
Total pot $27 | Rake $1.22 
Board [Jd Ad 3h 2c]
Seat 1: ZarubaNT (big blind) folded on the Turn
Seat 2: Nemo & co folded before Flop (didn't bet)
Seat 3: JulyShort folded before Flop (didn't bet)
Seat 4: mustanggino folded before Flop (didn't bet)
Seat 5: king10clubs (button) collected ($25.78)
Seat 6: floriiiiider (small blind) folded before Flop


PokerStars Game #102596502072:  Hold'em No Limit ($3/$6 USD) - 2013/08/11 4:54:28 ET
Table 'Klemola 40-100 bb' 6-max Seat #6 is the button
Seat 1: ZarubaNT ($633.20 in chips) 
Seat 2: Nemo & co ($750.48 in chips) 
Seat 3: JulyShort ($261 in chips) 
Seat 4: mustanggino ($528.18 in chips) 
Seat 5: king10clubs ($1196.69 in chips) 
Seat 6: floriiiiider ($1220.22 in chips) 
ZarubaNT: posts small blind $3
Nemo & co: posts big blind $6
*** HOLE CARDS ***
JulyShort: folds 
mustanggino: folds 
king10clubs: raises $9 to $15
floriiiiider: folds 
ZarubaNT: calls $12
Nemo & co: calls $9
*** FLOP *** [2d Jc Tc]
ZarubaNT: checks 
Nemo & co: checks 
king10clubs: checks 
*** TURN *** [2d Jc Tc] [7c]
ZarubaNT: checks 
Nemo & co: bets $30
king10clubs: folds 
ZarubaNT: calls $30
*** RIVER *** [2d Jc Tc 7c] [3s]
ZarubaNT: checks 
Nemo & co: checks 
*** SHOW DOWN ***
ZarubaNT: shows [Ks Qd] (high card King)
Nemo & co: shows [Ac 9h] (high card Ace)
Nemo & co collected $102.20 from pot
*** SUMMARY ***
Total pot $105 | Rake $2.80 
Board [2d Jc Tc 7c 3s]
Seat 1: ZarubaNT (small blind) showed [Ks Qd] and lost with high card King
Seat 2: Nemo & co (big blind) showed [Ac 9h] and won ($102.20) with high card Ace
Seat 3: JulyShort folded before Flop (didn't bet)
Seat 4: mustanggino folded before Flop (didn't bet)
Seat 5: king10clubs folded on the Turn
Seat 6: floriiiiider (button) folded before Flop (didn't bet)


PokerStars Game #102596308951:  Hold'em No Limit ($3/$6 USD) - 2013/08/11 4:45:23 ET
Table 'Klemola 40-100 bb' 6-max Seat #1 is the button
Seat 1: ZarubaNT ($600 in chips) 
Seat 2: Nemo & co ($789.48 in chips) 
Seat 4: mustanggino ($570.18 in chips) 
Seat 5: king10clubs ($1224.91 in chips) 
Seat 6: floriiiiider ($1172.05 in chips) 
Nemo & co: posts small blind $3
mustanggino: posts big blind $6
*** HOLE CARDS ***
king10clubs: folds 
floriiiiider: folds 
ZarubaNT: raises $6 to $12
Nemo & co: folds 
mustanggino: folds 
Uncalled bet ($6) returned to ZarubaNT
ZarubaNT collected $15 from pot
ZarubaNT: doesn't show hand 
*** SUMMARY ***
Total pot $15 | Rake $0 
Seat 1: ZarubaNT (button) collected ($15)
Seat 2: Nemo & co (small blind) folded before Flop
Seat 4: mustanggino (big blind) folded before Flop
Seat 5: king10clubs folded before Flop (didn't bet)
Seat 6: floriiiiider folded before Flop (didn't bet)


PokerStars Game #102596320307:  Hold'em No Limit ($3/$6 USD) - 2013/08/11 4:45:55 ET
Table 'Klemola 40-100 bb' 6-max Seat #2 is the button
Seat 1: ZarubaNT ($609 in chips) 
Seat 2: Nemo & co ($786.48 in chips) 
Seat 4: mustanggino ($564.18 in chips) 
Seat 5: king10clubs ($1224.91 in chips) 
Seat 6: floriiiiider ($1172.05 in chips) 
mustanggino: posts small blind $3
king10clubs: posts big blind $6
*** HOLE CARDS ***
floriiiiider: raises $12 to $18
ZarubaNT: folds 
Nemo & co: folds 
mustanggino: folds 
king10clubs: folds 
Uncalled bet ($12) returned to floriiiiider
floriiiiider collected $15 from pot
floriiiiider: doesn't show hand 
*** SUMMARY ***
Total pot $15 | Rake $0 
Seat 1: ZarubaNT folded before Flop (didn't bet)
Seat 2: Nemo & co (button) folded before Flop (didn't bet)
Seat 4: mustanggino (small blind) folded before Flop
Seat 5: king10clubs (big blind) folded before Flop
Seat 6: floriiiiider collected ($15)


PokerStars Game #102596330074:  Hold'em No Limit ($3/$6 USD) - 2013/08/11 4:46:23 ET
Table 'Klemola 40-100 bb' 6-max Seat #4 is the button
Seat 1: ZarubaNT ($609 in chips) 
Seat 2: Nemo & co ($786.48 in chips) 
Seat 4: mustanggino ($561.18 in chips) 
Seat 5: king10clubs ($1218.91 in chips) 
Seat 6: floriiiiider ($1181.05 in chips) 
king10clubs: posts small blind $3
floriiiiider: posts big blind $6
*** HOLE CARDS ***
ZarubaNT: folds 
Nemo & co: folds 
mustanggino: raises $6 to $12
king10clubs: raises $36 to $48
floriiiiider: folds 
mustanggino: folds 
Uncalled bet ($36) returned to king10clubs
king10clubs collected $30 from pot
king10clubs: doesn't show hand 
*** SUMMARY ***
Total pot $30 | Rake $0 
Seat 1: ZarubaNT folded before Flop (didn't bet)
Seat 2: Nemo & co folded before Flop (didn't bet)
Seat 4: mustanggino (button) folded before Flop
Seat 5: king10clubs (small blind) collected ($30)
Seat 6: floriiiiider (big blind) folded before Flop


PokerStars Game #102596341634:  Hold'em No Limit ($3/$6 USD) - 2013/08/11 4:46:55 ET
Table 'Klemola 40-100 bb' 6-max Seat #5 is the button
Seat 1: ZarubaNT ($609 in chips) 
Seat 2: Nemo & co ($786.48 in chips) 
Seat 4: mustanggino ($549.18 in chips) 
Seat 5: king10clubs ($1236.91 in chips) 
Seat 6: floriiiiider ($1175.05 in chips) 
floriiiiider: posts small blind $3
ZarubaNT: posts big blind $6
*** HOLE CARDS ***
Nemo & co: folds 
mustanggino: folds 
king10clubs: raises $6 to $12
floriiiiider: calls $9
ZarubaNT: folds 
*** FLOP *** [6s Th Jd]
floriiiiider: checks 
king10clubs: checks 
*** TURN *** [6s Th Jd] [Qc]
floriiiiider: checks 
king10clubs: checks 
*** RIVER *** [6s Th Jd Qc] [5h]
floriiiiider: checks 
king10clubs: checks 
*** SHOW DOWN ***
floriiiiider: shows [5d 5c] (three of a kind, Fives)
king10clubs: mucks hand 
floriiiiider collected $28.65 from pot
JulyShort joins the table at seat #3 
*** SUMMARY ***
Total pot $30 | Rake $1.35 
Board [6s Th Jd Qc 5h]
Seat 1: ZarubaNT (big blind) folded before Flop
Seat 2: Nemo & co folded before Flop (didn't bet)
Seat 4: mustanggino folded before Flop (didn't bet)
Seat 5: king10clubs (button) mucked
Seat 6: floriiiiider (small blind) showed [5d 5c] and won ($28.65) with three of a kind, Fives


PokerStars Game #102596359358:  Hold'em No Limit ($3/$6 USD) - 2013/08/11 4:47:46 ET
Table 'Klemola 40-100 bb' 6-max Seat #6 is the button
Seat 1: ZarubaNT ($603 in chips) 
Seat 2: Nemo & co ($786.48 in chips) 
Seat 4: mustanggino ($549.18 in chips) 
Seat 5: king10clubs ($1224.91 in chips) 
Seat 6: floriiiiider ($1191.70 in chips) 
ZarubaNT: posts small blind $3
Nemo & co: posts big blind $6
JulyShort: sits out 
*** HOLE CARDS ***
mustanggino: folds 
king10clubs: folds 
floriiiiider: folds 
ZarubaNT: raises $12 to $18
Nemo & co: folds 
Uncalled bet ($12) returned to ZarubaNT
ZarubaNT collected $12 from pot
ZarubaNT: doesn't show hand 
*** SUMMARY ***
Total pot $12 | Rake $0 
Seat 1: ZarubaNT (small blind) collected ($12)
Seat 2: Nemo & co (big blind) folded before Flop
Seat 4: mustanggino folded before Flop (didn't bet)
Seat 5: king10clubs folded before Flop (didn't bet)
Seat 6: floriiiiider (button) folded before Flop (didn't bet)


PokerStars Game #102596365230:  Hold'em No Limit ($3/$6 USD) - 2013/08/11 4:48:02 ET
Table 'Klemola 40-100 bb' 6-max Seat #1 is the button
Seat 1: ZarubaNT ($609 in chips) 
Seat 2: Nemo & co ($780.48 in chips) 
Seat 3: JulyShort ($240 in chips) 
Seat 4: mustanggino ($549.18 in chips) 
Seat 5: king10clubs ($1224.91 in chips) 
Seat 6: floriiiiider ($1191.70 in chips) 
Nemo & co: posts small blind $3
JulyShort: posts big blind $6
*** HOLE CARDS ***
mustanggino: folds 
king10clubs: raises $9 to $15
floriiiiider: folds 
ZarubaNT: folds 
Nemo & co: folds 
JulyShort: folds 
Uncalled bet ($9) returned to king10clubs
king10clubs collected $15 from pot
king10clubs: doesn't show hand 
*** SUMMARY ***
Total pot $15 | Rake $0 
Seat 1: ZarubaNT (button) folded before Flop (didn't bet)
Seat 2: Nemo & co (small blind) folded before Flop
Seat 3: JulyShort (big blind) folded before Flop
Seat 4: mustanggino folded before Flop (didn't bet)
Seat 5: king10clubs collected ($15)
Seat 6: floriiiiider folded before Flop (didn't bet)


PokerStars Game #102596370790:  Hold'em No Limit ($3/$6 USD) - 2013/08/11 4:48:18 ET
Table 'Klemola 40-100 bb' 6-max Seat #2 is the button
Seat 1: ZarubaNT ($609 in chips) 
Seat 2: Nemo & co ($777.48 in chips) 
Seat 3: JulyShort ($234 in chips) 
Seat 4: mustanggino ($549.18 in chips) 
Seat 5: king10clubs ($1233.91 in chips) 
Seat 6: floriiiiider ($1191.70 in chips) 
JulyShort: posts small blind $3
mustanggino: posts big blind $6
*** HOLE CARDS ***
king10clubs: raises $9 to $15
floriiiiider: calls $15
ZarubaNT: folds 
Nemo & co: folds 
JulyShort: raises $36 to $51
mustanggino: folds 
king10clubs: folds 
floriiiiider: folds 
Uncalled bet ($36) returned to JulyShort
JulyShort collected $51 from pot
JulyShort: doesn't show hand 
*** SUMMARY ***
Total pot $51 | Rake $0 
Seat 1: ZarubaNT folded before Flop (didn't bet)
Seat 2: Nemo & co (button) folded before Flop (didn't bet)
Seat 3: JulyShort (small blind) collected ($51)
Seat 4: mustanggino (big blind) folded before Flop
Seat 5: king10clubs folded before Flop
Seat 6: floriiiiider folded before Flop


PokerStars Game #102596389684:  Hold'em No Limit ($3/$6 USD) - 2013/08/11 4:49:11 ET
Table 'Klemola 40-100 bb' 6-max Seat #3 is the button
Seat 1: ZarubaNT ($609 in chips) 
Seat 2: Nemo & co ($777.48 in chips) 
Seat 3: JulyShort ($270 in chips) 
Seat 4: mustanggino ($543.18 in chips) 
Seat 5: king10clubs ($1218.91 in chips) 
Seat 6: floriiiiider ($1176.70 in chips) 
mustanggino: posts small blind $3
king10clubs: posts big blind $6
*** HOLE CARDS ***
floriiiiider: raises $12 to $18
ZarubaNT: folds 
Nemo & co: folds 
JulyShort: folds 
mustanggino: folds 
king10clubs: folds 
Uncalled bet ($12) returned to floriiiiider
floriiiiider collected $15 from pot
floriiiiider: doesn't show hand 
*** SUMMARY ***
Total pot $15 | Rake $0 
Seat 1: ZarubaNT folded before Flop (didn't bet)
Seat 2: Nemo & co folded before Flop (didn't bet)
Seat 3: JulyShort (button) folded before Flop (didn't bet)
Seat 4: mustanggino (small blind) folded before Flop
Seat 5: king10clubs (big blind) folded before Flop
Seat 6: floriiiiider collected ($15)


PokerStars Game #102596403670:  Hold'em No Limit ($3/$6 USD) - 2013/08/11 4:49:51 ET
Table 'Klemola 40-100 bb' 6-max Seat #4 is the button
Seat 1: ZarubaNT ($609 in chips) 
Seat 2: Nemo & co ($777.48 in chips) 
Seat 3: JulyShort ($270 in chips) 
Seat 4: mustanggino ($540.18 in chips) 
Seat 5: king10clubs ($1212.91 in chips) 
Seat 6: floriiiiider ($1185.70 in chips) 
king10clubs: posts small blind $3
floriiiiider: posts big blind $6
*** HOLE CARDS ***
ZarubaNT: folds 
Nemo & co: folds 
JulyShort: folds 
mustanggino: raises $6 to $12
king10clubs: folds 
floriiiiider: folds 
Uncalled bet ($6) returned to mustanggino
mustanggino collected $15 from pot
mustanggino: doesn't show hand 
*** SUMMARY ***
Total pot $15 | Rake $0 
Seat 1: ZarubaNT folded before Flop (didn't bet)
Seat 2: Nemo & co folded before Flop (didn't bet)
Seat 3: JulyShort folded before Flop (didn't bet)
Seat 4: mustanggino (button) collected ($15)
Seat 5: king10clubs (small blind) folded before Flop
Seat 6: floriiiiider (big blind) folded before Flop


PokerStars Game #102596830060:  Hold'em No Limit ($3/$6 USD) - 2013/08/11 5:10:04 ET
Table 'Klemola 40-100 bb' 6-max Seat #1 is the button
Seat 1: ZarubaNT ($600 in chips) 
Seat 2: Ratatuj ($234 in chips) 
Seat 3: JulyShort ($241.20 in chips) 
Seat 4: mustanggino ($450 in chips) 
Seat 5: dreamtech129 ($943.69 in chips) 
Seat 6: floriiiiider ($1889.48 in chips) 
Ratatuj: posts small blind $3
JulyShort: posts big blind $6
*** HOLE CARDS ***
mustanggino: folds 
dreamtech129: folds 
floriiiiider: raises $9 to $15
ZarubaNT: folds 
Ratatuj: raises $22.50 to $37.50
JulyShort: folds 
floriiiiider: raises $37.50 to $75
Ratatuj: folds 
Uncalled bet ($37.50) returned to floriiiiider
floriiiiider collected $81 from pot
floriiiiider: doesn't show hand 
*** SUMMARY ***
Total pot $81 | Rake $0 
Seat 1: ZarubaNT (button) folded before Flop (didn't bet)
Seat 2: Ratatuj (small blind) folded before Flop
Seat 3: JulyShort (big blind) folded before Flop
Seat 4: mustanggino folded before Flop (didn't bet)
Seat 5: dreamtech129 folded before Flop (didn't bet)
Seat 6: floriiiiider collected ($81)


PokerStars Game #102596844797:  Hold'em No Limit ($3/$6 USD) - 2013/08/11 5:10:42 ET
Table 'Klemola 40-100 bb' 6-max Seat #2 is the button
Seat 1: ZarubaNT ($600 in chips) 
Seat 2: Ratatuj ($196.50 in chips) 
Seat 3: JulyShort ($235.20 in chips) 
Seat 4: mustanggino ($450 in chips) 
Seat 5: dreamtech129 ($943.69 in chips) 
Seat 6: floriiiiider ($1932.98 in chips) 
JulyShort: posts small blind $3
mustanggino: posts big blind $6
*** HOLE CARDS ***
dreamtech129: folds 
floriiiiider: folds 
ZarubaNT: folds 
Ratatuj: raises $6.42 to $12.42
JulyShort: raises $20.58 to $33
mustanggino: folds 
Ratatuj: folds 
Uncalled bet ($20.58) returned to JulyShort
JulyShort collected $30.84 from pot
JulyShort: doesn't show hand 
*** SUMMARY ***
Total pot $30.84 | Rake $0 
Seat 1: ZarubaNT folded before Flop (didn't bet)
Seat 2: Ratatuj (button) folded before Flop
Seat 3: JulyShort (small blind) collected ($30.84)
Seat 4: mustanggino (big blind) folded before Flop
Seat 5: dreamtech129 folded before Flop (didn't bet)
Seat 6: floriiiiider folded before Flop (didn't bet)


PokerStars Game #102596856382:  Hold'em No Limit ($3/$6 USD) - 2013/08/11 5:11:12 ET
Table 'Klemola 40-100 bb' 6-max Seat #3 is the button
Seat 1: ZarubaNT ($600 in chips) 
Seat 2: Ratatuj ($184.08 in chips) 
Seat 3: JulyShort ($253.62 in chips) 
Seat 4: mustanggino ($450 in chips) 
Seat 5: dreamtech129 ($943.69 in chips) 
Seat 6: floriiiiider ($1932.98 in chips) 
mustanggino: posts small blind $3
dreamtech129: posts big blind $6
*** HOLE CARDS ***
floriiiiider: folds 
ZarubaNT: folds 
Ratatuj: raises $6 to $12
JulyShort: folds 
mustanggino: folds 
dreamtech129: folds 
Uncalled bet ($6) returned to Ratatuj
Ratatuj collected $15 from pot
Ratatuj: doesn't show hand 
*** SUMMARY ***
Total pot $15 | Rake $0 
Seat 1: ZarubaNT folded before Flop (didn't bet)
Seat 2: Ratatuj collected ($15)
Seat 3: JulyShort (button) folded before Flop (didn't bet)
Seat 4: mustanggino (small blind) folded before Flop
Seat 5: dreamtech129 (big blind) folded before Flop
Seat 6: floriiiiider folded before Flop (didn't bet)


PokerStars Game #102596864240:  Hold'em No Limit ($3/$6 USD) - 2013/08/11 5:11:32 ET
Table 'Klemola 40-100 bb' 6-max Seat #4 is the button
Seat 1: ZarubaNT ($600 in chips) 
Seat 2: Ratatuj ($193.08 in chips) 
Seat 3: JulyShort ($253.62 in chips) 
Seat 4: mustanggino ($450 in chips) 
Seat 5: dreamtech129 ($937.69 in chips) 
Seat 6: floriiiiider ($1932.98 in chips) 
dreamtech129: posts small blind $3
floriiiiider: posts big blind $6
*** HOLE CARDS ***
ZarubaNT: folds 
Ratatuj: folds 
JulyShort: folds 
mustanggino: raises $6 to $12
dreamtech129: raises $36 to $48
floriiiiider: calls $42
mustanggino: folds 
*** FLOP *** [Jc Qc Js]
dreamtech129: bets $69
floriiiiider: calls $69
*** TURN *** [Jc Qc Js] [2c]
dreamtech129: bets $174
floriiiiider: calls $174
*** RIVER *** [Jc Qc Js 2c] [6c]
dreamtech129: checks 
floriiiiider: bets $135
dreamtech129: calls $135
*** SHOW DOWN ***
floriiiiider: shows [Tc Ac] (a flush, Ace high)
dreamtech129: mucks hand 
floriiiiider collected $861.20 from pot
*** SUMMARY ***
Total pot $864 | Rake $2.80 
Board [Jc Qc Js 2c 6c]
Seat 1: ZarubaNT folded before Flop (didn't bet)
Seat 2: Ratatuj folded before Flop (didn't bet)
Seat 3: JulyShort folded before Flop (didn't bet)
Seat 4: mustanggino (button) folded before Flop
Seat 5: dreamtech129 (small blind) mucked
Seat 6: floriiiiider (big blind) showed [Tc Ac] and won ($861.20) with a flush, Ace high


PokerStars Game #102596912025:  Hold'em No Limit ($3/$6 USD) - 2013/08/11 5:13:33 ET
Table 'Klemola 40-100 bb' 6-max Seat #5 is the button
Seat 1: ZarubaNT ($600 in chips) 
Seat 2: Ratatuj ($193.08 in chips) 
Seat 3: JulyShort ($253.62 in chips) 
Seat 4: mustanggino ($450 in chips) 
Seat 5: dreamtech129 ($600 in chips) 
Seat 6: floriiiiider ($2368.18 in chips) 
floriiiiider: posts small blind $3
ZarubaNT: posts big blind $6
*** HOLE CARDS ***
Ratatuj: folds 
JulyShort: folds 
mustanggino: folds 
dreamtech129: raises $7.80 to $13.80
floriiiiider: folds 
ZarubaNT: calls $7.80
*** FLOP *** [6c 6s 2s]
ZarubaNT: checks 
dreamtech129: bets $18
ZarubaNT: folds 
Uncalled bet ($18) returned to dreamtech129
dreamtech129 collected $29.22 from pot
dreamtech129: doesn't show hand 
*** SUMMARY ***
Total pot $30.60 | Rake $1.38 
Board [6c 6s 2s]
Seat 1: ZarubaNT (big blind) folded on the Flop
Seat 2: Ratatuj folded before Flop (didn't bet)
Seat 3: JulyShort folded before Flop (didn't bet)
Seat 4: mustanggino folded before Flop (didn't bet)
Seat 5: dreamtech129 (button) collected ($29.22)
Seat 6: floriiiiider (small blind) folded before Flop


PokerStars Game #102596926336:  Hold'em No Limit ($3/$6 USD) - 2013/08/11 5:14:10 ET
Table 'Klemola 40-100 bb' 6-max Seat #6 is the button
Seat 1: ZarubaNT ($600 in chips) 
Seat 2: Ratatuj ($193.08 in chips) 
Seat 3: JulyShort ($253.62 in chips) 
Seat 4: mustanggino ($450 in chips) 
Seat 5: dreamtech129 ($615.42 in chips) 
Seat 6: floriiiiider ($2365.18 in chips) 
ZarubaNT: posts small blind $3
Ratatuj: posts big blind $6
*** HOLE CARDS ***
JulyShort: folds 
mustanggino: folds 
dreamtech129: raises $7.80 to $13.80
floriiiiider: folds 
ZarubaNT: folds 
Ratatuj: folds 
Uncalled bet ($7.80) returned to dreamtech129
dreamtech129 collected $15 from pot
dreamtech129: doesn't show hand 
*** SUMMARY ***
Total pot $15 | Rake $0 
Seat 1: ZarubaNT (small blind) folded before Flop
Seat 2: Ratatuj (big blind) folded before Flop
Seat 3: JulyShort folded before Flop (didn't bet)
Seat 4: mustanggino folded before Flop (didn't bet)
Seat 5: dreamtech129 collected ($15)
Seat 6: floriiiiider (button) folded before Flop (didn't bet)


PokerStars Game #102596932072:  Hold'em No Limit ($3/$6 USD) - 2013/08/11 5:14:25 ET
Table 'Klemola 40-100 bb' 6-max Seat #1 is the button
Seat 1: ZarubaNT ($600 in chips) 
Seat 2: Ratatuj ($187.08 in chips) 
Seat 4: mustanggino ($450 in chips) 
Seat 5: dreamtech129 ($624.42 in chips) 
Seat 6: floriiiiider ($2365.18 in chips) 
Ratatuj: posts small blind $3
JulyShort: is sitting out 
mustanggino: posts big blind $6
*** HOLE CARDS ***
dreamtech129: folds 
JulyShort leaves the table
floriiiiider: folds 
ZarubaNT: raises $6 to $12
Ratatuj: folds 
vjxbkf joins the table at seat #3 
vjxbkf leaves the table
mustanggino: calls $6
*** FLOP *** [8h Th 9d]
mustanggino: checks 
ZarubaNT: checks 
*** TURN *** [8h Th 9d] [Jc]
mustanggino: checks 
ZarubaNT: checks 
*** RIVER *** [8h Th 9d Jc] [4h]
mustanggino: checks 
ZarubaNT: checks 
*** SHOW DOWN ***
mustanggino: shows [5h 6c] (high card Jack)
ZarubaNT: shows [9h Kc] (a pair of Nines)
ZarubaNT collected $25.78 from pot
*** SUMMARY ***
Total pot $27 | Rake $1.22 
Board [8h Th 9d Jc 4h]
Seat 1: ZarubaNT (button) showed [9h Kc] and won ($25.78) with a pair of Nines
Seat 2: Ratatuj (small blind) folded before Flop
Seat 4: mustanggino (big blind) showed [5h 6c] and lost with high card Jack
Seat 5: dreamtech129 folded before Flop (didn't bet)
Seat 6: floriiiiider folded before Flop (didn't bet)


PokerStars Game #102596745956:  Hold'em No Limit ($3/$6 USD) - 2013/08/11 5:06:30 ET
Table 'Klemola 40-100 bb' 6-max Seat #4 is the button
Seat 1: ZarubaNT ($618 in chips) 
Seat 2: Nemo & co ($918.88 in chips) 
Seat 3: JulyShort ($241.20 in chips) 
Seat 4: mustanggino ($450 in chips) 
Seat 5: dreamtech129 ($957.49 in chips) 
Seat 6: floriiiiider ($1234.02 in chips) 
dreamtech129: posts small blind $3
floriiiiider: posts big blind $6
*** HOLE CARDS ***
ZarubaNT: folds 
Nemo & co is disconnected 
Nemo & co has timed out while disconnected
Nemo & co: folds 
JulyShort: folds 
mustanggino: folds 
dreamtech129: raises $7.80 to $13.80
floriiiiider: calls $7.80
*** FLOP *** [4c 3s 6s]
dreamtech129: checks 
floriiiiider: checks 
*** TURN *** [4c 3s 6s] [9d]
dreamtech129: checks 
floriiiiider: bets $18
dreamtech129: folds 
Uncalled bet ($18) returned to floriiiiider
floriiiiider collected $26.36 from pot
floriiiiider: doesn't show hand 
*** SUMMARY ***
Total pot $27.60 | Rake $1.24 
Board [4c 3s 6s 9d]
Seat 1: ZarubaNT folded before Flop (didn't bet)
Seat 2: Nemo & co folded before Flop (didn't bet)
Seat 3: JulyShort folded before Flop (didn't bet)
Seat 4: mustanggino (button) folded before Flop (didn't bet)
Seat 5: dreamtech129 (small blind) folded on the Turn
Seat 6: floriiiiider (big blind) collected ($26.36)


PokerStars Game #102596772509:  Hold'em No Limit ($3/$6 USD) - 2013/08/11 5:07:38 ET
Table 'Klemola 40-100 bb' 6-max Seat #5 is the button
Seat 1: ZarubaNT ($618 in chips) 
Seat 3: JulyShort ($241.20 in chips) 
Seat 4: mustanggino ($450 in chips) 
Seat 5: dreamtech129 ($943.69 in chips) 
Seat 6: floriiiiider ($1246.58 in chips) 
floriiiiider: posts small blind $3
ZarubaNT: posts big blind $6
*** HOLE CARDS ***
JulyShort: folds 
mustanggino: raises $6 to $12
dreamtech129: folds 
floriiiiider: folds 
Nemo & co leaves the table
ZarubaNT: calls $6
*** FLOP *** [2d Ts 9c]
ZarubaNT: checks 
mustanggino: bets $12
ZarubaNT: calls $12
*** TURN *** [2d Ts 9c] [3s]
ZarubaNT: checks 
vjxbkf joins the table at seat #2 
mustanggino: checks 
*** RIVER *** [2d Ts 9c 3s] [Ad]
vjxbkf leaves the table
Ratatuj joins the table at seat #2 
ZarubaNT: bets $36
mustanggino: folds 
Uncalled bet ($36) returned to ZarubaNT
ZarubaNT collected $48.70 from pot
ZarubaNT: doesn't show hand 
*** SUMMARY ***
Total pot $51 | Rake $2.30 
Board [2d Ts 9c 3s Ad]
Seat 1: ZarubaNT (big blind) collected ($48.70)
Seat 3: JulyShort folded before Flop (didn't bet)
Seat 4: mustanggino folded on the River
Seat 5: dreamtech129 (button) folded before Flop (didn't bet)
Seat 6: floriiiiider (small blind) folded before Flop


PokerStars Game #102596814424:  Hold'em No Limit ($3/$6 USD) - 2013/08/11 5:09:24 ET
Table 'Klemola 40-100 bb' 6-max Seat #6 is the button
Seat 1: ZarubaNT ($642.70 in chips) 
Seat 2: Ratatuj ($240 in chips) 
Seat 3: JulyShort ($241.20 in chips) 
Seat 4: mustanggino ($450 in chips) 
Seat 5: dreamtech129 ($943.69 in chips) 
Seat 6: floriiiiider ($1243.58 in chips) 
ZarubaNT: posts small blind $3
Ratatuj: posts big blind $6
*** HOLE CARDS ***
JulyShort: folds 
mustanggino: folds 
dreamtech129: folds 
floriiiiider: raises $6 to $12
ZarubaNT: raises $33 to $45
Ratatuj: folds 
floriiiiider: raises $54 to $99
ZarubaNT: raises $543.70 to $642.70 and is all-in
floriiiiider: calls $543.70
*** FLOP *** [4d 6d 9c]
*** TURN *** [4d 6d 9c] [Th]
*** RIVER *** [4d 6d 9c Th] [3s]
*** SHOW DOWN ***
ZarubaNT: shows [Qs Ts] (a pair of Tens)
floriiiiider: shows [Ac As] (a pair of Aces)
floriiiiider collected $1288.60 from pot
*** SUMMARY ***
Total pot $1291.40 | Rake $2.80 
Board [4d 6d 9c Th 3s]
Seat 1: ZarubaNT (small blind) showed [Qs Ts] and lost with a pair of Tens
Seat 2: Ratatuj (big blind) folded before Flop
Seat 3: JulyShort folded before Flop (didn't bet)
Seat 4: mustanggino folded before Flop (didn't bet)
Seat 5: dreamtech129 folded before Flop (didn't bet)
Seat 6: floriiiiider (button) showed [Ac As] and won ($1288.60) with a pair of Aces


PokerStars Game #102596532288:  Hold'em No Limit ($3/$6 USD) - 2013/08/11 4:56:05 ET
Table 'Klemola 40-100 bb' 6-max Seat #1 is the button
Seat 1: ZarubaNT ($600 in chips) 
Seat 2: Nemo & co ($807.68 in chips) 
Seat 3: JulyShort ($261 in chips) 
Seat 4: mustanggino ($528.18 in chips) 
Seat 5: king10clubs ($1181.69 in chips) 
Seat 6: floriiiiider ($1220.22 in chips) 
Nemo & co: posts small blind $3
JulyShort: posts big blind $6
*** HOLE CARDS ***
mustanggino: folds 
king10clubs: folds 
floriiiiider: folds 
ZarubaNT: raises $6 to $12
Nemo & co: calls $9
JulyShort: folds 
*** FLOP *** [7s 6h Js]
Nemo & co: checks 
ZarubaNT: checks 
*** TURN *** [7s 6h Js] [2d]
Nemo & co: bets $24
ZarubaNT: calls $24
*** RIVER *** [7s 6h Js 2d] [4c]
Nemo & co: bets $72
ZarubaNT: calls $72
*** SHOW DOWN ***
Nemo & co: shows [2s 2h] (three of a kind, Deuces)
ZarubaNT: mucks hand 
Nemo & co collected $219.20 from pot
*** SUMMARY ***
Total pot $222 | Rake $2.80 
Board [7s 6h Js 2d 4c]
Seat 1: ZarubaNT (button) mucked
Seat 2: Nemo & co (small blind) showed [2s 2h] and won ($219.20) with three of a kind, Deuces
Seat 3: JulyShort (big blind) folded before Flop
Seat 4: mustanggino folded before Flop (didn't bet)
Seat 5: king10clubs folded before Flop (didn't bet)
Seat 6: floriiiiider folded before Flop (didn't bet)


PokerStars Game #102596551714:  Hold'em No Limit ($3/$6 USD) - 2013/08/11 4:57:15 ET
Table 'Klemola 40-100 bb' 6-max Seat #2 is the button
Seat 1: ZarubaNT ($600 in chips) 
Seat 2: Nemo & co ($918.88 in chips) 
Seat 3: JulyShort ($255 in chips) 
Seat 4: mustanggino ($528.18 in chips) 
Seat 5: king10clubs ($1181.69 in chips) 
Seat 6: floriiiiider ($1220.22 in chips) 
JulyShort: posts small blind $3
mustanggino: posts big blind $6
*** HOLE CARDS ***
king10clubs: folds 
floriiiiider: raises $12 to $18
ZarubaNT: folds 
Nemo & co: folds 
JulyShort: folds 
mustanggino: folds 
Uncalled bet ($12) returned to floriiiiider
floriiiiider collected $15 from pot
floriiiiider: doesn't show hand 
*** SUMMARY ***
Total pot $15 | Rake $0 
Seat 1: ZarubaNT folded before Flop (didn't bet)
Seat 2: Nemo & co (button) folded before Flop (didn't bet)
Seat 3: JulyShort (small blind) folded before Flop
Seat 4: mustanggino (big blind) folded before Flop
Seat 5: king10clubs folded before Flop (didn't bet)
Seat 6: floriiiiider collected ($15)


PokerStars Game #102596559201:  Hold'em No Limit ($3/$6 USD) - 2013/08/11 4:57:42 ET
Table 'Klemola 40-100 bb' 6-max Seat #3 is the button
Seat 1: ZarubaNT ($600 in chips) 
Seat 2: Nemo & co ($918.88 in chips) 
Seat 3: JulyShort ($252 in chips) 
Seat 4: mustanggino ($522.18 in chips) 
Seat 6: floriiiiider ($1229.22 in chips) 
mustanggino: posts small blind $3
king10clubs: is sitting out 
floriiiiider: posts big blind $6
*** HOLE CARDS ***
ZarubaNT: folds 
Nemo & co: raises $12 to $18
JulyShort: folds 
mustanggino: folds 
floriiiiider: folds 
Uncalled bet ($12) returned to Nemo & co
Nemo & co collected $15 from pot
*** SUMMARY ***
Total pot $15 | Rake $0 
Seat 1: ZarubaNT folded before Flop (didn't bet)
Seat 2: Nemo & co collected ($15)
Seat 3: JulyShort (button) folded before Flop (didn't bet)
Seat 4: mustanggino (small blind) folded before Flop
Seat 6: floriiiiider (big blind) folded before Flop


PokerStars Game #102596568577:  Hold'em No Limit ($3/$6 USD) - 2013/08/11 4:58:15 ET
Table 'Klemola 40-100 bb' 6-max Seat #4 is the button
Seat 1: ZarubaNT ($600 in chips) 
Seat 2: Nemo & co ($927.88 in chips) 
Seat 3: JulyShort ($252 in chips) 
Seat 4: mustanggino ($519.18 in chips) 
Seat 6: floriiiiider ($1223.22 in chips) 
floriiiiider: posts small blind $3
ZarubaNT: posts big blind $6
*** HOLE CARDS ***
Nemo & co: folds 
JulyShort: folds 
mustanggino: raises $6 to $12
floriiiiider: folds 
ZarubaNT: folds 
Uncalled bet ($6) returned to mustanggino
mustanggino collected $15 from pot
mustanggino: doesn't show hand 
*** SUMMARY ***
Total pot $15 | Rake $0 
Seat 1: ZarubaNT (big blind) folded before Flop
Seat 2: Nemo & co folded before Flop (didn't bet)
Seat 3: JulyShort folded before Flop (didn't bet)
Seat 4: mustanggino (button) collected ($15)
Seat 6: floriiiiider (small blind) folded before Flop


PokerStars Game #102596574761:  Hold'em No Limit ($3/$6 USD) - 2013/08/11 4:58:37 ET
Table 'Klemola 40-100 bb' 6-max Seat #6 is the button
Seat 1: ZarubaNT ($600 in chips) 
Seat 2: Nemo & co ($927.88 in chips) 
Seat 3: JulyShort ($252 in chips) 
Seat 4: mustanggino ($528.18 in chips) 
Seat 6: floriiiiider ($1220.22 in chips) 
ZarubaNT: posts small blind $3
Nemo & co: posts big blind $6
*** HOLE CARDS ***
JulyShort: folds 
mustanggino: raises $6 to $12
floriiiiider: folds 
ZarubaNT: calls $9
Nemo & co: folds 
*** FLOP *** [Ac 7s 5h]
ZarubaNT: checks 
mustanggino: bets $18
ZarubaNT: calls $18
*** TURN *** [Ac 7s 5h] [Ks]
king10clubs leaves the table
ZarubaNT: checks 
dreamtech129 joins the table at seat #5 
mustanggino: checks 
*** RIVER *** [Ac 7s 5h Ks] [7c]
ZarubaNT: checks 
mustanggino: bets $42
ZarubaNT: folds 
Uncalled bet ($42) returned to mustanggino
mustanggino collected $63.20 from pot
mustanggino: doesn't show hand 
*** SUMMARY ***
Total pot $66 | Rake $2.80 
Board [Ac 7s 5h Ks 7c]
Seat 1: ZarubaNT (small blind) folded on the River
Seat 2: Nemo & co (big blind) folded before Flop
Seat 3: JulyShort folded before Flop (didn't bet)
Seat 4: mustanggino collected ($63.20)
Seat 6: floriiiiider (button) folded before Flop (didn't bet)


PokerStars Game #102596603099:  Hold'em No Limit ($3/$6 USD) - 2013/08/11 5:00:09 ET
Table 'Klemola 40-100 bb' 6-max Seat #1 is the button
Seat 1: ZarubaNT ($600 in chips) 
Seat 2: Nemo & co ($921.88 in chips) 
Seat 3: JulyShort ($252 in chips) 
Seat 4: mustanggino ($561.38 in chips) 
Seat 6: floriiiiider ($1220.22 in chips) 
Nemo & co: posts small blind $3
JulyShort: posts big blind $6
dreamtech129: sits out 
*** HOLE CARDS ***
mustanggino: folds 
floriiiiider: folds 
ZarubaNT: folds 
Nemo & co: folds 
Uncalled bet ($3) returned to JulyShort
JulyShort collected $6 from pot
JulyShort: doesn't show hand 
*** SUMMARY ***
Total pot $6 | Rake $0 
Seat 1: ZarubaNT (button) folded before Flop (didn't bet)
Seat 2: Nemo & co (small blind) folded before Flop
Seat 3: JulyShort (big blind) collected ($6)
Seat 4: mustanggino folded before Flop (didn't bet)
Seat 6: floriiiiider folded before Flop (didn't bet)


PokerStars Game #102596609607:  Hold'em No Limit ($3/$6 USD) - 2013/08/11 5:00:31 ET
Table 'Klemola 40-100 bb' 6-max Seat #2 is the button
Seat 1: ZarubaNT ($600 in chips) 
Seat 2: Nemo & co ($918.88 in chips) 
Seat 3: JulyShort ($255 in chips) 
Seat 4: mustanggino ($561.38 in chips) 
Seat 6: floriiiiider ($1220.22 in chips) 
JulyShort: posts small blind $3
mustanggino: posts big blind $6
dreamtech129: sits out 
*** HOLE CARDS ***
floriiiiider: folds 
ZarubaNT: raises $9 to $15
Nemo & co: folds 
JulyShort: folds 
mustanggino: folds 
Uncalled bet ($9) returned to ZarubaNT
ZarubaNT collected $15 from pot
ZarubaNT: doesn't show hand 
*** SUMMARY ***
Total pot $15 | Rake $0 
Seat 1: ZarubaNT collected ($15)
Seat 2: Nemo & co (button) folded before Flop (didn't bet)
Seat 3: JulyShort (small blind) folded before Flop
Seat 4: mustanggino (big blind) folded before Flop
Seat 6: floriiiiider folded before Flop (didn't bet)


PokerStars Game #102596616430:  Hold'em No Limit ($3/$6 USD) - 2013/08/11 5:00:53 ET
Table 'Klemola 40-100 bb' 6-max Seat #3 is the button
Seat 1: ZarubaNT ($609 in chips) 
Seat 2: Nemo & co ($918.88 in chips) 
Seat 3: JulyShort ($252 in chips) 
Seat 4: mustanggino ($555.38 in chips) 
Seat 5: dreamtech129 ($600 in chips) 
Seat 6: floriiiiider ($1220.22 in chips) 
mustanggino: posts small blind $3
dreamtech129: posts big blind $6
*** HOLE CARDS ***
floriiiiider: folds 
ZarubaNT: raises $12 to $18
Nemo & co: folds 
JulyShort: folds 
mustanggino: folds 
dreamtech129: folds 
Uncalled bet ($12) returned to ZarubaNT
ZarubaNT collected $15 from pot
ZarubaNT: doesn't show hand 
*** SUMMARY ***
Total pot $15 | Rake $0 
Seat 1: ZarubaNT collected ($15)
Seat 2: Nemo & co folded before Flop (didn't bet)
Seat 3: JulyShort (button) folded before Flop (didn't bet)
Seat 4: mustanggino (small blind) folded before Flop
Seat 5: dreamtech129 (big blind) folded before Flop
Seat 6: floriiiiider folded before Flop (didn't bet)


PokerStars Game #102596622558:  Hold'em No Limit ($3/$6 USD) - 2013/08/11 5:01:11 ET
Table 'Klemola 40-100 bb' 6-max Seat #4 is the button
Seat 1: ZarubaNT ($618 in chips) 
Seat 2: Nemo & co ($918.88 in chips) 
Seat 3: JulyShort ($252 in chips) 
Seat 4: mustanggino ($552.38 in chips) 
Seat 5: dreamtech129 ($600 in chips) 
Seat 6: floriiiiider ($1220.22 in chips) 
dreamtech129: posts small blind $3
floriiiiider: posts big blind $6
*** HOLE CARDS ***
ZarubaNT: raises $12 to $18
Nemo & co: folds 
JulyShort: folds 
mustanggino: folds 
dreamtech129: folds 
floriiiiider: folds 
Uncalled bet ($12) returned to ZarubaNT
ZarubaNT collected $15 from pot
ZarubaNT: doesn't show hand 
*** SUMMARY ***
Total pot $15 | Rake $0 
Seat 1: ZarubaNT collected ($15)
Seat 2: Nemo & co folded before Flop (didn't bet)
Seat 3: JulyShort folded before Flop (didn't bet)
Seat 4: mustanggino (button) folded before Flop (didn't bet)
Seat 5: dreamtech129 (small blind) folded before Flop
Seat 6: floriiiiider (big blind) folded before Flop


PokerStars Game #102596629765:  Hold'em No Limit ($3/$6 USD) - 2013/08/11 5:01:31 ET
Table 'Klemola 40-100 bb' 6-max Seat #5 is the button
Seat 1: ZarubaNT ($627 in chips) 
Seat 2: Nemo & co ($918.88 in chips) 
Seat 3: JulyShort ($252 in chips) 
Seat 4: mustanggino ($552.38 in chips) 
Seat 5: dreamtech129 ($600 in chips) 
Seat 6: floriiiiider ($1214.22 in chips) 
floriiiiider: posts small blind $3
ZarubaNT: posts big blind $6
*** HOLE CARDS ***
Nemo & co: folds 
JulyShort: folds 
mustanggino: folds 
dreamtech129: raises $7.80 to $13.80
floriiiiider: raises $31.20 to $45
ZarubaNT: folds 
dreamtech129: folds 
Uncalled bet ($31.20) returned to floriiiiider
floriiiiider collected $33.60 from pot
floriiiiider: doesn't show hand 
*** SUMMARY ***
Total pot $33.60 | Rake $0 
Seat 1: ZarubaNT (big blind) folded before Flop
Seat 2: Nemo & co folded before Flop (didn't bet)
Seat 3: JulyShort folded before Flop (didn't bet)
Seat 4: mustanggino folded before Flop (didn't bet)
Seat 5: dreamtech129 (button) folded before Flop
Seat 6: floriiiiider (small blind) collected ($33.60)


PokerStars Game #102596642343:  Hold'em No Limit ($3/$6 USD) - 2013/08/11 5:02:05 ET
Table 'Klemola 40-100 bb' 6-max Seat #6 is the button
Seat 1: ZarubaNT ($621 in chips) 
Seat 2: Nemo & co ($918.88 in chips) 
Seat 3: JulyShort ($252 in chips) 
Seat 4: mustanggino ($552.38 in chips) 
Seat 5: dreamtech129 ($600 in chips) 
Seat 6: floriiiiider ($1234.02 in chips) 
ZarubaNT: posts small blind $3
Nemo & co: posts big blind $6
*** HOLE CARDS ***
JulyShort: raises $6 to $12
mustanggino: folds 
dreamtech129: folds 
floriiiiider: folds 
ZarubaNT: folds 
Nemo & co: folds 
Uncalled bet ($6) returned to JulyShort
JulyShort collected $15 from pot
JulyShort: doesn't show hand 
*** SUMMARY ***
Total pot $15 | Rake $0 
Seat 1: ZarubaNT (small blind) folded before Flop
Seat 2: Nemo & co (big blind) folded before Flop
Seat 3: JulyShort collected ($15)
Seat 4: mustanggino folded before Flop (didn't bet)
Seat 5: dreamtech129 folded before Flop (didn't bet)
Seat 6: floriiiiider (button) folded before Flop (didn't bet)


PokerStars Game #102596651381:  Hold'em No Limit ($3/$6 USD) - 2013/08/11 5:02:28 ET
Table 'Klemola 40-100 bb' 6-max Seat #1 is the button
Seat 1: ZarubaNT ($618 in chips) 
Seat 2: Nemo & co ($912.88 in chips) 
Seat 3: JulyShort ($261 in chips) 
Seat 4: mustanggino ($552.38 in chips) 
Seat 5: dreamtech129 ($600 in chips) 
Seat 6: floriiiiider ($1234.02 in chips) 
Nemo & co: posts small blind $3
JulyShort: posts big blind $6
*** HOLE CARDS ***
mustanggino: folds 
dreamtech129: folds 
floriiiiider: folds 
ZarubaNT: folds 
Nemo & co: raises $6 to $12
JulyShort: folds 
Uncalled bet ($6) returned to Nemo & co
Nemo & co collected $12 from pot
*** SUMMARY ***
Total pot $12 | Rake $0 
Seat 1: ZarubaNT (button) folded before Flop (didn't bet)
Seat 2: Nemo & co (small blind) collected ($12)
Seat 3: JulyShort (big blind) folded before Flop
Seat 4: mustanggino folded before Flop (didn't bet)
Seat 5: dreamtech129 folded before Flop (didn't bet)
Seat 6: floriiiiider folded before Flop (didn't bet)


PokerStars Game #102596665699:  Hold'em No Limit ($3/$6 USD) - 2013/08/11 5:03:06 ET
Table 'Klemola 40-100 bb' 6-max Seat #2 is the button
Seat 1: ZarubaNT ($618 in chips) 
Seat 2: Nemo & co ($918.88 in chips) 
Seat 3: JulyShort ($255 in chips) 
Seat 4: mustanggino ($552.38 in chips) 
Seat 5: dreamtech129 ($600 in chips) 
Seat 6: floriiiiider ($1234.02 in chips) 
JulyShort: posts small blind $3
mustanggino: posts big blind $6
*** HOLE CARDS ***
dreamtech129: raises $7.80 to $13.80
floriiiiider: folds 
ZarubaNT: folds 
Nemo & co: folds 
JulyShort: calls $10.80
mustanggino: folds 
*** FLOP *** [Ah 8c 3s]
JulyShort: checks 
dreamtech129: bets $18
JulyShort: folds 
Uncalled bet ($18) returned to dreamtech129
dreamtech129 collected $32.09 from pot
dreamtech129: doesn't show hand 
*** SUMMARY ***
Total pot $33.60 | Rake $1.51 
Board [Ah 8c 3s]
Seat 1: ZarubaNT folded before Flop (didn't bet)
Seat 2: Nemo & co (button) folded before Flop (didn't bet)
Seat 3: JulyShort (small blind) folded on the Flop
Seat 4: mustanggino (big blind) folded before Flop
Seat 5: dreamtech129 collected ($32.09)
Seat 6: floriiiiider folded before Flop (didn't bet)


PokerStars Game #102596676838:  Hold'em No Limit ($3/$6 USD) - 2013/08/11 5:03:35 ET
Table 'Klemola 40-100 bb' 6-max Seat #3 is the button
Seat 1: ZarubaNT ($618 in chips) 
Seat 2: Nemo & co ($918.88 in chips) 
Seat 3: JulyShort ($241.20 in chips) 
Seat 4: mustanggino ($546.38 in chips) 
Seat 5: dreamtech129 ($618.29 in chips) 
Seat 6: floriiiiider ($1234.02 in chips) 
mustanggino: posts small blind $3
dreamtech129: posts big blind $6
*** HOLE CARDS ***
floriiiiider: folds 
ZarubaNT: folds 
Nemo & co: folds 
JulyShort: folds 
mustanggino: raises $6 to $12
dreamtech129: raises $24 to $36
mustanggino: raises $54 to $90
dreamtech129: calls $54
*** FLOP *** [5h 4d Ac]
mustanggino: bets $114
dreamtech129: calls $114
*** TURN *** [5h 4d Ac] [Ah]
mustanggino: bets $138
dreamtech129: calls $138
*** RIVER *** [5h 4d Ac Ah] [9h]
mustanggino: checks 
dreamtech129: checks 
*** SHOW DOWN ***
mustanggino: shows [4h Td] (two pair, Aces and Fours)
dreamtech129: shows [Qc Qd] (two pair, Aces and Queens)
dreamtech129 collected $681.20 from pot
*** SUMMARY ***
Total pot $684 | Rake $2.80 
Board [5h 4d Ac Ah 9h]
Seat 1: ZarubaNT folded before Flop (didn't bet)
Seat 2: Nemo & co folded before Flop (didn't bet)
Seat 3: JulyShort (button) folded before Flop (didn't bet)
Seat 4: mustanggino (small blind) showed [4h Td] and lost with two pair, Aces and Fours
Seat 5: dreamtech129 (big blind) showed [Qc Qd] and won ($681.20) with two pair, Aces and Queens
Seat 6: floriiiiider folded before Flop (didn't bet)


PokerStars Game #102597240757:  Hold'em No Limit ($3/$6 USD) - 2013/08/11 5:27:17 ET
Table 'Klemola 40-100 bb' 6-max Seat #4 is the button
Seat 1: floriiiiider ($2450.58 in chips) 
Seat 3: vjxbkf ($1125.67 in chips) 
Seat 4: ZarubaNT ($600 in chips) 
Seat 5: dreamtech129 ($600 in chips) 
dreamtech129: posts small blind $3
floriiiiider: posts big blind $6
SlovakPsycho: sits out 
*** HOLE CARDS ***
vjxbkf: folds 
ZarubaNT: folds 
dreamtech129: folds 
Uncalled bet ($3) returned to floriiiiider
Interra leaves the table
floriiiiider collected $6 from pot
floriiiiider: doesn't show hand 
*** SUMMARY ***
Total pot $6 | Rake $0 
Seat 1: floriiiiider (big blind) collected ($6)
Seat 3: vjxbkf folded before Flop (didn't bet)
Seat 4: ZarubaNT (button) folded before Flop (didn't bet)
Seat 5: dreamtech129 (small blind) folded before Flop


PokerStars Game #102597245297:  Hold'em No Limit ($3/$6 USD) - 2013/08/11 5:27:28 ET
Table 'Klemola 40-100 bb' 6-max Seat #5 is the button
Seat 1: floriiiiider ($2453.58 in chips) 
Seat 2: SlovakPsycho ($600 in chips) 
Seat 3: vjxbkf ($1125.67 in chips) 
Seat 4: ZarubaNT ($600 in chips) 
Seat 5: dreamtech129 ($600 in chips) 
floriiiiider: posts small blind $3
SlovakPsycho: posts big blind $6
*** HOLE CARDS ***
vjxbkf: raises $15 to $21
ChowYuenFatt joins the table at seat #6 
ZarubaNT: folds 
dreamtech129: folds 
floriiiiider: folds 
SlovakPsycho: folds 
Uncalled bet ($15) returned to vjxbkf
vjxbkf collected $15 from pot
vjxbkf: doesn't show hand 
*** SUMMARY ***
Total pot $15 | Rake $0 
Seat 1: floriiiiider (small blind) folded before Flop
Seat 2: SlovakPsycho (big blind) folded before Flop
Seat 3: vjxbkf collected ($15)
Seat 4: ZarubaNT folded before Flop (didn't bet)
Seat 5: dreamtech129 (button) folded before Flop (didn't bet)


PokerStars Game #102597254282:  Hold'em No Limit ($3/$6 USD) - 2013/08/11 5:27:51 ET
Table 'Klemola 40-100 bb' 6-max Seat #1 is the button
Seat 1: floriiiiider ($2450.58 in chips) 
Seat 2: SlovakPsycho ($600 in chips) 
Seat 3: vjxbkf ($1134.67 in chips) 
Seat 4: ZarubaNT ($600 in chips) 
Seat 5: dreamtech129 ($600 in chips) 
SlovakPsycho: posts small blind $3
vjxbkf: posts big blind $6
ChowYuenFatt: sits out 
*** HOLE CARDS ***
ZarubaNT: raises $12 to $18
dreamtech129: folds 
floriiiiider: calls $18
SlovakPsycho: folds 
vjxbkf: calls $12
*** FLOP *** [6s 3d 5d]
vjxbkf: bets $45
ZarubaNT: folds 
floriiiiider: calls $45
*** TURN *** [6s 3d 5d] [3h]
vjxbkf: bets $114
floriiiiider: calls $114
*** RIVER *** [6s 3d 5d 3h] [2h]
vjxbkf: checks 
floriiiiider: checks 
*** SHOW DOWN ***
vjxbkf: shows [Tc Th] (two pair, Tens and Threes)
floriiiiider: mucks hand 
vjxbkf collected $372.20 from pot
*** SUMMARY ***
Total pot $375 | Rake $2.80 
Board [6s 3d 5d 3h 2h]
Seat 1: floriiiiider (button) mucked
Seat 2: SlovakPsycho (small blind) folded before Flop
Seat 3: vjxbkf (big blind) showed [Tc Th] and won ($372.20) with two pair, Tens and Threes
Seat 4: ZarubaNT folded on the Flop
Seat 5: dreamtech129 folded before Flop (didn't bet)


PokerStars Game #102597296299:  Hold'em No Limit ($3/$6 USD) - 2013/08/11 5:29:38 ET
Table 'Klemola 40-100 bb' 6-max Seat #2 is the button
Seat 1: floriiiiider ($2273.58 in chips) 
Seat 2: SlovakPsycho ($600 in chips) 
Seat 3: vjxbkf ($1329.87 in chips) 
Seat 4: ZarubaNT ($600 in chips) 
Seat 5: dreamtech129 ($600 in chips) 
vjxbkf: posts small blind $3
ZarubaNT: posts big blind $6
ChowYuenFatt: sits out 
*** HOLE CARDS ***
dreamtech129: folds 
floriiiiider: folds 
SlovakPsycho: folds 
vjxbkf: folds 
Uncalled bet ($3) returned to ZarubaNT
ZarubaNT collected $6 from pot
ZarubaNT: doesn't show hand 
*** SUMMARY ***
Total pot $6 | Rake $0 
Seat 1: floriiiiider folded before Flop (didn't bet)
Seat 2: SlovakPsycho (button) folded before Flop (didn't bet)
Seat 3: vjxbkf (small blind) folded before Flop
Seat 4: ZarubaNT (big blind) collected ($6)
Seat 5: dreamtech129 folded before Flop (didn't bet)


PokerStars Game #102597074272:  Hold'em No Limit ($3/$6 USD) - 2013/08/11 5:20:23 ET
Table 'Klemola 40-100 bb' 6-max Seat #3 is the button
Seat 1: floriiiiider ($2348.38 in chips) 
Seat 2: Ratatuj ($664.44 in chips) 
Seat 3: vjxbkf ($600 in chips) 
Seat 4: ZarubaNT ($600 in chips) 
Seat 5: dreamtech129 ($658.14 in chips) 
Seat 6: Interra ($392.83 in chips) 
ZarubaNT: posts small blind $3
dreamtech129: posts big blind $6
*** HOLE CARDS ***
Interra: raises $6 to $12
floriiiiider: folds 
Ratatuj said, "v tilte sednya?"
Ratatuj: folds 
vjxbkf: calls $12
ZarubaNT: folds 
dreamtech129: folds 
*** FLOP *** [Ad Th 5c]
Interra: bets $12
ZarubaNT said, "ne"
ZarubaNT said, "default"
vjxbkf: calls $12
*** TURN *** [Ad Th 5c] [Ks]
Ratatuj said, "ok )"
Interra: bets $60
Ratatuj said, "gl"
vjxbkf: folds 
Uncalled bet ($60) returned to Interra
Interra collected $54.44 from pot
*** SUMMARY ***
Total pot $57 | Rake $2.56 
Board [Ad Th 5c Ks]
Seat 1: floriiiiider folded before Flop (didn't bet)
Seat 2: Ratatuj folded before Flop (didn't bet)
Seat 3: vjxbkf (button) folded on the Turn
Seat 4: ZarubaNT (small blind) folded before Flop
Seat 5: dreamtech129 (big blind) folded before Flop
Seat 6: Interra collected ($54.44)


PokerStars Game #102597104452:  Hold'em No Limit ($3/$6 USD) - 2013/08/11 5:21:39 ET
Table 'Klemola 40-100 bb' 6-max Seat #4 is the button
Seat 1: floriiiiider ($2348.38 in chips) 
Seat 2: Ratatuj ($664.44 in chips) 
Seat 3: vjxbkf ($600 in chips) 
Seat 4: ZarubaNT ($600 in chips) 
Seat 5: dreamtech129 ($652.14 in chips) 
Seat 6: Interra ($423.27 in chips) 
dreamtech129: posts small blind $3
Interra: posts big blind $6
*** HOLE CARDS ***
floriiiiider: folds 
Ratatuj: folds 
vjxbkf: raises $12 to $18
ZarubaNT: folds 
dreamtech129: raises $42 to $60
Interra: folds 
vjxbkf: calls $42
*** FLOP *** [4s 7h 4h]
dreamtech129: bets $72
vjxbkf: raises $90 to $162
dreamtech129: folds 
Uncalled bet ($90) returned to vjxbkf
vjxbkf collected $267.20 from pot
vjxbkf: doesn't show hand 
*** SUMMARY ***
Total pot $270 | Rake $2.80 
Board [4s 7h 4h]
Seat 1: floriiiiider folded before Flop (didn't bet)
Seat 2: Ratatuj folded before Flop (didn't bet)
Seat 3: vjxbkf collected ($267.20)
Seat 4: ZarubaNT (button) folded before Flop (didn't bet)
Seat 5: dreamtech129 (small blind) folded on the Flop
Seat 6: Interra (big blind) folded before Flop


PokerStars Game #102597138434:  Hold'em No Limit ($3/$6 USD) - 2013/08/11 5:23:02 ET
Table 'Klemola 40-100 bb' 6-max Seat #5 is the button
Seat 1: floriiiiider ($2348.38 in chips) 
Seat 2: Ratatuj ($664.44 in chips) 
Seat 3: vjxbkf ($735.20 in chips) 
Seat 4: ZarubaNT ($600 in chips) 
Seat 5: dreamtech129 ($600 in chips) 
Seat 6: Interra ($417.27 in chips) 
Interra: posts small blind $3
floriiiiider: posts big blind $6
*** HOLE CARDS ***
Ratatuj: folds 
vjxbkf: folds 
ZarubaNT: raises $9 to $15
dreamtech129: folds 
Interra: raises $9 to $24
floriiiiider: raises $42 to $66
ZarubaNT: calls $51
Interra: folds 
*** FLOP *** [As 2s 2h]
floriiiiider: bets $63
ZarubaNT: folds 
Uncalled bet ($63) returned to floriiiiider
floriiiiider collected $153.20 from pot
floriiiiider: doesn't show hand 
*** SUMMARY ***
Total pot $156 | Rake $2.80 
Board [As 2s 2h]
Seat 1: floriiiiider (big blind) collected ($153.20)
Seat 2: Ratatuj folded before Flop (didn't bet)
Seat 3: vjxbkf folded before Flop (didn't bet)
Seat 4: ZarubaNT folded on the Flop
Seat 5: dreamtech129 (button) folded before Flop (didn't bet)
Seat 6: Interra (small blind) folded before Flop


PokerStars Game #102597155195:  Hold'em No Limit ($3/$6 USD) - 2013/08/11 5:23:43 ET
Table 'Klemola 40-100 bb' 6-max Seat #6 is the button
Seat 1: floriiiiider ($2435.58 in chips) 
Seat 3: vjxbkf ($735.20 in chips) 
Seat 4: ZarubaNT ($600 in chips) 
Seat 5: dreamtech129 ($600 in chips) 
Seat 6: Interra ($393.27 in chips) 
floriiiiider: posts small blind $3
Ratatuj: is sitting out 
Ratatuj leaves the table
vjxbkf: posts big blind $6
*** HOLE CARDS ***
SlovakPsycho joins the table at seat #2 
ZarubaNT: folds 
dreamtech129: folds 
Interra: folds 
floriiiiider: raises $12 to $18
vjxbkf: folds 
Uncalled bet ($12) returned to floriiiiider
floriiiiider collected $12 from pot
floriiiiider: doesn't show hand 
*** SUMMARY ***
Total pot $12 | Rake $0 
Seat 1: floriiiiider (small blind) collected ($12)
Seat 3: vjxbkf (big blind) folded before Flop
Seat 4: ZarubaNT folded before Flop (didn't bet)
Seat 5: dreamtech129 folded before Flop (didn't bet)
Seat 6: Interra (button) folded before Flop (didn't bet)


PokerStars Game #102597168823:  Hold'em No Limit ($3/$6 USD) - 2013/08/11 5:24:17 ET
Table 'Klemola 40-100 bb' 6-max Seat #1 is the button
Seat 1: floriiiiider ($2441.58 in chips) 
Seat 3: vjxbkf ($729.20 in chips) 
Seat 4: ZarubaNT ($600 in chips) 
Seat 5: dreamtech129 ($600 in chips) 
Seat 6: Interra ($393.27 in chips) 
SlovakPsycho will be allowed to play after the button
vjxbkf: posts small blind $3
ZarubaNT: posts big blind $6
*** HOLE CARDS ***
dreamtech129: folds 
Interra: folds 
floriiiiider: raises $6 to $12
vjxbkf: folds 
ZarubaNT: folds 
Uncalled bet ($6) returned to floriiiiider
floriiiiider collected $15 from pot
floriiiiider: doesn't show hand 
*** SUMMARY ***
Total pot $15 | Rake $0 
Seat 1: floriiiiider (button) collected ($15)
Seat 3: vjxbkf (small blind) folded before Flop
Seat 4: ZarubaNT (big blind) folded before Flop
Seat 5: dreamtech129 folded before Flop (didn't bet)
Seat 6: Interra folded before Flop (didn't bet)


PokerStars Game #102597180355:  Hold'em No Limit ($3/$6 USD) - 2013/08/11 5:24:46 ET
Table 'Klemola 40-100 bb' 6-max Seat #3 is the button
Seat 1: floriiiiider ($2450.58 in chips) 
Seat 3: vjxbkf ($726.20 in chips) 
Seat 4: ZarubaNT ($600 in chips) 
Seat 5: dreamtech129 ($600 in chips) 
Seat 6: Interra ($393.27 in chips) 
ZarubaNT: posts small blind $3
dreamtech129: posts big blind $6
SlovakPsycho: sits out 
*** HOLE CARDS ***
Interra: calls $6
floriiiiider: folds 
vjxbkf: calls $6
ZarubaNT: folds 
dreamtech129: checks 
*** FLOP *** [7h Jd As]
dreamtech129: checks 
Interra: bets $30
vjxbkf: calls $30
dreamtech129: folds 
*** TURN *** [7h Jd As] [3d]
Interra: bets $72
vjxbkf: calls $72
*** RIVER *** [7h Jd As 3d] [6s]
Interra: bets $285.27 and is all-in
vjxbkf: calls $285.27
*** SHOW DOWN ***
Interra: shows [8h 9h] (high card Ace)
vjxbkf: shows [7s Qc] (a pair of Sevens)
vjxbkf collected $792.74 from pot
*** SUMMARY ***
Total pot $795.54 | Rake $2.80 
Board [7h Jd As 3d 6s]
Seat 1: floriiiiider folded before Flop (didn't bet)
Seat 3: vjxbkf (button) showed [7s Qc] and won ($792.74) with a pair of Sevens
Seat 4: ZarubaNT (small blind) folded before Flop
Seat 5: dreamtech129 (big blind) folded on the Flop
Seat 6: Interra showed [8h 9h] and lost with high card Ace


PokerStars Game #102596958205:  Hold'em No Limit ($3/$6 USD) - 2013/08/11 5:15:30 ET
Table 'Klemola 40-100 bb' 6-max Seat #2 is the button
Seat 1: ZarubaNT ($613.78 in chips) 
Seat 2: Ratatuj ($184.08 in chips) 
Seat 4: mustanggino ($450 in chips) 
Seat 5: dreamtech129 ($624.42 in chips) 
Seat 6: floriiiiider ($2365.18 in chips) 
mustanggino: posts small blind $3
dreamtech129: posts big blind $6
*** HOLE CARDS ***
floriiiiider: folds 
ZarubaNT: folds 
Ratatuj: raises $6.42 to $12.42
mustanggino: folds 
dreamtech129: folds 
Uncalled bet ($6.42) returned to Ratatuj
Ratatuj collected $15 from pot
Ratatuj: doesn't show hand 
*** SUMMARY ***
Total pot $15 | Rake $0 
Seat 1: ZarubaNT folded before Flop (didn't bet)
Seat 2: Ratatuj (button) collected ($15)
Seat 4: mustanggino (small blind) folded before Flop
Seat 5: dreamtech129 (big blind) folded before Flop
Seat 6: floriiiiider folded before Flop (didn't bet)


PokerStars Game #102596967331:  Hold'em No Limit ($3/$6 USD) - 2013/08/11 5:15:54 ET
Table 'Klemola 40-100 bb' 6-max Seat #4 is the button
Seat 2: Ratatuj ($193.08 in chips) 
Seat 4: mustanggino ($450 in chips) 
Seat 5: dreamtech129 ($618.42 in chips) 
dreamtech129: posts small blind $3
floriiiiider: is sitting out 
ZarubaNT: is sitting out 
Ratatuj: posts big blind $6
*** HOLE CARDS ***
floriiiiider leaves the table
ZarubaNT leaves the table
mustanggino: folds 
dreamtech129: raises $7.80 to $13.80
Ratatuj: calls $7.80
*** FLOP *** [4c 8d 2h]
dreamtech129: bets $15
Interra joins the table at seat #6 
Ratatuj: calls $15
*** TURN *** [4c 8d 2h] [7s]
dreamtech129: bets $36
floriiiiider joins the table at seat #1 
Ratatuj: folds 
Uncalled bet ($36) returned to dreamtech129
dreamtech129 collected $56.10 from pot
dreamtech129: doesn't show hand 
*** SUMMARY ***
Total pot $57.60 | Rake $1.50 
Board [4c 8d 2h 7s]
Seat 2: Ratatuj (big blind) folded on the Turn
Seat 4: mustanggino (button) folded before Flop (didn't bet)
Seat 5: dreamtech129 (small blind) collected ($56.10)


PokerStars Game #102596985828:  Hold'em No Limit ($3/$6 USD) - 2013/08/11 5:16:40 ET
Table 'Klemola 40-100 bb' 6-max Seat #2 is the button
Seat 2: Ratatuj ($226.20 in chips) 
Seat 5: dreamtech129 ($659.52 in chips) 
Seat 6: Interra ($480 in chips) 
dreamtech129: posts small blind $3
Interra: posts big blind $6
floriiiiider: sits out 
*** HOLE CARDS ***
Ratatuj: raises $6.42 to $12.42
dreamtech129: folds 
Interra: calls $6.42
*** FLOP *** [2d Kc Jc]
Interra: bets $18
Ratatuj: folds 
Uncalled bet ($18) returned to Interra
Interra collected $26.59 from pot
*** SUMMARY ***
Total pot $27.84 | Rake $1.25 
Board [2d Kc Jc]
Seat 2: Ratatuj (button) folded on the Flop
Seat 5: dreamtech129 (small blind) folded before Flop
Seat 6: Interra (big blind) collected ($26.59)


PokerStars Game #102596996036:  Hold'em No Limit ($3/$6 USD) - 2013/08/11 5:17:06 ET
Table 'Klemola 40-100 bb' 6-max Seat #5 is the button
Seat 1: floriiiiider ($2365.18 in chips) 
Seat 2: Ratatuj ($213.78 in chips) 
Seat 5: dreamtech129 ($656.52 in chips) 
Seat 6: Interra ($494.17 in chips) 
Interra: posts small blind $3
floriiiiider: posts big blind $6
*** HOLE CARDS ***
Ratatuj: folds 
dreamtech129: raises $7.80 to $13.80
vjxbkf joins the table at seat #3 
Interra: folds 
floriiiiider: calls $7.80
*** FLOP *** [Ad 4h 8s]
floriiiiider: checks 
dreamtech129: bets $18
ZarubaNT joins the table at seat #4 
floriiiiider: folds 
Uncalled bet ($18) returned to dreamtech129
dreamtech129 collected $29.22 from pot
dreamtech129: doesn't show hand 
*** SUMMARY ***
Total pot $30.60 | Rake $1.38 
Board [Ad 4h 8s]
Seat 1: floriiiiider (big blind) folded on the Flop
Seat 2: Ratatuj folded before Flop (didn't bet)
Seat 5: dreamtech129 (button) collected ($29.22)
Seat 6: Interra (small blind) folded before Flop


PokerStars Game #102597013949:  Hold'em No Limit ($3/$6 USD) - 2013/08/11 5:17:51 ET
Table 'Klemola 40-100 bb' 6-max Seat #6 is the button
Seat 1: floriiiiider ($2351.38 in chips) 
Seat 2: Ratatuj ($213.78 in chips) 
Seat 5: dreamtech129 ($671.94 in chips) 
Seat 6: Interra ($491.17 in chips) 
floriiiiider: posts small blind $3
Ratatuj: posts big blind $6
vjxbkf: sits out 
ZarubaNT: sits out 
*** HOLE CARDS ***
dreamtech129: raises $7.80 to $13.80
Interra: folds 
floriiiiider: folds 
Ratatuj: raises $23.46 to $37.26
dreamtech129: folds 
Uncalled bet ($23.46) returned to Ratatuj
Ratatuj collected $30.60 from pot
Ratatuj: doesn't show hand 
*** SUMMARY ***
Total pot $30.60 | Rake $0 
Seat 1: floriiiiider (small blind) folded before Flop
Seat 2: Ratatuj (big blind) collected ($30.60)
Seat 5: dreamtech129 folded before Flop
Seat 6: Interra (button) folded before Flop (didn't bet)


PokerStars Game #102597019207:  Hold'em No Limit ($3/$6 USD) - 2013/08/11 5:18:04 ET
Table 'Klemola 40-100 bb' 6-max Seat #1 is the button
Seat 1: floriiiiider ($2348.38 in chips) 
Seat 2: Ratatuj ($230.58 in chips) 
Seat 3: vjxbkf ($600 in chips) 
Seat 5: dreamtech129 ($658.14 in chips) 
Seat 6: Interra ($491.17 in chips) 
Ratatuj: posts small blind $3
vjxbkf: posts big blind $6
ZarubaNT: sits out 
*** HOLE CARDS ***
dreamtech129: folds 
Interra: calls $6
floriiiiider: folds 
Ratatuj: calls $3
vjxbkf: checks 
*** FLOP *** [Qd Jd 7h]
Ratatuj: bets $11.34
vjxbkf: folds 
Interra: calls $11.34
*** TURN *** [Qd Jd 7h] [8c]
Ratatuj: bets $27
Interra: calls $27
*** RIVER *** [Qd Jd 7h 8c] [Kd]
Ratatuj: checks 
Interra: bets $54
Ratatuj: calls $54
*** SHOW DOWN ***
Interra: shows [Jc 7c] (two pair, Jacks and Sevens)
Ratatuj: shows [9h Td] (a straight, Nine to King)
Ratatuj collected $199.88 from pot
*** SUMMARY ***
Total pot $202.68 | Rake $2.80 
Board [Qd Jd 7h 8c Kd]
Seat 1: floriiiiider (button) folded before Flop (didn't bet)
Seat 2: Ratatuj (small blind) showed [9h Td] and won ($199.88) with a straight, Nine to King
Seat 3: vjxbkf (big blind) folded on the Flop
Seat 5: dreamtech129 folded before Flop (didn't bet)
Seat 6: Interra showed [Jc 7c] and lost with two pair, Jacks and Sevens


PokerStars Game #102597054606:  Hold'em No Limit ($3/$6 USD) - 2013/08/11 5:19:33 ET
Table 'Klemola 40-100 bb' 6-max Seat #2 is the button
Seat 1: floriiiiider ($2348.38 in chips) 
Seat 2: Ratatuj ($332.12 in chips) 
Seat 3: vjxbkf ($600 in chips) 
Seat 4: ZarubaNT ($613.78 in chips) 
Seat 5: dreamtech129 ($658.14 in chips) 
Seat 6: Interra ($392.83 in chips) 
vjxbkf: posts small blind $3
ZarubaNT: posts big blind $6
*** HOLE CARDS ***
dreamtech129: folds 
Interra: folds 
floriiiiider: folds 
Ratatuj: raises $6.42 to $12.42
vjxbkf: folds 
ZarubaNT: raises $23.58 to $36
Ratatuj: raises $45 to $81
ZarubaNT: raises $532.78 to $613.78 and is all-in
Ratatuj: calls $251.12 and is all-in
Uncalled bet ($281.66) returned to ZarubaNT
*** FIRST FLOP *** [3c 3h Jh]
*** FIRST TURN *** [3c 3h Jh] [3s]
*** FIRST RIVER *** [3c 3h Jh 3s] [7s]
*** SECOND FLOP *** [6c Td 8d]
*** SECOND TURN *** [6c Td 8d] [9h]
*** SECOND RIVER *** [6c Td 8d 9h] [2h]
*** FIRST SHOW DOWN ***
ZarubaNT: shows [Qc Kc] (three of a kind, Threes)
Ratatuj: shows [Kd As] (three of a kind, Threes - Ace kicker)
Ratatuj collected $332.22 from pot
*** SECOND SHOW DOWN ***
ZarubaNT: shows [Qc Kc] (high card King)
Ratatuj: shows [Kd As] (high card Ace)
Ratatuj collected $332.22 from pot
*** SUMMARY ***
Total pot $667.24 | Rake $2.80 
Hand was run twice
FIRST Board [3c 3h Jh 3s 7s]
SECOND Board [6c Td 8d 9h 2h]
Seat 1: floriiiiider folded before Flop (didn't bet)
Seat 2: Ratatuj (button) showed [Kd As] and won ($332.22) with three of a kind, Threes, and won ($332.22) with high card Ace
Seat 3: vjxbkf (small blind) folded before Flop
Seat 4: ZarubaNT (big blind) showed [Qc Kc] and lost with three of a kind, Threes, and lost with high card King
Seat 5: dreamtech129 folded before Flop (didn't bet)
Seat 6: Interra folded before Flop (didn't bet)


PokerStars Game #102596981155:  Hold'em No Limit ($3/$6 USD) - 2013/08/11 5:16:28 ET
Table 'Klemola 40-100 bb' 6-max Seat #2 is the button
Seat 2: Ratatuj ($240 in chips) 
Seat 5: dreamtech129 ($645.72 in chips) 
Interra will be allowed to play after the button
floriiiiider will be allowed to play after the button
Ratatuj: posts small blind $3
mustanggino: is sitting out 
dreamtech129: posts big blind $6
*** HOLE CARDS ***
Ratatuj: raises $7.80 to $13.80
dreamtech129: raises $16.20 to $30
mustanggino leaves the table
Ratatuj: folds 
Uncalled bet ($16.20) returned to dreamtech129
dreamtech129 collected $27.60 from pot
dreamtech129: doesn't show hand 
*** SUMMARY ***
Total pot $27.60 | Rake $0 
Seat 2: Ratatuj (button) (small blind) folded before Flop
Seat 5: dreamtech129 (big blind) collected ($27.60)


PokerStars Game #102597543990:  Hold'em No Limit ($3/$6 USD) - 2013/08/11 5:40:00 ET
Table 'Klemola 40-100 bb' 6-max Seat #4 is the button
Seat 1: floriiiiider ($2288.78 in chips) 
Seat 2: SlovakPsycho ($840.20 in chips) 
Seat 3: vjxbkf ($1212.87 in chips) 
Seat 4: ZarubaNT ($702.40 in chips) 
Seat 5: dreamtech129 ($625.20 in chips) 
Seat 6: ChowYuenFatt ($600 in chips) 
dreamtech129: posts small blind $3
ChowYuenFatt: posts big blind $6
*** HOLE CARDS ***
floriiiiider: folds 
SlovakPsycho: folds 
vjxbkf: folds 
ZarubaNT: raises $6 to $12
dreamtech129: folds 
ChowYuenFatt: calls $6
*** FLOP *** [Jc 5c 8h]
ChowYuenFatt: checks 
ZarubaNT: bets $18
ChowYuenFatt: raises $31 to $49
ZarubaNT: folds 
Uncalled bet ($31) returned to ChowYuenFatt
ChowYuenFatt collected $60.20 from pot
ChowYuenFatt: doesn't show hand 
*** SUMMARY ***
Total pot $63 | Rake $2.80 
Board [Jc 5c 8h]
Seat 1: floriiiiider folded before Flop (didn't bet)
Seat 2: SlovakPsycho folded before Flop (didn't bet)
Seat 3: vjxbkf folded before Flop (didn't bet)
Seat 4: ZarubaNT (button) folded on the Flop
Seat 5: dreamtech129 (small blind) folded before Flop
Seat 6: ChowYuenFatt (big blind) collected ($60.20)


PokerStars Game #102597563255:  Hold'em No Limit ($3/$6 USD) - 2013/08/11 5:40:48 ET
Table 'Klemola 40-100 bb' 6-max Seat #5 is the button
Seat 1: floriiiiider ($2288.78 in chips) 
Seat 2: SlovakPsycho ($840.20 in chips) 
Seat 3: vjxbkf ($1212.87 in chips) 
Seat 4: ZarubaNT ($672.40 in chips) 
Seat 5: dreamtech129 ($622.20 in chips) 
Seat 6: ChowYuenFatt ($630.20 in chips) 
ChowYuenFatt: posts small blind $3
floriiiiider: posts big blind $6
*** HOLE CARDS ***
SlovakPsycho: folds 
vjxbkf: raises $15 to $21
ZarubaNT: folds 
dreamtech129: folds 
ChowYuenFatt: folds 
floriiiiider: folds 
Uncalled bet ($15) returned to vjxbkf
vjxbkf collected $15 from pot
vjxbkf: doesn't show hand 
*** SUMMARY ***
Total pot $15 | Rake $0 
Seat 1: floriiiiider (big blind) folded before Flop
Seat 2: SlovakPsycho folded before Flop (didn't bet)
Seat 3: vjxbkf collected ($15)
Seat 4: ZarubaNT folded before Flop (didn't bet)
Seat 5: dreamtech129 (button) folded before Flop (didn't bet)
Seat 6: ChowYuenFatt (small blind) folded before Flop


PokerStars Game #102597574709:  Hold'em No Limit ($3/$6 USD) - 2013/08/11 5:41:17 ET
Table 'Klemola 40-100 bb' 6-max Seat #6 is the button
Seat 1: floriiiiider ($2282.78 in chips) 
Seat 2: SlovakPsycho ($840.20 in chips) 
Seat 3: vjxbkf ($1221.87 in chips) 
Seat 4: ZarubaNT ($672.40 in chips) 
Seat 5: dreamtech129 ($622.20 in chips) 
Seat 6: ChowYuenFatt ($627.20 in chips) 
floriiiiider: posts small blind $3
SlovakPsycho: posts big blind $6
*** HOLE CARDS ***
vjxbkf: folds 
ZarubaNT: folds 
dreamtech129: raises $7.80 to $13.80
ChowYuenFatt: folds 
floriiiiider: raises $34.20 to $48
SlovakPsycho: folds 
dreamtech129: folds 
Uncalled bet ($34.20) returned to floriiiiider
floriiiiider collected $33.60 from pot
floriiiiider: doesn't show hand 
*** SUMMARY ***
Total pot $33.60 | Rake $0 
Seat 1: floriiiiider (small blind) collected ($33.60)
Seat 2: SlovakPsycho (big blind) folded before Flop
Seat 3: vjxbkf folded before Flop (didn't bet)
Seat 4: ZarubaNT folded before Flop (didn't bet)
Seat 5: dreamtech129 folded before Flop
Seat 6: ChowYuenFatt (button) folded before Flop (didn't bet)


PokerStars Game #102597593932:  Hold'em No Limit ($3/$6 USD) - 2013/08/11 5:42:04 ET
Table 'Klemola 40-100 bb' 6-max Seat #1 is the button
Seat 1: floriiiiider ($2302.58 in chips) 
Seat 2: SlovakPsycho ($834.20 in chips) 
Seat 3: vjxbkf ($1221.87 in chips) 
Seat 4: ZarubaNT ($672.40 in chips) 
Seat 5: dreamtech129 ($608.40 in chips) 
Seat 6: ChowYuenFatt ($627.20 in chips) 
SlovakPsycho: posts small blind $3
vjxbkf: posts big blind $6
*** HOLE CARDS ***
ZarubaNT: folds 
dreamtech129: folds 
ChowYuenFatt: folds 
floriiiiider: folds 
SlovakPsycho: raises $15 to $21
vjxbkf: calls $15
*** FLOP *** [Qs 8s 4h]
SlovakPsycho: checks 
vjxbkf: bets $24
SlovakPsycho: raises $54 to $78
vjxbkf: folds 
Uncalled bet ($54) returned to SlovakPsycho
SlovakPsycho collected $87.20 from pot
SlovakPsycho: doesn't show hand 
*** SUMMARY ***
Total pot $90 | Rake $2.80 
Board [Qs 8s 4h]
Seat 1: floriiiiider (button) folded before Flop (didn't bet)
Seat 2: SlovakPsycho (small blind) collected ($87.20)
Seat 3: vjxbkf (big blind) folded on the Flop
Seat 4: ZarubaNT folded before Flop (didn't bet)
Seat 5: dreamtech129 folded before Flop (didn't bet)
Seat 6: ChowYuenFatt folded before Flop (didn't bet)


PokerStars Game #102597626303:  Hold'em No Limit ($3/$6 USD) - 2013/08/11 5:43:23 ET
Table 'Klemola 40-100 bb' 6-max Seat #2 is the button
Seat 1: floriiiiider ($2302.58 in chips) 
Seat 2: SlovakPsycho ($876.40 in chips) 
Seat 3: vjxbkf ($1176.87 in chips) 
Seat 4: ZarubaNT ($672.40 in chips) 
Seat 5: dreamtech129 ($608.40 in chips) 
Seat 6: ChowYuenFatt ($627.20 in chips) 
vjxbkf: posts small blind $3
ZarubaNT: posts big blind $6
*** HOLE CARDS ***
dreamtech129: folds 
ChowYuenFatt: folds 
floriiiiider: folds 
SlovakPsycho: raises $6 to $12
vjxbkf: folds 
ZarubaNT: calls $6
*** FLOP *** [6h 8d Jh]
ZarubaNT: checks 
SlovakPsycho: bets $18
ZarubaNT: folds 
Uncalled bet ($18) returned to SlovakPsycho
SlovakPsycho collected $25.78 from pot
SlovakPsycho: doesn't show hand 
*** SUMMARY ***
Total pot $27 | Rake $1.22 
Board [6h 8d Jh]
Seat 1: floriiiiider folded before Flop (didn't bet)
Seat 2: SlovakPsycho (button) collected ($25.78)
Seat 3: vjxbkf (small blind) folded before Flop
Seat 4: ZarubaNT (big blind) folded on the Flop
Seat 5: dreamtech129 folded before Flop (didn't bet)
Seat 6: ChowYuenFatt folded before Flop (didn't bet)


PokerStars Game #102597645651:  Hold'em No Limit ($3/$6 USD) - 2013/08/11 5:44:10 ET
Table 'Klemola 40-100 bb' 6-max Seat #3 is the button
Seat 1: floriiiiider ($2302.58 in chips) 
Seat 2: SlovakPsycho ($890.18 in chips) 
Seat 3: vjxbkf ($1173.87 in chips) 
Seat 4: ZarubaNT ($660.40 in chips) 
Seat 5: dreamtech129 ($608.40 in chips) 
Seat 6: ChowYuenFatt ($627.20 in chips) 
ZarubaNT: posts small blind $3
dreamtech129: posts big blind $6
*** HOLE CARDS ***
ChowYuenFatt: folds 
floriiiiider: folds 
SlovakPsycho: raises $12 to $18
vjxbkf: folds 
ZarubaNT: folds 
dreamtech129: folds 
Uncalled bet ($12) returned to SlovakPsycho
SlovakPsycho collected $15 from pot
SlovakPsycho: doesn't show hand 
*** SUMMARY ***
Total pot $15 | Rake $0 
Seat 1: floriiiiider folded before Flop (didn't bet)
Seat 2: SlovakPsycho collected ($15)
Seat 3: vjxbkf (button) folded before Flop (didn't bet)
Seat 4: ZarubaNT (small blind) folded before Flop
Seat 5: dreamtech129 (big blind) folded before Flop
Seat 6: ChowYuenFatt folded before Flop (didn't bet)


PokerStars Game #102597655974:  Hold'em No Limit ($3/$6 USD) - 2013/08/11 5:44:35 ET
Table 'Klemola 40-100 bb' 6-max Seat #4 is the button
Seat 1: floriiiiider ($2302.58 in chips) 
Seat 2: SlovakPsycho ($899.18 in chips) 
Seat 3: vjxbkf ($1173.87 in chips) 
Seat 4: ZarubaNT ($657.40 in chips) 
Seat 5: dreamtech129 ($602.40 in chips) 
Seat 6: ChowYuenFatt ($627.20 in chips) 
dreamtech129: posts small blind $3
ChowYuenFatt: posts big blind $6
*** HOLE CARDS ***
floriiiiider: folds 
SlovakPsycho: raises $15 to $21
vjxbkf: folds 
ZarubaNT: folds 
dreamtech129: folds 
ChowYuenFatt: folds 
Uncalled bet ($15) returned to SlovakPsycho
SlovakPsycho collected $15 from pot
SlovakPsycho: doesn't show hand 
*** SUMMARY ***
Total pot $15 | Rake $0 
Seat 1: floriiiiider folded before Flop (didn't bet)
Seat 2: SlovakPsycho collected ($15)
Seat 3: vjxbkf folded before Flop (didn't bet)
Seat 4: ZarubaNT (button) folded before Flop (didn't bet)
Seat 5: dreamtech129 (small blind) folded before Flop
Seat 6: ChowYuenFatt (big blind) folded before Flop


PokerStars Game #102597665404:  Hold'em No Limit ($3/$6 USD) - 2013/08/11 5:44:58 ET
Table 'Klemola 40-100 bb' 6-max Seat #5 is the button
Seat 2: SlovakPsycho ($908.18 in chips) 
Seat 3: vjxbkf ($1173.87 in chips) 
Seat 4: ZarubaNT ($657.40 in chips) 
Seat 5: dreamtech129 ($600 in chips) 
Seat 6: ChowYuenFatt ($621.20 in chips) 
ChowYuenFatt: posts small blind $3
floriiiiider: is sitting out 
SlovakPsycho: posts big blind $6
*** HOLE CARDS ***
floriiiiider leaves the table
vjxbkf: raises $15 to $21
ZarubaNT: folds 
dreamtech129: folds 
ChowYuenFatt: folds 
SlovakPsycho: folds 
Uncalled bet ($15) returned to vjxbkf
vjxbkf collected $15 from pot
vjxbkf: doesn't show hand 
*** SUMMARY ***
Total pot $15 | Rake $0 
Seat 2: SlovakPsycho (big blind) folded before Flop
Seat 3: vjxbkf collected ($15)
Seat 4: ZarubaNT folded before Flop (didn't bet)
Seat 5: dreamtech129 (button) folded before Flop (didn't bet)
Seat 6: ChowYuenFatt (small blind) folded before Flop


PokerStars Game #102597430065:  Hold'em No Limit ($3/$6 USD) - 2013/08/11 5:35:14 ET
Table 'Klemola 40-100 bb' 6-max Seat #5 is the button
Seat 1: floriiiiider ($2297.78 in chips) 
Seat 2: SlovakPsycho ($600 in chips) 
Seat 3: vjxbkf ($1269.87 in chips) 
Seat 4: ZarubaNT ($648.20 in chips) 
Seat 5: dreamtech129 ($613.20 in chips) 
Seat 6: ChowYuenFatt ($571.20 in chips) 
ChowYuenFatt: posts small blind $3
floriiiiider: posts big blind $6
*** HOLE CARDS ***
SlovakPsycho: folds 
vjxbkf has timed out
vjxbkf: folds 
ZarubaNT: folds 
dreamtech129: raises $7.80 to $13.80
ChowYuenFatt: folds 
floriiiiider: folds 
Uncalled bet ($7.80) returned to dreamtech129
dreamtech129 collected $15 from pot
dreamtech129: doesn't show hand 
*** SUMMARY ***
Total pot $15 | Rake $0 
Seat 1: floriiiiider (big blind) folded before Flop
Seat 2: SlovakPsycho folded before Flop (didn't bet)
Seat 3: vjxbkf folded before Flop (didn't bet)
Seat 4: ZarubaNT folded before Flop (didn't bet)
Seat 5: dreamtech129 (button) collected ($15)
Seat 6: ChowYuenFatt (small blind) folded before Flop


PokerStars Game #102597444074:  Hold'em No Limit ($3/$6 USD) - 2013/08/11 5:35:49 ET
Table 'Klemola 40-100 bb' 6-max Seat #6 is the button
Seat 1: floriiiiider ($2291.78 in chips) 
Seat 2: SlovakPsycho ($600 in chips) 
Seat 3: vjxbkf ($1269.87 in chips) 
Seat 4: ZarubaNT ($648.20 in chips) 
Seat 5: dreamtech129 ($622.20 in chips) 
Seat 6: ChowYuenFatt ($568.20 in chips) 
floriiiiider: posts small blind $3
SlovakPsycho: posts big blind $6
*** HOLE CARDS ***
vjxbkf: folds 
ZarubaNT: folds 
dreamtech129: folds 
ChowYuenFatt: raises $9 to $15
floriiiiider: folds 
SlovakPsycho: raises $39 to $54
ChowYuenFatt: calls $39
*** FLOP *** [Jh Kd 7s]
SlovakPsycho: bets $57
ChowYuenFatt: calls $57
*** TURN *** [Jh Kd 7s] [6d]
SlovakPsycho: bets $132
ChowYuenFatt: calls $132
*** RIVER *** [Jh Kd 7s 6d] [2h]
SlovakPsycho: bets $357 and is all-in
ChowYuenFatt: folds 
Uncalled bet ($357) returned to SlovakPsycho
SlovakPsycho collected $486.20 from pot
SlovakPsycho: doesn't show hand 
*** SUMMARY ***
Total pot $489 | Rake $2.80 
Board [Jh Kd 7s 6d 2h]
Seat 1: floriiiiider (small blind) folded before Flop
Seat 2: SlovakPsycho (big blind) collected ($486.20)
Seat 3: vjxbkf folded before Flop (didn't bet)
Seat 4: ZarubaNT folded before Flop (didn't bet)
Seat 5: dreamtech129 folded before Flop (didn't bet)
Seat 6: ChowYuenFatt (button) folded on the River


PokerStars Game #102597490297:  Hold'em No Limit ($3/$6 USD) - 2013/08/11 5:37:45 ET
Table 'Klemola 40-100 bb' 6-max Seat #1 is the button
Seat 1: floriiiiider ($2288.78 in chips) 
Seat 2: SlovakPsycho ($843.20 in chips) 
Seat 3: vjxbkf ($1269.87 in chips) 
Seat 4: ZarubaNT ($648.20 in chips) 
Seat 5: dreamtech129 ($622.20 in chips) 
Seat 6: ChowYuenFatt ($600 in chips) 
SlovakPsycho: posts small blind $3
vjxbkf: posts big blind $6
*** HOLE CARDS ***
ZarubaNT: folds 
dreamtech129: raises $7.80 to $13.80
ChowYuenFatt: folds 
floriiiiider: folds 
SlovakPsycho: folds 
vjxbkf: folds 
Uncalled bet ($7.80) returned to dreamtech129
dreamtech129 collected $15 from pot
dreamtech129: doesn't show hand 
*** SUMMARY ***
Total pot $15 | Rake $0 
Seat 1: floriiiiider (button) folded before Flop (didn't bet)
Seat 2: SlovakPsycho (small blind) folded before Flop
Seat 3: vjxbkf (big blind) folded before Flop
Seat 4: ZarubaNT folded before Flop (didn't bet)
Seat 5: dreamtech129 collected ($15)
Seat 6: ChowYuenFatt folded before Flop (didn't bet)


PokerStars Game #102597504083:  Hold'em No Limit ($3/$6 USD) - 2013/08/11 5:38:19 ET
Table 'Klemola 40-100 bb' 6-max Seat #2 is the button
Seat 1: floriiiiider ($2288.78 in chips) 
Seat 2: SlovakPsycho ($840.20 in chips) 
Seat 3: vjxbkf ($1263.87 in chips) 
Seat 4: ZarubaNT ($648.20 in chips) 
Seat 5: dreamtech129 ($631.20 in chips) 
Seat 6: ChowYuenFatt ($600 in chips) 
vjxbkf: posts small blind $3
ZarubaNT: posts big blind $6
*** HOLE CARDS ***
dreamtech129: folds 
ChowYuenFatt: folds 
floriiiiider: folds 
SlovakPsycho: folds 
vjxbkf: raises $18 to $24
ZarubaNT: calls $18
*** FLOP *** [9h 8c 3s]
vjxbkf: bets $36
ZarubaNT: calls $36
*** TURN *** [9h 8c 3s] [Qh]
vjxbkf: checks 
ZarubaNT: bets $87
vjxbkf: folds 
Uncalled bet ($87) returned to ZarubaNT
ZarubaNT collected $117.20 from pot
ZarubaNT: doesn't show hand 
*** SUMMARY ***
Total pot $120 | Rake $2.80 
Board [9h 8c 3s Qh]
Seat 1: floriiiiider folded before Flop (didn't bet)
Seat 2: SlovakPsycho (button) folded before Flop (didn't bet)
Seat 3: vjxbkf (small blind) folded on the Turn
Seat 4: ZarubaNT (big blind) collected ($117.20)
Seat 5: dreamtech129 folded before Flop (didn't bet)
Seat 6: ChowYuenFatt folded before Flop (didn't bet)


PokerStars Game #102597534261:  Hold'em No Limit ($3/$6 USD) - 2013/08/11 5:39:36 ET
Table 'Klemola 40-100 bb' 6-max Seat #3 is the button
Seat 1: floriiiiider ($2288.78 in chips) 
Seat 2: SlovakPsycho ($840.20 in chips) 
Seat 3: vjxbkf ($1203.87 in chips) 
Seat 4: ZarubaNT ($705.40 in chips) 
Seat 5: dreamtech129 ($631.20 in chips) 
Seat 6: ChowYuenFatt ($600 in chips) 
ZarubaNT: posts small blind $3
dreamtech129: posts big blind $6
*** HOLE CARDS ***
ChowYuenFatt: folds 
floriiiiider: folds 
SlovakPsycho: folds 
vjxbkf: raises $6 to $12
ZarubaNT: folds 
dreamtech129: folds 
Uncalled bet ($6) returned to vjxbkf
vjxbkf collected $15 from pot
vjxbkf: doesn't show hand 
*** SUMMARY ***
Total pot $15 | Rake $0 
Seat 1: floriiiiider folded before Flop (didn't bet)
Seat 2: SlovakPsycho folded before Flop (didn't bet)
Seat 3: vjxbkf (button) collected ($15)
Seat 4: ZarubaNT (small blind) folded before Flop
Seat 5: dreamtech129 (big blind) folded before Flop
Seat 6: ChowYuenFatt folded before Flop (didn't bet)


PokerStars Game #102597305849:  Hold'em No Limit ($3/$6 USD) - 2013/08/11 5:30:01 ET
Table 'Klemola 40-100 bb' 6-max Seat #3 is the button
Seat 1: floriiiiider ($2273.58 in chips) 
Seat 2: SlovakPsycho ($600 in chips) 
Seat 3: vjxbkf ($1326.87 in chips) 
Seat 4: ZarubaNT ($603 in chips) 
Seat 5: dreamtech129 ($600 in chips) 
ZarubaNT: posts small blind $3
dreamtech129: posts big blind $6
ChowYuenFatt: sits out 
*** HOLE CARDS ***
floriiiiider: folds 
SlovakPsycho: folds 
vjxbkf: folds 
ZarubaNT: folds 
Uncalled bet ($3) returned to dreamtech129
dreamtech129 collected $6 from pot
dreamtech129: doesn't show hand 
*** SUMMARY ***
Total pot $6 | Rake $0 
Seat 1: floriiiiider folded before Flop (didn't bet)
Seat 2: SlovakPsycho folded before Flop (didn't bet)
Seat 3: vjxbkf (button) folded before Flop (didn't bet)
Seat 4: ZarubaNT (small blind) folded before Flop
Seat 5: dreamtech129 (big blind) collected ($6)


PokerStars Game #102597312043:  Hold'em No Limit ($3/$6 USD) - 2013/08/11 5:30:17 ET
Table 'Klemola 40-100 bb' 6-max Seat #4 is the button
Seat 1: floriiiiider ($2273.58 in chips) 
Seat 2: SlovakPsycho ($600 in chips) 
Seat 3: vjxbkf ($1326.87 in chips) 
Seat 4: ZarubaNT ($600 in chips) 
Seat 5: dreamtech129 ($603 in chips) 
Seat 6: ChowYuenFatt ($600 in chips) 
dreamtech129: posts small blind $3
ChowYuenFatt: posts big blind $6
*** HOLE CARDS ***
floriiiiider: folds 
SlovakPsycho: folds 
vjxbkf: raises $12 to $18
ZarubaNT: folds 
dreamtech129: raises $42 to $60
ChowYuenFatt: folds 
vjxbkf: folds 
Uncalled bet ($42) returned to dreamtech129
dreamtech129 collected $42 from pot
dreamtech129: doesn't show hand 
*** SUMMARY ***
Total pot $42 | Rake $0 
Seat 1: floriiiiider folded before Flop (didn't bet)
Seat 2: SlovakPsycho folded before Flop (didn't bet)
Seat 3: vjxbkf folded before Flop
Seat 4: ZarubaNT (button) folded before Flop (didn't bet)
Seat 5: dreamtech129 (small blind) collected ($42)
Seat 6: ChowYuenFatt (big blind) folded before Flop


PokerStars Game #102597322474:  Hold'em No Limit ($3/$6 USD) - 2013/08/11 5:30:43 ET
Table 'Klemola 40-100 bb' 6-max Seat #5 is the button
Seat 1: floriiiiider ($2273.58 in chips) 
Seat 2: SlovakPsycho ($600 in chips) 
Seat 3: vjxbkf ($1308.87 in chips) 
Seat 4: ZarubaNT ($600 in chips) 
Seat 5: dreamtech129 ($627 in chips) 
Seat 6: ChowYuenFatt ($594 in chips) 
ChowYuenFatt: posts small blind $3
floriiiiider: posts big blind $6
*** HOLE CARDS ***
SlovakPsycho: folds 
vjxbkf: folds 
ZarubaNT: folds 
dreamtech129: raises $7.80 to $13.80
ChowYuenFatt: folds 
floriiiiider: folds 
Uncalled bet ($7.80) returned to dreamtech129
dreamtech129 collected $15 from pot
dreamtech129: doesn't show hand 
*** SUMMARY ***
Total pot $15 | Rake $0 
Seat 1: floriiiiider (big blind) folded before Flop
Seat 2: SlovakPsycho folded before Flop (didn't bet)
Seat 3: vjxbkf folded before Flop (didn't bet)
Seat 4: ZarubaNT folded before Flop (didn't bet)
Seat 5: dreamtech129 (button) collected ($15)
Seat 6: ChowYuenFatt (small blind) folded before Flop


PokerStars Game #102597334361:  Hold'em No Limit ($3/$6 USD) - 2013/08/11 5:31:13 ET
Table 'Klemola 40-100 bb' 6-max Seat #6 is the button
Seat 1: floriiiiider ($2267.58 in chips) 
Seat 2: SlovakPsycho ($600 in chips) 
Seat 3: vjxbkf ($1308.87 in chips) 
Seat 4: ZarubaNT ($600 in chips) 
Seat 5: dreamtech129 ($636 in chips) 
Seat 6: ChowYuenFatt ($591 in chips) 
floriiiiider: posts small blind $3
SlovakPsycho: posts big blind $6
*** HOLE CARDS ***
vjxbkf: folds 
ZarubaNT: folds 
dreamtech129: raises $7.80 to $13.80
ChowYuenFatt: calls $13.80
floriiiiider: folds 
SlovakPsycho: raises $46.20 to $60
dreamtech129: folds 
ChowYuenFatt: folds 
Uncalled bet ($46.20) returned to SlovakPsycho
SlovakPsycho collected $44.40 from pot
SlovakPsycho: doesn't show hand 
*** SUMMARY ***
Total pot $44.40 | Rake $0 
Seat 1: floriiiiider (small blind) folded before Flop
Seat 2: SlovakPsycho (big blind) collected ($44.40)
Seat 3: vjxbkf folded before Flop (didn't bet)
Seat 4: ZarubaNT folded before Flop (didn't bet)
Seat 5: dreamtech129 folded before Flop
Seat 6: ChowYuenFatt (button) folded before Flop


PokerStars Game #102597348419:  Hold'em No Limit ($3/$6 USD) - 2013/08/11 5:31:49 ET
Table 'Klemola 40-100 bb' 6-max Seat #1 is the button
Seat 1: floriiiiider ($2264.58 in chips) 
Seat 2: SlovakPsycho ($630.60 in chips) 
Seat 3: vjxbkf ($1308.87 in chips) 
Seat 4: ZarubaNT ($600 in chips) 
Seat 5: dreamtech129 ($622.20 in chips) 
Seat 6: ChowYuenFatt ($577.20 in chips) 
SlovakPsycho: posts small blind $3
vjxbkf: posts big blind $6
*** HOLE CARDS ***
ZarubaNT: folds 
dreamtech129: folds 
ChowYuenFatt: folds 
floriiiiider: raises $6 to $12
SlovakPsycho: folds 
vjxbkf: calls $6
*** FLOP *** [Td 8s 5d]
vjxbkf: bets $21
floriiiiider: calls $21
*** TURN *** [Td 8s 5d] [3d]
vjxbkf: checks 
floriiiiider: checks 
*** RIVER *** [Td 8s 5d 3d] [4s]
vjxbkf: checks 
floriiiiider: checks 
*** SHOW DOWN ***
vjxbkf: shows [6s 9s] (high card Ten)
floriiiiider: shows [Kd 8c] (a pair of Eights)
floriiiiider collected $66.20 from pot
*** SUMMARY ***
Total pot $69 | Rake $2.80 
Board [Td 8s 5d 3d 4s]
Seat 1: floriiiiider (button) showed [Kd 8c] and won ($66.20) with a pair of Eights
Seat 2: SlovakPsycho (small blind) folded before Flop
Seat 3: vjxbkf (big blind) showed [6s 9s] and lost with high card Ten
Seat 4: ZarubaNT folded before Flop (didn't bet)
Seat 5: dreamtech129 folded before Flop (didn't bet)
Seat 6: ChowYuenFatt folded before Flop (didn't bet)


PokerStars Game #102597386492:  Hold'em No Limit ($3/$6 USD) - 2013/08/11 5:33:26 ET
Table 'Klemola 40-100 bb' 6-max Seat #2 is the button
Seat 1: floriiiiider ($2297.78 in chips) 
Seat 2: SlovakPsycho ($627.60 in chips) 
Seat 3: vjxbkf ($1275.87 in chips) 
Seat 4: ZarubaNT ($600 in chips) 
Seat 5: dreamtech129 ($622.20 in chips) 
Seat 6: ChowYuenFatt ($577.20 in chips) 
vjxbkf: posts small blind $3
ZarubaNT: posts big blind $6
*** HOLE CARDS ***
dreamtech129: folds 
ChowYuenFatt: folds 
floriiiiider: folds 
SlovakPsycho: raises $6 to $12
vjxbkf: folds 
ZarubaNT: calls $6
*** FLOP *** [3d 2c 7d]
ZarubaNT: checks 
SlovakPsycho: checks 
*** TURN *** [3d 2c 7d] [4c]
ZarubaNT: bets $18
SlovakPsycho: calls $18
*** RIVER *** [3d 2c 7d 4c] [Ts]
ZarubaNT: bets $51
SlovakPsycho: folds 
Uncalled bet ($51) returned to ZarubaNT
ZarubaNT collected $60.20 from pot
ZarubaNT: doesn't show hand 
*** SUMMARY ***
Total pot $63 | Rake $2.80 
Board [3d 2c 7d 4c Ts]
Seat 1: floriiiiider folded before Flop (didn't bet)
Seat 2: SlovakPsycho (button) folded on the River
Seat 3: vjxbkf (small blind) folded before Flop
Seat 4: ZarubaNT (big blind) collected ($60.20)
Seat 5: dreamtech129 folded before Flop (didn't bet)
Seat 6: ChowYuenFatt folded before Flop (didn't bet)


PokerStars Game #102597407821:  Hold'em No Limit ($3/$6 USD) - 2013/08/11 5:34:19 ET
Table 'Klemola 40-100 bb' 6-max Seat #3 is the button
Seat 1: floriiiiider ($2297.78 in chips) 
Seat 2: SlovakPsycho ($600 in chips) 
Seat 3: vjxbkf ($1272.87 in chips) 
Seat 4: ZarubaNT ($630.20 in chips) 
Seat 5: dreamtech129 ($622.20 in chips) 
Seat 6: ChowYuenFatt ($577.20 in chips) 
ZarubaNT: posts small blind $3
dreamtech129: posts big blind $6
*** HOLE CARDS ***
ChowYuenFatt: folds 
floriiiiider: folds 
SlovakPsycho: folds 
vjxbkf: raises $6 to $12
ZarubaNT: raises $33 to $45
dreamtech129: folds 
vjxbkf: folds 
Uncalled bet ($33) returned to ZarubaNT
ZarubaNT collected $30 from pot
ZarubaNT: doesn't show hand 
*** SUMMARY ***
Total pot $30 | Rake $0 
Seat 1: floriiiiider folded before Flop (didn't bet)
Seat 2: SlovakPsycho folded before Flop (didn't bet)
Seat 3: vjxbkf (button) folded before Flop
Seat 4: ZarubaNT (small blind) collected ($30)
Seat 5: dreamtech129 (big blind) folded before Flop
Seat 6: ChowYuenFatt folded before Flop (didn't bet)


PokerStars Game #102597421082:  Hold'em No Limit ($3/$6 USD) - 2013/08/11 5:34:53 ET
Table 'Klemola 40-100 bb' 6-max Seat #4 is the button
Seat 1: floriiiiider ($2297.78 in chips) 
Seat 2: SlovakPsycho ($600 in chips) 
Seat 3: vjxbkf ($1260.87 in chips) 
Seat 4: ZarubaNT ($648.20 in chips) 
Seat 5: dreamtech129 ($616.20 in chips) 
Seat 6: ChowYuenFatt ($577.20 in chips) 
dreamtech129: posts small blind $3
ChowYuenFatt: posts big blind $6
*** HOLE CARDS ***
floriiiiider: folds 
SlovakPsycho: folds 
vjxbkf: raises $12 to $18
ZarubaNT: folds 
dreamtech129: folds 
ChowYuenFatt: folds 
Uncalled bet ($12) returned to vjxbkf
vjxbkf collected $15 from pot
vjxbkf: doesn't show hand 
*** SUMMARY ***
Total pot $15 | Rake $0 
Seat 1: floriiiiider folded before Flop (didn't bet)
Seat 2: SlovakPsycho folded before Flop (didn't bet)
Seat 3: vjxbkf collected ($15)
Seat 4: ZarubaNT (button) folded before Flop (didn't bet)
Seat 5: dreamtech129 (small blind) folded before Flop
Seat 6: ChowYuenFatt (big blind) folded before Flop


PokerStars Game #102597798809:  Hold'em No Limit ($3/$6 USD) - 2013/08/11 5:50:26 ET
Table 'Klemola 40-100 bb' 6-max Seat #1 is the button
Seat 1: DuckinF0nk ($600 in chips) 
Seat 2: SlovakPsycho ($863.18 in chips) 
Seat 3: vjxbkf ($1181.11 in chips) 
Seat 4: ZarubaNT ($707.35 in chips) 
Seat 5: dreamtech129 ($600 in chips) 
Seat 6: ChowYuenFatt ($642.48 in chips) 
SlovakPsycho: posts small blind $3
vjxbkf: posts big blind $6
*** HOLE CARDS ***
ZarubaNT: folds 
dreamtech129: folds 
ChowYuenFatt: folds 
DuckinF0nk: raises $6 to $12
SlovakPsycho: raises $39 to $51
vjxbkf: folds 
DuckinF0nk: folds 
Uncalled bet ($39) returned to SlovakPsycho
SlovakPsycho collected $30 from pot
SlovakPsycho: doesn't show hand 
*** SUMMARY ***
Total pot $30 | Rake $0 
Seat 1: DuckinF0nk (button) folded before Flop
Seat 2: SlovakPsycho (small blind) collected ($30)
Seat 3: vjxbkf (big blind) folded before Flop
Seat 4: ZarubaNT folded before Flop (didn't bet)
Seat 5: dreamtech129 folded before Flop (didn't bet)
Seat 6: ChowYuenFatt folded before Flop (didn't bet)


PokerStars Game #102597813783:  Hold'em No Limit ($3/$6 USD) - 2013/08/11 5:51:04 ET
Table 'Klemola 40-100 bb' 6-max Seat #2 is the button
Seat 1: DuckinF0nk ($600 in chips) 
Seat 2: SlovakPsycho ($881.18 in chips) 
Seat 3: vjxbkf ($1175.11 in chips) 
Seat 5: dreamtech129 ($600 in chips) 
Seat 6: ChowYuenFatt ($642.48 in chips) 
vjxbkf: posts small blind $3
ZarubaNT: is sitting out 
dreamtech129: posts big blind $6
*** HOLE CARDS ***
ZarubaNT leaves the table
GERAKLmeat joins the table at seat #4 
ChowYuenFatt: raises $11 to $17
DuckinF0nk: folds 
SlovakPsycho: folds 
vjxbkf: folds 
dreamtech129: folds 
Uncalled bet ($11) returned to ChowYuenFatt
ChowYuenFatt collected $15 from pot
ChowYuenFatt: doesn't show hand 
*** SUMMARY ***
Total pot $15 | Rake $0 
Seat 1: DuckinF0nk folded before Flop (didn't bet)
Seat 2: SlovakPsycho (button) folded before Flop (didn't bet)
Seat 3: vjxbkf (small blind) folded before Flop
Seat 5: dreamtech129 (big blind) folded before Flop
Seat 6: ChowYuenFatt collected ($15)


PokerStars Game #102597821592:  Hold'em No Limit ($3/$6 USD) - 2013/08/11 5:51:23 ET
Table 'Klemola 40-100 bb' 6-max Seat #3 is the button
Seat 1: DuckinF0nk ($600 in chips) 
Seat 2: SlovakPsycho ($881.18 in chips) 
Seat 3: vjxbkf ($1172.11 in chips) 
Seat 5: dreamtech129 ($600 in chips) 
Seat 6: ChowYuenFatt ($651.48 in chips) 
GERAKLmeat will be allowed to play after the button
dreamtech129: posts small blind $3
ChowYuenFatt: posts big blind $6
*** HOLE CARDS ***
DuckinF0nk: folds 
SlovakPsycho: folds 
vjxbkf: raises $6 to $12
dreamtech129: folds 
ChowYuenFatt: folds 
Uncalled bet ($6) returned to vjxbkf
vjxbkf collected $15 from pot
vjxbkf: doesn't show hand 
*** SUMMARY ***
Total pot $15 | Rake $0 
Seat 1: DuckinF0nk folded before Flop (didn't bet)
Seat 2: SlovakPsycho folded before Flop (didn't bet)
Seat 3: vjxbkf (button) collected ($15)
Seat 5: dreamtech129 (small blind) folded before Flop
Seat 6: ChowYuenFatt (big blind) folded before Flop


PokerStars Game #102597831317:  Hold'em No Limit ($3/$6 USD) - 2013/08/11 5:51:48 ET
Table 'Klemola 40-100 bb' 6-max Seat #5 is the button
Seat 1: DuckinF0nk ($600 in chips) 
Seat 2: SlovakPsycho ($881.18 in chips) 
Seat 3: vjxbkf ($1181.11 in chips) 
Seat 5: dreamtech129 ($600 in chips) 
Seat 6: ChowYuenFatt ($645.48 in chips) 
ChowYuenFatt: posts small blind $3
DuckinF0nk: posts big blind $6
GERAKLmeat: sits out 
*** HOLE CARDS ***
SlovakPsycho: folds 
vjxbkf: folds 
dreamtech129: folds 
ChowYuenFatt: raises $12 to $18
DuckinF0nk: folds 
Uncalled bet ($12) returned to ChowYuenFatt
ChowYuenFatt collected $12 from pot
ChowYuenFatt: doesn't show hand 
*** SUMMARY ***
Total pot $12 | Rake $0 
Seat 1: DuckinF0nk (big blind) folded before Flop
Seat 2: SlovakPsycho folded before Flop (didn't bet)
Seat 3: vjxbkf folded before Flop (didn't bet)
Seat 5: dreamtech129 (button) folded before Flop (didn't bet)
Seat 6: ChowYuenFatt (small blind) collected ($12)


PokerStars Game #102597842539:  Hold'em No Limit ($3/$6 USD) - 2013/08/11 5:52:16 ET
Table 'Klemola 40-100 bb' 6-max Seat #6 is the button
Seat 1: DuckinF0nk ($600 in chips) 
Seat 2: SlovakPsycho ($881.18 in chips) 
Seat 3: vjxbkf ($1181.11 in chips) 
Seat 5: dreamtech129 ($600 in chips) 
Seat 6: ChowYuenFatt ($651.48 in chips) 
DuckinF0nk: posts small blind $3
SlovakPsycho: posts big blind $6
GERAKLmeat: sits out 
*** HOLE CARDS ***
vjxbkf: folds 
dreamtech129: raises $7.80 to $13.80
ChowYuenFatt: calls $13.80
DuckinF0nk: folds 
SlovakPsycho: folds 
*** FLOP *** [Js 3s 4c]
dreamtech129: bets $21
ChowYuenFatt: folds 
Uncalled bet ($21) returned to dreamtech129
dreamtech129 collected $34.95 from pot
dreamtech129: doesn't show hand 
*** SUMMARY ***
Total pot $36.60 | Rake $1.65 
Board [Js 3s 4c]
Seat 1: DuckinF0nk (small blind) folded before Flop
Seat 2: SlovakPsycho (big blind) folded before Flop
Seat 3: vjxbkf folded before Flop (didn't bet)
Seat 5: dreamtech129 collected ($34.95)
Seat 6: ChowYuenFatt (button) folded on the Flop


PokerStars Game #102597853250:  Hold'em No Limit ($3/$6 USD) - 2013/08/11 5:52:42 ET
Table 'Klemola 40-100 bb' 6-max Seat #1 is the button
Seat 1: DuckinF0nk ($600 in chips) 
Seat 2: SlovakPsycho ($875.18 in chips) 
Seat 3: vjxbkf ($1181.11 in chips) 
Seat 5: dreamtech129 ($621.15 in chips) 
Seat 6: ChowYuenFatt ($637.68 in chips) 
SlovakPsycho: posts small blind $3
vjxbkf: posts big blind $6
GERAKLmeat: sits out 
*** HOLE CARDS ***
dreamtech129: folds 
ChowYuenFatt: folds 
DuckinF0nk: raises $6 to $12
SlovakPsycho: calls $9
vjxbkf: folds 
*** FLOP *** [9h 2c Ts]
SlovakPsycho: checks 
DuckinF0nk: checks 
*** TURN *** [9h 2c Ts] [Tc]
SlovakPsycho: bets $21
DuckinF0nk: folds 
Uncalled bet ($21) returned to SlovakPsycho
SlovakPsycho collected $28.65 from pot
SlovakPsycho: doesn't show hand 
*** SUMMARY ***
Total pot $30 | Rake $1.35 
Board [9h 2c Ts Tc]
Seat 1: DuckinF0nk (button) folded on the Turn
Seat 2: SlovakPsycho (small blind) collected ($28.65)
Seat 3: vjxbkf (big blind) folded before Flop
Seat 5: dreamtech129 folded before Flop (didn't bet)
Seat 6: ChowYuenFatt folded before Flop (didn't bet)


PokerStars Game #102597877456:  Hold'em No Limit ($3/$6 USD) - 2013/08/11 5:53:42 ET
Table 'Klemola 40-100 bb' 6-max Seat #2 is the button
Seat 1: DuckinF0nk ($600 in chips) 
Seat 2: SlovakPsycho ($891.83 in chips) 
Seat 3: vjxbkf ($1175.11 in chips) 
Seat 4: GERAKLmeat ($240 in chips) 
Seat 5: dreamtech129 ($621.15 in chips) 
Seat 6: ChowYuenFatt ($637.68 in chips) 
vjxbkf: posts small blind $3
GERAKLmeat: posts big blind $6
*** HOLE CARDS ***
dreamtech129: folds 
ChowYuenFatt: folds 
DuckinF0nk: folds 
SlovakPsycho: folds 
vjxbkf: raises $12 to $18
GERAKLmeat: folds 
Uncalled bet ($12) returned to vjxbkf
vjxbkf collected $12 from pot
vjxbkf: doesn't show hand 
*** SUMMARY ***
Total pot $12 | Rake $0 
Seat 1: DuckinF0nk folded before Flop (didn't bet)
Seat 2: SlovakPsycho (button) folded before Flop (didn't bet)
Seat 3: vjxbkf (small blind) collected ($12)
Seat 4: GERAKLmeat (big blind) folded before Flop
Seat 5: dreamtech129 folded before Flop (didn't bet)
Seat 6: ChowYuenFatt folded before Flop (didn't bet)


PokerStars Game #102597888085:  Hold'em No Limit ($3/$6 USD) - 2013/08/11 5:54:09 ET
Table 'Klemola 40-100 bb' 6-max Seat #3 is the button
Seat 1: DuckinF0nk ($600 in chips) 
Seat 2: SlovakPsycho ($891.83 in chips) 
Seat 3: vjxbkf ($1181.11 in chips) 
Seat 4: GERAKLmeat ($240 in chips) 
Seat 5: dreamtech129 ($621.15 in chips) 
Seat 6: ChowYuenFatt ($637.68 in chips) 
GERAKLmeat: posts small blind $3
dreamtech129: posts big blind $6
*** HOLE CARDS ***
ChowYuenFatt: folds 
DuckinF0nk: folds 
SlovakPsycho: folds 
vjxbkf: folds 
GERAKLmeat: raises $6 to $12
dreamtech129: folds 
Uncalled bet ($6) returned to GERAKLmeat
GERAKLmeat collected $12 from pot
GERAKLmeat: doesn't show hand 
*** SUMMARY ***
Total pot $12 | Rake $0 
Seat 1: DuckinF0nk folded before Flop (didn't bet)
Seat 2: SlovakPsycho folded before Flop (didn't bet)
Seat 3: vjxbkf (button) folded before Flop (didn't bet)
Seat 4: GERAKLmeat (small blind) collected ($12)
Seat 5: dreamtech129 (big blind) folded before Flop
Seat 6: ChowYuenFatt folded before Flop (didn't bet)


PokerStars Game #102597895197:  Hold'em No Limit ($3/$6 USD) - 2013/08/11 5:54:26 ET
Table 'Klemola 40-100 bb' 6-max Seat #4 is the button
Seat 1: DuckinF0nk ($600 in chips) 
Seat 2: SlovakPsycho ($891.83 in chips) 
Seat 3: vjxbkf ($1181.11 in chips) 
Seat 4: GERAKLmeat ($246 in chips) 
Seat 5: dreamtech129 ($615.15 in chips) 
Seat 6: ChowYuenFatt ($637.68 in chips) 
dreamtech129: posts small blind $3
ChowYuenFatt: posts big blind $6
*** HOLE CARDS ***
DuckinF0nk: folds 
SlovakPsycho: folds 
vjxbkf: folds 
GERAKLmeat: raises $6 to $12
dreamtech129: raises $18 to $30
ChowYuenFatt: folds 
GERAKLmeat: calls $18
*** FLOP *** [3c 2d 9h]
dreamtech129: bets $33
GERAKLmeat: calls $33
*** TURN *** [3c 2d 9h] [Qd]
dreamtech129: checks 
GERAKLmeat: bets $60
dreamtech129: folds 
Uncalled bet ($60) returned to GERAKLmeat
GERAKLmeat collected $129.20 from pot
GERAKLmeat: doesn't show hand 
*** SUMMARY ***
Total pot $132 | Rake $2.80 
Board [3c 2d 9h Qd]
Seat 1: DuckinF0nk folded before Flop (didn't bet)
Seat 2: SlovakPsycho folded before Flop (didn't bet)
Seat 3: vjxbkf folded before Flop (didn't bet)
Seat 4: GERAKLmeat (button) collected ($129.20)
Seat 5: dreamtech129 (small blind) folded on the Turn
Seat 6: ChowYuenFatt (big blind) folded before Flop


PokerStars Game #102597679814:  Hold'em No Limit ($3/$6 USD) - 2013/08/11 5:45:33 ET
Table 'Klemola 40-100 bb' 6-max Seat #6 is the button
Seat 2: SlovakPsycho ($902.18 in chips) 
Seat 3: vjxbkf ($1182.87 in chips) 
Seat 4: ZarubaNT ($657.40 in chips) 
Seat 5: dreamtech129 ($600 in chips) 
Seat 6: ChowYuenFatt ($618.20 in chips) 
SlovakPsycho: posts small blind $3
vjxbkf: posts big blind $6
*** HOLE CARDS ***
ZarubaNT: raises $12 to $18
dreamtech129: folds 
ChowYuenFatt: raises $28 to $46
DuckinF0nk joins the table at seat #1 
SlovakPsycho: folds 
vjxbkf: folds 
ZarubaNT: calls $28
*** FLOP *** [Th 8c 7h]
ZarubaNT: checks 
ChowYuenFatt: checks 
*** TURN *** [Th 8c 7h] [8s]
ZarubaNT: checks 
ChowYuenFatt: checks 
*** RIVER *** [Th 8c 7h 8s] [Qc]
ZarubaNT: checks 
ChowYuenFatt: checks 
*** SHOW DOWN ***
ZarubaNT: shows [Kd As] (a pair of Eights)
ChowYuenFatt: shows [Ks Ah] (a pair of Eights)
ZarubaNT collected $49.10 from pot
ChowYuenFatt collected $49.10 from pot
*** SUMMARY ***
Total pot $101 | Rake $2.80 
Board [Th 8c 7h 8s Qc]
Seat 2: SlovakPsycho (small blind) folded before Flop
Seat 3: vjxbkf (big blind) folded before Flop
Seat 4: ZarubaNT showed [Kd As] and won ($49.10) with a pair of Eights
Seat 5: dreamtech129 folded before Flop (didn't bet)
Seat 6: ChowYuenFatt (button) showed [Ks Ah] and won ($49.10) with a pair of Eights


PokerStars Game #102597700564:  Hold'em No Limit ($3/$6 USD) - 2013/08/11 5:46:24 ET
Table 'Klemola 40-100 bb' 6-max Seat #2 is the button
Seat 2: SlovakPsycho ($899.18 in chips) 
Seat 3: vjxbkf ($1176.87 in chips) 
Seat 4: ZarubaNT ($660.50 in chips) 
Seat 5: dreamtech129 ($600 in chips) 
Seat 6: ChowYuenFatt ($621.30 in chips) 
vjxbkf: posts small blind $3
ZarubaNT: posts big blind $6
DuckinF0nk: sits out 
*** HOLE CARDS ***
dreamtech129: folds 
ChowYuenFatt: folds 
SlovakPsycho: raises $6 to $12
vjxbkf: folds 
ZarubaNT: calls $6
*** FLOP *** [5d Qd Ah]
ZarubaNT: checks 
SlovakPsycho: checks 
*** TURN *** [5d Qd Ah] [Qc]
ZarubaNT: checks 
SlovakPsycho: checks 
*** RIVER *** [5d Qd Ah Qc] [9c]
ZarubaNT: bets $18
SlovakPsycho: calls $18
*** SHOW DOWN ***
ZarubaNT: shows [5h 5c] (a full house, Fives full of Queens)
SlovakPsycho: mucks hand 
ZarubaNT collected $60.20 from pot
*** SUMMARY ***
Total pot $63 | Rake $2.80 
Board [5d Qd Ah Qc 9c]
Seat 2: SlovakPsycho (button) mucked
Seat 3: vjxbkf (small blind) folded before Flop
Seat 4: ZarubaNT (big blind) showed [5h 5c] and won ($60.20) with a full house, Fives full of Queens
Seat 5: dreamtech129 folded before Flop (didn't bet)
Seat 6: ChowYuenFatt folded before Flop (didn't bet)


PokerStars Game #102597729556:  Hold'em No Limit ($3/$6 USD) - 2013/08/11 5:47:35 ET
Table 'Klemola 40-100 bb' 6-max Seat #3 is the button
Seat 2: SlovakPsycho ($869.18 in chips) 
Seat 3: vjxbkf ($1173.87 in chips) 
Seat 4: ZarubaNT ($690.70 in chips) 
Seat 5: dreamtech129 ($600 in chips) 
Seat 6: ChowYuenFatt ($621.30 in chips) 
ZarubaNT: posts small blind $3
dreamtech129: posts big blind $6
DuckinF0nk: sits out 
*** HOLE CARDS ***
ChowYuenFatt: folds 
SlovakPsycho: folds 
vjxbkf: raises $6 to $12
ZarubaNT: calls $9
dreamtech129: folds 
*** FLOP *** [Kd Tc 5c]
ZarubaNT: checks 
vjxbkf: checks 
*** TURN *** [Kd Tc 5c] [3s]
ZarubaNT: checks 
vjxbkf: checks 
*** RIVER *** [Kd Tc 5c 3s] [Js]
ZarubaNT: checks 
vjxbkf: checks 
*** SHOW DOWN ***
ZarubaNT: shows [8c 8d] (a pair of Eights)
vjxbkf: mucks hand 
ZarubaNT collected $28.65 from pot
*** SUMMARY ***
Total pot $30 | Rake $1.35 
Board [Kd Tc 5c 3s Js]
Seat 2: SlovakPsycho folded before Flop (didn't bet)
Seat 3: vjxbkf (button) mucked
Seat 4: ZarubaNT (small blind) showed [8c 8d] and won ($28.65) with a pair of Eights
Seat 5: dreamtech129 (big blind) folded before Flop
Seat 6: ChowYuenFatt folded before Flop (didn't bet)


PokerStars Game #102597748397:  Hold'em No Limit ($3/$6 USD) - 2013/08/11 5:48:21 ET
Table 'Klemola 40-100 bb' 6-max Seat #4 is the button
Seat 2: SlovakPsycho ($869.18 in chips) 
Seat 3: vjxbkf ($1161.87 in chips) 
Seat 4: ZarubaNT ($707.35 in chips) 
Seat 5: dreamtech129 ($600 in chips) 
Seat 6: ChowYuenFatt ($621.30 in chips) 
dreamtech129: posts small blind $3
ChowYuenFatt: posts big blind $6
DuckinF0nk: sits out 
*** HOLE CARDS ***
SlovakPsycho: folds 
vjxbkf: raises $12 to $18
ZarubaNT: folds 
dreamtech129: folds 
ChowYuenFatt: calls $12
*** FLOP *** [4s 5s Ah]
ChowYuenFatt: checks 
vjxbkf: bets $21
ChowYuenFatt: folds 
Uncalled bet ($21) returned to vjxbkf
vjxbkf collected $37.24 from pot
vjxbkf: doesn't show hand 
*** SUMMARY ***
Total pot $39 | Rake $1.76 
Board [4s 5s Ah]
Seat 2: SlovakPsycho folded before Flop (didn't bet)
Seat 3: vjxbkf collected ($37.24)
Seat 4: ZarubaNT (button) folded before Flop (didn't bet)
Seat 5: dreamtech129 (small blind) folded before Flop
Seat 6: ChowYuenFatt (big blind) folded on the Flop


PokerStars Game #102597770884:  Hold'em No Limit ($3/$6 USD) - 2013/08/11 5:49:17 ET
Table 'Klemola 40-100 bb' 6-max Seat #5 is the button
Seat 1: DuckinF0nk ($600 in chips) 
Seat 2: SlovakPsycho ($869.18 in chips) 
Seat 3: vjxbkf ($1181.11 in chips) 
Seat 4: ZarubaNT ($707.35 in chips) 
Seat 5: dreamtech129 ($600 in chips) 
Seat 6: ChowYuenFatt ($603.30 in chips) 
ChowYuenFatt: posts small blind $3
DuckinF0nk: posts big blind $6
*** HOLE CARDS ***
SlovakPsycho: folds 
vjxbkf: folds 
ZarubaNT: folds 
dreamtech129: raises $7.80 to $13.80
ChowYuenFatt: raises $33.20 to $47
DuckinF0nk: folds 
dreamtech129: folds 
Uncalled bet ($33.20) returned to ChowYuenFatt
ChowYuenFatt collected $33.60 from pot
ChowYuenFatt: doesn't show hand 
*** SUMMARY ***
Total pot $33.60 | Rake $0 
Seat 1: DuckinF0nk (big blind) folded before Flop
Seat 2: SlovakPsycho folded before Flop (didn't bet)
Seat 3: vjxbkf folded before Flop (didn't bet)
Seat 4: ZarubaNT folded before Flop (didn't bet)
Seat 5: dreamtech129 (button) folded before Flop
Seat 6: ChowYuenFatt (small blind) collected ($33.60)


PokerStars Game #102597783237:  Hold'em No Limit ($3/$6 USD) - 2013/08/11 5:49:47 ET
Table 'Klemola 40-100 bb' 6-max Seat #6 is the button
Seat 1: DuckinF0nk ($600 in chips) 
Seat 2: SlovakPsycho ($869.18 in chips) 
Seat 3: vjxbkf ($1181.11 in chips) 
Seat 4: ZarubaNT ($707.35 in chips) 
Seat 5: dreamtech129 ($600 in chips) 
Seat 6: ChowYuenFatt ($623.10 in chips) 
DuckinF0nk: posts small blind $3
SlovakPsycho: posts big blind $6
*** HOLE CARDS ***
vjxbkf: folds 
ZarubaNT: folds 
dreamtech129: folds 
ChowYuenFatt: raises $9 to $15
DuckinF0nk: calls $12
SlovakPsycho: folds 
*** FLOP *** [3d 6s 6c]
DuckinF0nk: checks 
ChowYuenFatt: bets $34
DuckinF0nk: folds 
Uncalled bet ($34) returned to ChowYuenFatt
ChowYuenFatt collected $34.38 from pot
ChowYuenFatt: doesn't show hand 
*** SUMMARY ***
Total pot $36 | Rake $1.62 
Board [3d 6s 6c]
Seat 1: DuckinF0nk (small blind) folded on the Flop
Seat 2: SlovakPsycho (big blind) folded before Flop
Seat 3: vjxbkf folded before Flop (didn't bet)
Seat 4: ZarubaNT folded before Flop (didn't bet)
Seat 5: dreamtech129 folded before Flop (didn't bet)
Seat 6: ChowYuenFatt (button) collected ($34.38)


PokerStars Game #102598264530:  Hold'em No Limit ($3/$6 USD) - 2013/08/11 6:10:28 ET
Table 'Klemola 40-100 bb' 6-max Seat #1 is the button
Seat 1: DuckinF0nk ($708 in chips) 
Seat 2: SlovakPsycho ($1132.87 in chips) 
Seat 3: vjxbkf ($1185.89 in chips) 
Seat 4: GERAKLmeat ($363 in chips) 
Seat 5: dreamtech129 ($604.20 in chips) 
Seat 6: ChowYuenFatt ($508.08 in chips) 
SlovakPsycho: posts small blind $3
vjxbkf: posts big blind $6
*** HOLE CARDS ***
GERAKLmeat: raises $6 to $12
dreamtech129: folds 
ChowYuenFatt: folds 
DuckinF0nk: folds 
SlovakPsycho: folds 
vjxbkf: calls $6
*** FLOP *** [3d 8s 7h]
vjxbkf: bets $21
GERAKLmeat: folds 
Uncalled bet ($21) returned to vjxbkf
vjxbkf collected $25.78 from pot
vjxbkf: doesn't show hand 
*** SUMMARY ***
Total pot $27 | Rake $1.22 
Board [3d 8s 7h]
Seat 1: DuckinF0nk (button) folded before Flop (didn't bet)
Seat 2: SlovakPsycho (small blind) folded before Flop
Seat 3: vjxbkf (big blind) collected ($25.78)
Seat 4: GERAKLmeat folded on the Flop
Seat 5: dreamtech129 folded before Flop (didn't bet)
Seat 6: ChowYuenFatt folded before Flop (didn't bet)


PokerStars Game #102598279135:  Hold'em No Limit ($3/$6 USD) - 2013/08/11 6:11:02 ET
Table 'Klemola 40-100 bb' 6-max Seat #2 is the button
Seat 1: DuckinF0nk ($708 in chips) 
Seat 2: SlovakPsycho ($1129.87 in chips) 
Seat 3: vjxbkf ($1199.67 in chips) 
Seat 4: GERAKLmeat ($351 in chips) 
Seat 5: dreamtech129 ($604.20 in chips) 
Seat 6: ChowYuenFatt ($508.08 in chips) 
vjxbkf: posts small blind $3
GERAKLmeat: posts big blind $6
*** HOLE CARDS ***
dreamtech129: folds 
ChowYuenFatt: folds 
DuckinF0nk: raises $6 to $12
SlovakPsycho: folds 
vjxbkf: raises $39 to $51
GERAKLmeat: folds 
DuckinF0nk: folds 
Uncalled bet ($39) returned to vjxbkf
vjxbkf collected $30 from pot
vjxbkf: doesn't show hand 
*** SUMMARY ***
Total pot $30 | Rake $0 
Seat 1: DuckinF0nk folded before Flop
Seat 2: SlovakPsycho (button) folded before Flop (didn't bet)
Seat 3: vjxbkf (small blind) collected ($30)
Seat 4: GERAKLmeat (big blind) folded before Flop
Seat 5: dreamtech129 folded before Flop (didn't bet)
Seat 6: ChowYuenFatt folded before Flop (didn't bet)


PokerStars Game #102598294815:  Hold'em No Limit ($3/$6 USD) - 2013/08/11 6:11:39 ET
Table 'Klemola 40-100 bb' 6-max Seat #3 is the button
Seat 1: DuckinF0nk ($696 in chips) 
Seat 2: SlovakPsycho ($1129.87 in chips) 
Seat 3: vjxbkf ($1217.67 in chips) 
Seat 4: GERAKLmeat ($345 in chips) 
Seat 5: dreamtech129 ($604.20 in chips) 
Seat 6: ChowYuenFatt ($508.08 in chips) 
GERAKLmeat: posts small blind $3
dreamtech129: posts big blind $6
*** HOLE CARDS ***
ChowYuenFatt: folds 
DuckinF0nk: raises $9 to $15
SlovakPsycho: folds 
vjxbkf: calls $15
GERAKLmeat: raises $330 to $345 and is all-in
dreamtech129: folds 
DuckinF0nk: folds 
vjxbkf: calls $330
*** FLOP *** [5s 2c 5d]
*** TURN *** [5s 2c 5d] [6d]
*** RIVER *** [5s 2c 5d 6d] [Qc]
*** SHOW DOWN ***
GERAKLmeat: shows [9d 9c] (two pair, Nines and Fives)
vjxbkf: shows [8d 8h] (two pair, Eights and Fives)
GERAKLmeat collected $708.20 from pot
*** SUMMARY ***
Total pot $711 | Rake $2.80 
Board [5s 2c 5d 6d Qc]
Seat 1: DuckinF0nk folded before Flop
Seat 2: SlovakPsycho folded before Flop (didn't bet)
Seat 3: vjxbkf (button) showed [8d 8h] and lost with two pair, Eights and Fives
Seat 4: GERAKLmeat (small blind) showed [9d 9c] and won ($708.20) with two pair, Nines and Fives
Seat 5: dreamtech129 (big blind) folded before Flop
Seat 6: ChowYuenFatt folded before Flop (didn't bet)


PokerStars Game #102598329054:  Hold'em No Limit ($3/$6 USD) - 2013/08/11 6:13:00 ET
Table 'Klemola 40-100 bb' 6-max Seat #4 is the button
Seat 1: DuckinF0nk ($681 in chips) 
Seat 2: SlovakPsycho ($1129.87 in chips) 
Seat 3: vjxbkf ($872.67 in chips) 
Seat 4: GERAKLmeat ($708.20 in chips) 
Seat 5: dreamtech129 ($600 in chips) 
Seat 6: ChowYuenFatt ($508.08 in chips) 
dreamtech129: posts small blind $3
ChowYuenFatt: posts big blind $6
*** HOLE CARDS ***
DuckinF0nk: folds 
SlovakPsycho: folds 
vjxbkf: folds 
GERAKLmeat: raises $6 to $12
dreamtech129: folds 
ChowYuenFatt: calls $6
*** FLOP *** [Ks Jh 8s]
ChowYuenFatt: checks 
GERAKLmeat: bets $13.14
ChowYuenFatt: folds 
Uncalled bet ($13.14) returned to GERAKLmeat
GERAKLmeat collected $25.78 from pot
GERAKLmeat: doesn't show hand 
*** SUMMARY ***
Total pot $27 | Rake $1.22 
Board [Ks Jh 8s]
Seat 1: DuckinF0nk folded before Flop (didn't bet)
Seat 2: SlovakPsycho folded before Flop (didn't bet)
Seat 3: vjxbkf folded before Flop (didn't bet)
Seat 4: GERAKLmeat (button) collected ($25.78)
Seat 5: dreamtech129 (small blind) folded before Flop
Seat 6: ChowYuenFatt (big blind) folded on the Flop


PokerStars Game #102598348709:  Hold'em No Limit ($3/$6 USD) - 2013/08/11 6:13:46 ET
Table 'Klemola 40-100 bb' 6-max Seat #5 is the button
Seat 1: DuckinF0nk ($681 in chips) 
Seat 2: SlovakPsycho ($1129.87 in chips) 
Seat 3: vjxbkf ($872.67 in chips) 
Seat 4: GERAKLmeat ($721.98 in chips) 
Seat 5: dreamtech129 ($600 in chips) 
Seat 6: ChowYuenFatt ($496.08 in chips) 
ChowYuenFatt: posts small blind $3
DuckinF0nk: posts big blind $6
*** HOLE CARDS ***
SlovakPsycho: folds 
vjxbkf: folds 
SlovakPsycho leaves the table
Hristo008 joins the table at seat #2 
GERAKLmeat: folds 
dreamtech129: raises $7.80 to $13.80
ChowYuenFatt: raises $24.20 to $38
DuckinF0nk: folds 
dreamtech129: calls $24.20
*** FLOP *** [2d 6s Qs]
ChowYuenFatt: bets $49
dreamtech129: calls $49
*** TURN *** [2d 6s Qs] [Jd]
ChowYuenFatt: checks 
dreamtech129: bets $114
ChowYuenFatt: calls $114
*** RIVER *** [2d 6s Qs Jd] [Kd]
ChowYuenFatt: bets $295.08 and is all-in
dreamtech129: calls $295.08
*** SHOW DOWN ***
ChowYuenFatt: shows [9s 9h] (a pair of Nines)
dreamtech129: shows [Ad Qd] (a flush, Ace high)
dreamtech129 collected $995.36 from pot
*** SUMMARY ***
Total pot $998.16 | Rake $2.80 
Board [2d 6s Qs Jd Kd]
Seat 1: DuckinF0nk (big blind) folded before Flop
Seat 2: SlovakPsycho folded before Flop (didn't bet)
Seat 3: vjxbkf folded before Flop (didn't bet)
Seat 4: GERAKLmeat folded before Flop (didn't bet)
Seat 5: dreamtech129 (button) showed [Ad Qd] and won ($995.36) with a flush, Ace high
Seat 6: ChowYuenFatt (small blind) showed [9s 9h] and lost with a pair of Nines


PokerStars Game #102598379467:  Hold'em No Limit ($3/$6 USD) - 2013/08/11 6:14:58 ET
Table 'Klemola 40-100 bb' 6-max Seat #1 is the button
Seat 1: DuckinF0nk ($675 in chips) 
Seat 3: vjxbkf ($872.67 in chips) 
Seat 4: GERAKLmeat ($721.98 in chips) 
Seat 5: dreamtech129 ($1099.28 in chips) 
vjxbkf: posts small blind $3
GERAKLmeat: posts big blind $6
*** HOLE CARDS ***
dreamtech129: folds 
DuckinF0nk: folds 
ChowYuenFatt leaves the table
vjxbkf: raises $18 to $24
GERAKLmeat: folds 
Uncalled bet ($18) returned to vjxbkf
vjxbkf collected $12 from pot
vjxbkf: doesn't show hand 
*** SUMMARY ***
Total pot $12 | Rake $0 
Seat 1: DuckinF0nk (button) folded before Flop (didn't bet)
Seat 3: vjxbkf (small blind) collected ($12)
Seat 4: GERAKLmeat (big blind) folded before Flop
Seat 5: dreamtech129 folded before Flop (didn't bet)


PokerStars Game #102598130124:  Hold'em No Limit ($3/$6 USD) - 2013/08/11 6:05:13 ET
Table 'Klemola 40-100 bb' 6-max Seat #1 is the button
Seat 1: DuckinF0nk ($600 in chips) 
Seat 2: SlovakPsycho ($1105.03 in chips) 
Seat 3: vjxbkf ($1194.89 in chips) 
Seat 4: GERAKLmeat ($288.20 in chips) 
Seat 5: dreamtech129 ($627 in chips) 
Seat 6: ChowYuenFatt ($691.88 in chips) 
SlovakPsycho: posts small blind $3
vjxbkf: posts big blind $6
*** HOLE CARDS ***
GERAKLmeat: folds 
dreamtech129: folds 
ChowYuenFatt: raises $9 to $15
DuckinF0nk: raises $33 to $48
SlovakPsycho: folds 
vjxbkf: folds 
ChowYuenFatt: raises $81 to $129
DuckinF0nk: raises $471 to $600 and is all-in
ChowYuenFatt: folds 
Uncalled bet ($471) returned to DuckinF0nk
DuckinF0nk collected $267 from pot
DuckinF0nk: doesn't show hand 
*** SUMMARY ***
Total pot $267 | Rake $0 
Seat 1: DuckinF0nk (button) collected ($267)
Seat 2: SlovakPsycho (small blind) folded before Flop
Seat 3: vjxbkf (big blind) folded before Flop
Seat 4: GERAKLmeat folded before Flop (didn't bet)
Seat 5: dreamtech129 folded before Flop (didn't bet)
Seat 6: ChowYuenFatt folded before Flop


PokerStars Game #102598149291:  Hold'em No Limit ($3/$6 USD) - 2013/08/11 6:05:57 ET
Table 'Klemola 40-100 bb' 6-max Seat #2 is the button
Seat 1: DuckinF0nk ($738 in chips) 
Seat 2: SlovakPsycho ($1102.03 in chips) 
Seat 3: vjxbkf ($1188.89 in chips) 
Seat 4: GERAKLmeat ($288.20 in chips) 
Seat 5: dreamtech129 ($627 in chips) 
Seat 6: ChowYuenFatt ($562.88 in chips) 
vjxbkf: posts small blind $3
GERAKLmeat: posts big blind $6
*** HOLE CARDS ***
dreamtech129: raises $7.80 to $13.80
ChowYuenFatt: calls $13.80
DuckinF0nk: folds 
SlovakPsycho: folds 
vjxbkf: folds 
GERAKLmeat: calls $7.80
*** FLOP *** [7h 4d Kh]
GERAKLmeat: checks 
dreamtech129: checks 
ChowYuenFatt: bets $32
GERAKLmeat: raises $242.40 to $274.40 and is all-in
dreamtech129: folds 
ChowYuenFatt: folds 
Uncalled bet ($242.40) returned to GERAKLmeat
GERAKLmeat collected $105.60 from pot
GERAKLmeat: doesn't show hand 
*** SUMMARY ***
Total pot $108.40 | Rake $2.80 
Board [7h 4d Kh]
Seat 1: DuckinF0nk folded before Flop (didn't bet)
Seat 2: SlovakPsycho (button) folded before Flop (didn't bet)
Seat 3: vjxbkf (small blind) folded before Flop
Seat 4: GERAKLmeat (big blind) collected ($105.60)
Seat 5: dreamtech129 folded on the Flop
Seat 6: ChowYuenFatt folded on the Flop


PokerStars Game #102598177189:  Hold'em No Limit ($3/$6 USD) - 2013/08/11 6:07:02 ET
Table 'Klemola 40-100 bb' 6-max Seat #3 is the button
Seat 1: DuckinF0nk ($738 in chips) 
Seat 2: SlovakPsycho ($1102.03 in chips) 
Seat 3: vjxbkf ($1185.89 in chips) 
Seat 4: GERAKLmeat ($348 in chips) 
Seat 5: dreamtech129 ($613.20 in chips) 
Seat 6: ChowYuenFatt ($517.08 in chips) 
GERAKLmeat: posts small blind $3
dreamtech129: posts big blind $6
*** HOLE CARDS ***
ChowYuenFatt: folds 
DuckinF0nk: folds 
SlovakPsycho: raises $12 to $18
vjxbkf: folds 
GERAKLmeat: folds 
dreamtech129: folds 
Uncalled bet ($12) returned to SlovakPsycho
SlovakPsycho collected $15 from pot
SlovakPsycho: doesn't show hand 
*** SUMMARY ***
Total pot $15 | Rake $0 
Seat 1: DuckinF0nk folded before Flop (didn't bet)
Seat 2: SlovakPsycho collected ($15)
Seat 3: vjxbkf (button) folded before Flop (didn't bet)
Seat 4: GERAKLmeat (small blind) folded before Flop
Seat 5: dreamtech129 (big blind) folded before Flop
Seat 6: ChowYuenFatt folded before Flop (didn't bet)


PokerStars Game #102598191049:  Hold'em No Limit ($3/$6 USD) - 2013/08/11 6:07:35 ET
Table 'Klemola 40-100 bb' 6-max Seat #4 is the button
Seat 1: DuckinF0nk ($738 in chips) 
Seat 2: SlovakPsycho ($1111.03 in chips) 
Seat 3: vjxbkf ($1185.89 in chips) 
Seat 4: GERAKLmeat ($345 in chips) 
Seat 5: dreamtech129 ($607.20 in chips) 
Seat 6: ChowYuenFatt ($517.08 in chips) 
dreamtech129: posts small blind $3
ChowYuenFatt: posts big blind $6
*** HOLE CARDS ***
DuckinF0nk: folds 
SlovakPsycho: folds 
vjxbkf: folds 
GERAKLmeat: raises $6 to $12
dreamtech129: folds 
ChowYuenFatt: folds 
Uncalled bet ($6) returned to GERAKLmeat
GERAKLmeat collected $15 from pot
GERAKLmeat: doesn't show hand 
*** SUMMARY ***
Total pot $15 | Rake $0 
Seat 1: DuckinF0nk folded before Flop (didn't bet)
Seat 2: SlovakPsycho folded before Flop (didn't bet)
Seat 3: vjxbkf folded before Flop (didn't bet)
Seat 4: GERAKLmeat (button) collected ($15)
Seat 5: dreamtech129 (small blind) folded before Flop
Seat 6: ChowYuenFatt (big blind) folded before Flop


PokerStars Game #102598199705:  Hold'em No Limit ($3/$6 USD) - 2013/08/11 6:07:55 ET
Table 'Klemola 40-100 bb' 6-max Seat #5 is the button
Seat 1: DuckinF0nk ($738 in chips) 
Seat 2: SlovakPsycho ($1111.03 in chips) 
Seat 3: vjxbkf ($1185.89 in chips) 
Seat 4: GERAKLmeat ($354 in chips) 
Seat 5: dreamtech129 ($604.20 in chips) 
Seat 6: ChowYuenFatt ($511.08 in chips) 
ChowYuenFatt: posts small blind $3
DuckinF0nk: posts big blind $6
*** HOLE CARDS ***
SlovakPsycho: folds 
vjxbkf: folds 
GERAKLmeat: raises $6 to $12
dreamtech129: folds 
ChowYuenFatt: folds 
DuckinF0nk: folds 
Uncalled bet ($6) returned to GERAKLmeat
GERAKLmeat collected $15 from pot
GERAKLmeat: doesn't show hand 
*** SUMMARY ***
Total pot $15 | Rake $0 
Seat 1: DuckinF0nk (big blind) folded before Flop
Seat 2: SlovakPsycho folded before Flop (didn't bet)
Seat 3: vjxbkf folded before Flop (didn't bet)
Seat 4: GERAKLmeat collected ($15)
Seat 5: dreamtech129 (button) folded before Flop (didn't bet)
Seat 6: ChowYuenFatt (small blind) folded before Flop


PokerStars Game #102598214040:  Hold'em No Limit ($3/$6 USD) - 2013/08/11 6:08:29 ET
Table 'Klemola 40-100 bb' 6-max Seat #6 is the button
Seat 1: DuckinF0nk ($732 in chips) 
Seat 2: SlovakPsycho ($1111.03 in chips) 
Seat 3: vjxbkf ($1185.89 in chips) 
Seat 4: GERAKLmeat ($363 in chips) 
Seat 5: dreamtech129 ($604.20 in chips) 
Seat 6: ChowYuenFatt ($508.08 in chips) 
DuckinF0nk: posts small blind $3
SlovakPsycho: posts big blind $6
*** HOLE CARDS ***
vjxbkf: folds 
GERAKLmeat: folds 
dreamtech129: folds 
ChowYuenFatt: folds 
DuckinF0nk: calls $3
SlovakPsycho: checks 
*** FLOP *** [Kd 7s Td]
DuckinF0nk: checks 
SlovakPsycho: checks 
*** TURN *** [Kd 7s Td] [Qs]
DuckinF0nk: bets $18
SlovakPsycho: calls $18
*** RIVER *** [Kd 7s Td Qs] [6s]
DuckinF0nk: checks 
SlovakPsycho: bets $33
DuckinF0nk: folds 
Uncalled bet ($33) returned to SlovakPsycho
SlovakPsycho collected $45.84 from pot
SlovakPsycho: doesn't show hand 
*** SUMMARY ***
Total pot $48 | Rake $2.16 
Board [Kd 7s Td Qs 6s]
Seat 1: DuckinF0nk (small blind) folded on the River
Seat 2: SlovakPsycho (big blind) collected ($45.84)
Seat 3: vjxbkf folded before Flop (didn't bet)
Seat 4: GERAKLmeat folded before Flop (didn't bet)
Seat 5: dreamtech129 folded before Flop (didn't bet)
Seat 6: ChowYuenFatt (button) folded before Flop (didn't bet)


PokerStars Game #102597920500:  Hold'em No Limit ($3/$6 USD) - 2013/08/11 5:55:32 ET
Table 'Klemola 40-100 bb' 6-max Seat #5 is the button
Seat 1: DuckinF0nk ($600 in chips) 
Seat 2: SlovakPsycho ($891.83 in chips) 
Seat 3: vjxbkf ($1181.11 in chips) 
Seat 4: GERAKLmeat ($312.20 in chips) 
Seat 5: dreamtech129 ($600 in chips) 
Seat 6: ChowYuenFatt ($631.68 in chips) 
ChowYuenFatt: posts small blind $3
DuckinF0nk: posts big blind $6
*** HOLE CARDS ***
SlovakPsycho: folds 
vjxbkf: folds 
GERAKLmeat: folds 
dreamtech129: folds 
ChowYuenFatt: folds 
Uncalled bet ($3) returned to DuckinF0nk
DuckinF0nk collected $6 from pot
DuckinF0nk: doesn't show hand 
*** SUMMARY ***
Total pot $6 | Rake $0 
Seat 1: DuckinF0nk (big blind) collected ($6)
Seat 2: SlovakPsycho folded before Flop (didn't bet)
Seat 3: vjxbkf folded before Flop (didn't bet)
Seat 4: GERAKLmeat folded before Flop (didn't bet)
Seat 5: dreamtech129 (button) folded before Flop (didn't bet)
Seat 6: ChowYuenFatt (small blind) folded before Flop


PokerStars Game #102597927535:  Hold'em No Limit ($3/$6 USD) - 2013/08/11 5:55:54 ET
Table 'Klemola 40-100 bb' 6-max Seat #6 is the button
Seat 1: DuckinF0nk ($603 in chips) 
Seat 2: SlovakPsycho ($891.83 in chips) 
Seat 3: vjxbkf ($1181.11 in chips) 
Seat 4: GERAKLmeat ($312.20 in chips) 
Seat 5: dreamtech129 ($600 in chips) 
Seat 6: ChowYuenFatt ($628.68 in chips) 
DuckinF0nk: posts small blind $3
SlovakPsycho: posts big blind $6
*** HOLE CARDS ***
vjxbkf: folds 
GERAKLmeat: folds 
dreamtech129: folds 
ChowYuenFatt: folds 
DuckinF0nk: folds 
Uncalled bet ($3) returned to SlovakPsycho
SlovakPsycho collected $6 from pot
SlovakPsycho: doesn't show hand 
*** SUMMARY ***
Total pot $6 | Rake $0 
Seat 1: DuckinF0nk (small blind) folded before Flop
Seat 2: SlovakPsycho (big blind) collected ($6)
Seat 3: vjxbkf folded before Flop (didn't bet)
Seat 4: GERAKLmeat folded before Flop (didn't bet)
Seat 5: dreamtech129 folded before Flop (didn't bet)
Seat 6: ChowYuenFatt (button) folded before Flop (didn't bet)


PokerStars Game #102597934251:  Hold'em No Limit ($3/$6 USD) - 2013/08/11 5:56:16 ET
Table 'Klemola 40-100 bb' 6-max Seat #1 is the button
Seat 1: DuckinF0nk ($600 in chips) 
Seat 2: SlovakPsycho ($894.83 in chips) 
Seat 3: vjxbkf ($1181.11 in chips) 
Seat 4: GERAKLmeat ($312.20 in chips) 
Seat 5: dreamtech129 ($600 in chips) 
Seat 6: ChowYuenFatt ($628.68 in chips) 
SlovakPsycho: posts small blind $3
vjxbkf: posts big blind $6
*** HOLE CARDS ***
GERAKLmeat: folds 
dreamtech129: folds 
ChowYuenFatt: folds 
DuckinF0nk: raises $6 to $12
SlovakPsycho: folds 
vjxbkf: calls $6
*** FLOP *** [Ad Kc Tc]
vjxbkf: bets $21
DuckinF0nk: folds 
Uncalled bet ($21) returned to vjxbkf
vjxbkf collected $25.78 from pot
vjxbkf: doesn't show hand 
*** SUMMARY ***
Total pot $27 | Rake $1.22 
Board [Ad Kc Tc]
Seat 1: DuckinF0nk (button) folded on the Flop
Seat 2: SlovakPsycho (small blind) folded before Flop
Seat 3: vjxbkf (big blind) collected ($25.78)
Seat 4: GERAKLmeat folded before Flop (didn't bet)
Seat 5: dreamtech129 folded before Flop (didn't bet)
Seat 6: ChowYuenFatt folded before Flop (didn't bet)


PokerStars Game #102597944840:  Hold'em No Limit ($3/$6 USD) - 2013/08/11 5:56:50 ET
Table 'Klemola 40-100 bb' 6-max Seat #2 is the button
Seat 1: DuckinF0nk ($600 in chips) 
Seat 2: SlovakPsycho ($891.83 in chips) 
Seat 3: vjxbkf ($1194.89 in chips) 
Seat 4: GERAKLmeat ($312.20 in chips) 
Seat 5: dreamtech129 ($600 in chips) 
Seat 6: ChowYuenFatt ($628.68 in chips) 
vjxbkf: posts small blind $3
GERAKLmeat: posts big blind $6
*** HOLE CARDS ***
dreamtech129: folds 
ChowYuenFatt: folds 
DuckinF0nk: folds 
SlovakPsycho: folds 
vjxbkf: folds 
Uncalled bet ($3) returned to GERAKLmeat
GERAKLmeat collected $6 from pot
GERAKLmeat: doesn't show hand 
*** SUMMARY ***
Total pot $6 | Rake $0 
Seat 1: DuckinF0nk folded before Flop (didn't bet)
Seat 2: SlovakPsycho (button) folded before Flop (didn't bet)
Seat 3: vjxbkf (small blind) folded before Flop
Seat 4: GERAKLmeat (big blind) collected ($6)
Seat 5: dreamtech129 folded before Flop (didn't bet)
Seat 6: ChowYuenFatt folded before Flop (didn't bet)


PokerStars Game #102597951024:  Hold'em No Limit ($3/$6 USD) - 2013/08/11 5:57:09 ET
Table 'Klemola 40-100 bb' 6-max Seat #3 is the button
Seat 1: DuckinF0nk ($600 in chips) 
Seat 2: SlovakPsycho ($891.83 in chips) 
Seat 3: vjxbkf ($1191.89 in chips) 
Seat 4: GERAKLmeat ($315.20 in chips) 
Seat 5: dreamtech129 ($600 in chips) 
Seat 6: ChowYuenFatt ($628.68 in chips) 
GERAKLmeat: posts small blind $3
dreamtech129: posts big blind $6
*** HOLE CARDS ***
ChowYuenFatt: raises $10 to $16
DuckinF0nk: folds 
SlovakPsycho: calls $16
vjxbkf: folds 
GERAKLmeat: folds 
dreamtech129: folds 
*** FLOP *** [Td 4d Kc]
ChowYuenFatt: bets $29
SlovakPsycho: calls $29
*** TURN *** [Td 4d Kc] [7s]
ChowYuenFatt: bets $79
SlovakPsycho: folds 
Uncalled bet ($79) returned to ChowYuenFatt
ChowYuenFatt collected $96.20 from pot
ChowYuenFatt: doesn't show hand 
*** SUMMARY ***
Total pot $99 | Rake $2.80 
Board [Td 4d Kc 7s]
Seat 1: DuckinF0nk folded before Flop (didn't bet)
Seat 2: SlovakPsycho folded on the Turn
Seat 3: vjxbkf (button) folded before Flop (didn't bet)
Seat 4: GERAKLmeat (small blind) folded before Flop
Seat 5: dreamtech129 (big blind) folded before Flop
Seat 6: ChowYuenFatt collected ($96.20)


PokerStars Game #102597982607:  Hold'em No Limit ($3/$6 USD) - 2013/08/11 5:58:47 ET
Table 'Klemola 40-100 bb' 6-max Seat #4 is the button
Seat 1: DuckinF0nk ($600 in chips) 
Seat 2: SlovakPsycho ($846.83 in chips) 
Seat 3: vjxbkf ($1191.89 in chips) 
Seat 4: GERAKLmeat ($312.20 in chips) 
Seat 5: dreamtech129 ($600 in chips) 
Seat 6: ChowYuenFatt ($679.88 in chips) 
dreamtech129: posts small blind $3
ChowYuenFatt: posts big blind $6
*** HOLE CARDS ***
DuckinF0nk: folds 
SlovakPsycho: folds 
vjxbkf: raises $12 to $18
GERAKLmeat: folds 
dreamtech129: folds 
ChowYuenFatt: folds 
Uncalled bet ($12) returned to vjxbkf
vjxbkf collected $15 from pot
vjxbkf: doesn't show hand 
*** SUMMARY ***
Total pot $15 | Rake $0 
Seat 1: DuckinF0nk folded before Flop (didn't bet)
Seat 2: SlovakPsycho folded before Flop (didn't bet)
Seat 3: vjxbkf collected ($15)
Seat 4: GERAKLmeat (button) folded before Flop (didn't bet)
Seat 5: dreamtech129 (small blind) folded before Flop
Seat 6: ChowYuenFatt (big blind) folded before Flop


PokerStars Game #102597991287:  Hold'em No Limit ($3/$6 USD) - 2013/08/11 5:59:15 ET
Table 'Klemola 40-100 bb' 6-max Seat #5 is the button
Seat 1: DuckinF0nk ($600 in chips) 
Seat 2: SlovakPsycho ($846.83 in chips) 
Seat 3: vjxbkf ($1200.89 in chips) 
Seat 4: GERAKLmeat ($312.20 in chips) 
Seat 5: dreamtech129 ($600 in chips) 
Seat 6: ChowYuenFatt ($673.88 in chips) 
ChowYuenFatt: posts small blind $3
DuckinF0nk: posts big blind $6
*** HOLE CARDS ***
SlovakPsycho: folds 
vjxbkf: folds 
GERAKLmeat: raises $6 to $12
dreamtech129: folds 
ChowYuenFatt: folds 
DuckinF0nk: folds 
Uncalled bet ($6) returned to GERAKLmeat
GERAKLmeat collected $15 from pot
GERAKLmeat: doesn't show hand 
*** SUMMARY ***
Total pot $15 | Rake $0 
Seat 1: DuckinF0nk (big blind) folded before Flop
Seat 2: SlovakPsycho folded before Flop (didn't bet)
Seat 3: vjxbkf folded before Flop (didn't bet)
Seat 4: GERAKLmeat collected ($15)
Seat 5: dreamtech129 (button) folded before Flop (didn't bet)
Seat 6: ChowYuenFatt (small blind) folded before Flop


PokerStars Game #102597997602:  Hold'em No Limit ($3/$6 USD) - 2013/08/11 5:59:34 ET
Table 'Klemola 40-100 bb' 6-max Seat #6 is the button
Seat 1: DuckinF0nk ($600 in chips) 
Seat 2: SlovakPsycho ($846.83 in chips) 
Seat 3: vjxbkf ($1200.89 in chips) 
Seat 4: GERAKLmeat ($321.20 in chips) 
Seat 5: dreamtech129 ($600 in chips) 
Seat 6: ChowYuenFatt ($670.88 in chips) 
DuckinF0nk: posts small blind $3
SlovakPsycho: posts big blind $6
*** HOLE CARDS ***
vjxbkf: folds 
GERAKLmeat: raises $6 to $12
dreamtech129: folds 
ChowYuenFatt: raises $27 to $39
DuckinF0nk: folds 
SlovakPsycho: folds 
GERAKLmeat: folds 
Uncalled bet ($27) returned to ChowYuenFatt
ChowYuenFatt collected $33 from pot
ChowYuenFatt: doesn't show hand 
*** SUMMARY ***
Total pot $33 | Rake $0 
Seat 1: DuckinF0nk (small blind) folded before Flop
Seat 2: SlovakPsycho (big blind) folded before Flop
Seat 3: vjxbkf folded before Flop (didn't bet)
Seat 4: GERAKLmeat folded before Flop
Seat 5: dreamtech129 folded before Flop (didn't bet)
Seat 6: ChowYuenFatt (button) collected ($33)


PokerStars Game #102598005511:  Hold'em No Limit ($3/$6 USD) - 2013/08/11 5:59:58 ET
Table 'Klemola 40-100 bb' 6-max Seat #1 is the button
Seat 1: DuckinF0nk ($600 in chips) 
Seat 2: SlovakPsycho ($840.83 in chips) 
Seat 3: vjxbkf ($1200.89 in chips) 
Seat 4: GERAKLmeat ($309.20 in chips) 
Seat 5: dreamtech129 ($600 in chips) 
Seat 6: ChowYuenFatt ($691.88 in chips) 
SlovakPsycho: posts small blind $3
vjxbkf: posts big blind $6
*** HOLE CARDS ***
GERAKLmeat: folds 
dreamtech129: folds 
ChowYuenFatt: folds 
DuckinF0nk: raises $6 to $12
SlovakPsycho: calls $9
vjxbkf: calls $6
*** FLOP *** [Kc 8h Ah]
SlovakPsycho: checks 
vjxbkf: checks 
DuckinF0nk: bets $24
SlovakPsycho: calls $24
vjxbkf: folds 
*** TURN *** [Kc 8h Ah] [2h]
SlovakPsycho: checks 
DuckinF0nk: bets $60
SlovakPsycho: calls $60
*** RIVER *** [Kc 8h Ah 2h] [9s]
SlovakPsycho: checks 
DuckinF0nk: bets $156
SlovakPsycho: calls $156
*** SHOW DOWN ***
DuckinF0nk: shows [Ts Qh] (high card Ace)
SlovakPsycho: shows [As Th] (a pair of Aces)
SlovakPsycho collected $513.20 from pot
*** SUMMARY ***
Total pot $516 | Rake $2.80 
Board [Kc 8h Ah 2h 9s]
Seat 1: DuckinF0nk (button) showed [Ts Qh] and lost with high card Ace
Seat 2: SlovakPsycho (small blind) showed [As Th] and won ($513.20) with a pair of Aces
Seat 3: vjxbkf (big blind) folded on the Flop
Seat 4: GERAKLmeat folded before Flop (didn't bet)
Seat 5: dreamtech129 folded before Flop (didn't bet)
Seat 6: ChowYuenFatt folded before Flop (didn't bet)


PokerStars Game #102598066546:  Hold'em No Limit ($3/$6 USD) - 2013/08/11 6:02:43 ET
Table 'Klemola 40-100 bb' 6-max Seat #2 is the button
Seat 1: DuckinF0nk ($600 in chips) 
Seat 2: SlovakPsycho ($1102.03 in chips) 
Seat 3: vjxbkf ($1188.89 in chips) 
Seat 4: GERAKLmeat ($309.20 in chips) 
Seat 5: dreamtech129 ($600 in chips) 
Seat 6: ChowYuenFatt ($691.88 in chips) 
vjxbkf: posts small blind $3
GERAKLmeat: posts big blind $6
*** HOLE CARDS ***
dreamtech129: folds 
ChowYuenFatt: folds 
DuckinF0nk: folds 
SlovakPsycho: raises $6 to $12
vjxbkf: folds 
GERAKLmeat: folds 
Uncalled bet ($6) returned to SlovakPsycho
SlovakPsycho collected $15 from pot
SlovakPsycho: doesn't show hand 
*** SUMMARY ***
Total pot $15 | Rake $0 
Seat 1: DuckinF0nk folded before Flop (didn't bet)
Seat 2: SlovakPsycho (button) collected ($15)
Seat 3: vjxbkf (small blind) folded before Flop
Seat 4: GERAKLmeat (big blind) folded before Flop
Seat 5: dreamtech129 folded before Flop (didn't bet)
Seat 6: ChowYuenFatt folded before Flop (didn't bet)


PokerStars Game #102598079723:  Hold'em No Limit ($3/$6 USD) - 2013/08/11 6:03:15 ET
Table 'Klemola 40-100 bb' 6-max Seat #3 is the button
Seat 1: DuckinF0nk ($600 in chips) 
Seat 2: SlovakPsycho ($1111.03 in chips) 
Seat 3: vjxbkf ($1185.89 in chips) 
Seat 4: GERAKLmeat ($303.20 in chips) 
Seat 5: dreamtech129 ($600 in chips) 
Seat 6: ChowYuenFatt ($691.88 in chips) 
GERAKLmeat: posts small blind $3
dreamtech129: posts big blind $6
*** HOLE CARDS ***
ChowYuenFatt: raises $9 to $15
DuckinF0nk: folds 
SlovakPsycho: folds 
vjxbkf: folds 
GERAKLmeat: folds 
dreamtech129: folds 
Uncalled bet ($9) returned to ChowYuenFatt
ChowYuenFatt collected $15 from pot
ChowYuenFatt: doesn't show hand 
*** SUMMARY ***
Total pot $15 | Rake $0 
Seat 1: DuckinF0nk folded before Flop (didn't bet)
Seat 2: SlovakPsycho folded before Flop (didn't bet)
Seat 3: vjxbkf (button) folded before Flop (didn't bet)
Seat 4: GERAKLmeat (small blind) folded before Flop
Seat 5: dreamtech129 (big blind) folded before Flop
Seat 6: ChowYuenFatt collected ($15)


PokerStars Game #102598091162:  Hold'em No Limit ($3/$6 USD) - 2013/08/11 6:03:41 ET
Table 'Klemola 40-100 bb' 6-max Seat #4 is the button
Seat 1: DuckinF0nk ($600 in chips) 
Seat 2: SlovakPsycho ($1111.03 in chips) 
Seat 3: vjxbkf ($1185.89 in chips) 
Seat 4: GERAKLmeat ($300.20 in chips) 
Seat 5: dreamtech129 ($600 in chips) 
Seat 6: ChowYuenFatt ($700.88 in chips) 
dreamtech129: posts small blind $3
ChowYuenFatt: posts big blind $6
*** HOLE CARDS ***
DuckinF0nk: folds 
SlovakPsycho: folds 
vjxbkf: folds 
GERAKLmeat: raises $6 to $12
dreamtech129: raises $18 to $30
ChowYuenFatt: folds 
GERAKLmeat: folds 
Uncalled bet ($18) returned to dreamtech129
dreamtech129 collected $30 from pot
dreamtech129: doesn't show hand 
*** SUMMARY ***
Total pot $30 | Rake $0 
Seat 1: DuckinF0nk folded before Flop (didn't bet)
Seat 2: SlovakPsycho folded before Flop (didn't bet)
Seat 3: vjxbkf folded before Flop (didn't bet)
Seat 4: GERAKLmeat (button) folded before Flop
Seat 5: dreamtech129 (small blind) collected ($30)
Seat 6: ChowYuenFatt (big blind) folded before Flop


PokerStars Game #102598101408:  Hold'em No Limit ($3/$6 USD) - 2013/08/11 6:04:06 ET
Table 'Klemola 40-100 bb' 6-max Seat #5 is the button
Seat 1: DuckinF0nk ($600 in chips) 
Seat 2: SlovakPsycho ($1111.03 in chips) 
Seat 3: vjxbkf ($1185.89 in chips) 
Seat 4: GERAKLmeat ($288.20 in chips) 
Seat 5: dreamtech129 ($618 in chips) 
Seat 6: ChowYuenFatt ($694.88 in chips) 
ChowYuenFatt: posts small blind $3
DuckinF0nk: posts big blind $6
*** HOLE CARDS ***
SlovakPsycho: folds 
vjxbkf: raises $15 to $21
GERAKLmeat: folds 
dreamtech129: folds 
ChowYuenFatt: folds 
DuckinF0nk: folds 
Uncalled bet ($15) returned to vjxbkf
vjxbkf collected $15 from pot
vjxbkf: doesn't show hand 
*** SUMMARY ***
Total pot $15 | Rake $0 
Seat 1: DuckinF0nk (big blind) folded before Flop
Seat 2: SlovakPsycho folded before Flop (didn't bet)
Seat 3: vjxbkf collected ($15)
Seat 4: GERAKLmeat folded before Flop (didn't bet)
Seat 5: dreamtech129 (button) folded before Flop (didn't bet)
Seat 6: ChowYuenFatt (small blind) folded before Flop


PokerStars Game #102598121176:  Hold'em No Limit ($3/$6 USD) - 2013/08/11 6:04:52 ET
Table 'Klemola 40-100 bb' 6-max Seat #6 is the button
Seat 1: DuckinF0nk ($600 in chips) 
Seat 2: SlovakPsycho ($1111.03 in chips) 
Seat 3: vjxbkf ($1194.89 in chips) 
Seat 4: GERAKLmeat ($288.20 in chips) 
Seat 5: dreamtech129 ($618 in chips) 
Seat 6: ChowYuenFatt ($691.88 in chips) 
DuckinF0nk: posts small blind $3
SlovakPsycho: posts big blind $6
*** HOLE CARDS ***
vjxbkf: folds 
GERAKLmeat: folds 
dreamtech129: raises $7.80 to $13.80
ChowYuenFatt: folds 
DuckinF0nk: folds 
SlovakPsycho: folds 
Uncalled bet ($7.80) returned to dreamtech129
dreamtech129 collected $15 from pot
dreamtech129: doesn't show hand 
*** SUMMARY ***
Total pot $15 | Rake $0 
Seat 1: DuckinF0nk (small blind) folded before Flop
Seat 2: SlovakPsycho (big blind) folded before Flop
Seat 3: vjxbkf folded before Flop (didn't bet)
Seat 4: GERAKLmeat folded before Flop (didn't bet)
Seat 5: dreamtech129 collected ($15)
Seat 6: ChowYuenFatt (button) folded before Flop (didn't bet)


PokerStars Game #102598655835:  Hold'em No Limit ($3/$6 USD) - 2013/08/11 6:25:41 ET
Table 'Klemola 40-100 bb' 6-max Seat #4 is the button
Seat 1: DuckinF0nk ($600 in chips) 
Seat 3: vjxbkf ($830.67 in chips) 
Seat 4: GERAKLmeat ($833.96 in chips) 
Seat 5: dreamtech129 ($1118.68 in chips) 
Seat 6: ZarubaNT ($908.20 in chips) 
dreamtech129: posts small blind $3
ZarubaNT: posts big blind $6
*** HOLE CARDS ***
DuckinF0nk: folds 
vjxbkf: folds 
GERAKLmeat: raises $6 to $12
dreamtech129: folds 
ZarubaNT: calls $6
*** FLOP *** [5c Kd Jd]
ZarubaNT: checks 
GERAKLmeat: bets $13.14
ZarubaNT: folds 
Uncalled bet ($13.14) returned to GERAKLmeat
GERAKLmeat collected $25.78 from pot
GERAKLmeat: doesn't show hand 
*** SUMMARY ***
Total pot $27 | Rake $1.22 
Board [5c Kd Jd]
Seat 1: DuckinF0nk folded before Flop (didn't bet)
Seat 3: vjxbkf folded before Flop (didn't bet)
Seat 4: GERAKLmeat (button) collected ($25.78)
Seat 5: dreamtech129 (small blind) folded before Flop
Seat 6: ZarubaNT (big blind) folded on the Flop


PokerStars Game #102598676701:  Hold'em No Limit ($3/$6 USD) - 2013/08/11 6:26:30 ET
Table 'Klemola 40-100 bb' 6-max Seat #5 is the button
Seat 1: DuckinF0nk ($600 in chips) 
Seat 3: vjxbkf ($830.67 in chips) 
Seat 4: GERAKLmeat ($847.74 in chips) 
Seat 5: dreamtech129 ($1115.68 in chips) 
Seat 6: ZarubaNT ($896.20 in chips) 
ZarubaNT: posts small blind $3
DuckinF0nk: posts big blind $6
*** HOLE CARDS ***
vjxbkf: folds 
GERAKLmeat: folds 
dreamtech129: raises $7.80 to $13.80
ZarubaNT: folds 
DuckinF0nk: raises $28.80 to $42.60
dreamtech129: folds 
Uncalled bet ($28.80) returned to DuckinF0nk
DuckinF0nk collected $30.60 from pot
DuckinF0nk: doesn't show hand 
*** SUMMARY ***
Total pot $30.60 | Rake $0 
Seat 1: DuckinF0nk (big blind) collected ($30.60)
Seat 3: vjxbkf folded before Flop (didn't bet)
Seat 4: GERAKLmeat folded before Flop (didn't bet)
Seat 5: dreamtech129 (button) folded before Flop
Seat 6: ZarubaNT (small blind) folded before Flop


PokerStars Game #102598685642:  Hold'em No Limit ($3/$6 USD) - 2013/08/11 6:26:51 ET
Table 'Klemola 40-100 bb' 6-max Seat #6 is the button
Seat 1: DuckinF0nk ($616.80 in chips) 
Seat 3: vjxbkf ($830.67 in chips) 
Seat 4: GERAKLmeat ($847.74 in chips) 
Seat 5: dreamtech129 ($1101.88 in chips) 
Seat 6: ZarubaNT ($893.20 in chips) 
DuckinF0nk: posts small blind $3
vjxbkf: posts big blind $6
*** HOLE CARDS ***
GERAKLmeat: raises $6 to $12
dreamtech129: folds 
ZarubaNT: folds 
DuckinF0nk: folds 
vjxbkf: calls $6
*** FLOP *** [2s 4s 5s]
vjxbkf: checks 
GERAKLmeat: bets $13.14
vjxbkf: folds 
Uncalled bet ($13.14) returned to GERAKLmeat
GERAKLmeat collected $25.78 from pot
GERAKLmeat: doesn't show hand 
*** SUMMARY ***
Total pot $27 | Rake $1.22 
Board [2s 4s 5s]
Seat 1: DuckinF0nk (small blind) folded before Flop
Seat 3: vjxbkf (big blind) folded on the Flop
Seat 4: GERAKLmeat collected ($25.78)
Seat 5: dreamtech129 folded before Flop (didn't bet)
Seat 6: ZarubaNT (button) folded before Flop (didn't bet)


PokerStars Game #102598704272:  Hold'em No Limit ($3/$6 USD) - 2013/08/11 6:27:35 ET
Table 'Klemola 40-100 bb' 6-max Seat #1 is the button
Seat 1: DuckinF0nk ($613.80 in chips) 
Seat 3: vjxbkf ($818.67 in chips) 
Seat 4: GERAKLmeat ($861.52 in chips) 
Seat 5: dreamtech129 ($1101.88 in chips) 
Seat 6: ZarubaNT ($893.20 in chips) 
Hristo008 was removed from the table for failing to post
vjxbkf: posts small blind $3
GERAKLmeat: posts big blind $6
*** HOLE CARDS ***
dreamtech129: raises $7.80 to $13.80
ZarubaNT: folds 
DuckinF0nk: folds 
vjxbkf: folds 
GERAKLmeat: folds 
Uncalled bet ($7.80) returned to dreamtech129
dreamtech129 collected $15 from pot
dreamtech129: doesn't show hand 
*** SUMMARY ***
Total pot $15 | Rake $0 
Seat 1: DuckinF0nk (button) folded before Flop (didn't bet)
Seat 3: vjxbkf (small blind) folded before Flop
Seat 4: GERAKLmeat (big blind) folded before Flop
Seat 5: dreamtech129 collected ($15)
Seat 6: ZarubaNT folded before Flop (didn't bet)


PokerStars Game #102598712689:  Hold'em No Limit ($3/$6 USD) - 2013/08/11 6:27:54 ET
Table 'Klemola 40-100 bb' 6-max Seat #3 is the button
Seat 1: DuckinF0nk ($613.80 in chips) 
Seat 3: vjxbkf ($815.67 in chips) 
Seat 4: GERAKLmeat ($855.52 in chips) 
Seat 5: dreamtech129 ($1110.88 in chips) 
Seat 6: ZarubaNT ($893.20 in chips) 
GERAKLmeat: posts small blind $3
dreamtech129: posts big blind $6
*** HOLE CARDS ***
ZarubaNT: folds 
DuckinF0nk: folds 
vjxbkf: folds 
GERAKLmeat: raises $6 to $12
dreamtech129: folds 
Uncalled bet ($6) returned to GERAKLmeat
GERAKLmeat collected $12 from pot
GERAKLmeat: doesn't show hand 
*** SUMMARY ***
Total pot $12 | Rake $0 
Seat 1: DuckinF0nk folded before Flop (didn't bet)
Seat 3: vjxbkf (button) folded before Flop (didn't bet)
Seat 4: GERAKLmeat (small blind) collected ($12)
Seat 5: dreamtech129 (big blind) folded before Flop
Seat 6: ZarubaNT folded before Flop (didn't bet)


PokerStars Game #102598719629:  Hold'em No Limit ($3/$6 USD) - 2013/08/11 6:28:10 ET
Table 'Klemola 40-100 bb' 6-max Seat #4 is the button
Seat 1: DuckinF0nk ($613.80 in chips) 
Seat 3: vjxbkf ($815.67 in chips) 
Seat 4: GERAKLmeat ($861.52 in chips) 
Seat 5: dreamtech129 ($1104.88 in chips) 
Seat 6: ZarubaNT ($893.20 in chips) 
dreamtech129: posts small blind $3
ZarubaNT: posts big blind $6
*** HOLE CARDS ***
DuckinF0nk: folds 
vjxbkf: folds 
GERAKLmeat: raises $6 to $12
dreamtech129: folds 
ZarubaNT: folds 
Uncalled bet ($6) returned to GERAKLmeat
GERAKLmeat collected $15 from pot
GERAKLmeat: doesn't show hand 
*** SUMMARY ***
Total pot $15 | Rake $0 
Seat 1: DuckinF0nk folded before Flop (didn't bet)
Seat 3: vjxbkf folded before Flop (didn't bet)
Seat 4: GERAKLmeat (button) collected ($15)
Seat 5: dreamtech129 (small blind) folded before Flop
Seat 6: ZarubaNT (big blind) folded before Flop


PokerStars Game #102598726711:  Hold'em No Limit ($3/$6 USD) - 2013/08/11 6:28:26 ET
Table 'Klemola 40-100 bb' 6-max Seat #5 is the button
Seat 4: GERAKLmeat ($870.52 in chips) 
Seat 5: dreamtech129 ($1101.88 in chips) 
Seat 6: ZarubaNT ($887.20 in chips) 
ZarubaNT: posts small blind $3
vjxbkf: is sitting out 
GERAKLmeat: posts big blind $6
*** HOLE CARDS ***
dreamtech129: raises $7.80 to $13.80
vjxbkf leaves the table
ZarubaNT: raises $34.20 to $48
GERAKLmeat: raises $52 to $100
dreamtech129: folds 
ZarubaNT: calls $52
*** FLOP *** [5d As 2c]
ZarubaNT: checks 
GERAKLmeat: bets $108.27
ZarubaNT: calls $108.27
*** TURN *** [5d As 2c] [Kd]
ZarubaNT: checks 
GERAKLmeat: checks 
*** RIVER *** [5d As 2c Kd] [3h]
ZarubaNT: bets $321
GERAKLmeat: folds 
Uncalled bet ($321) returned to ZarubaNT
ZarubaNT collected $428.84 from pot
ZarubaNT: doesn't show hand 
*** SUMMARY ***
Total pot $430.34 | Rake $1.50 
Board [5d As 2c Kd 3h]
Seat 4: GERAKLmeat (big blind) folded on the River
Seat 5: dreamtech129 (button) folded before Flop
Seat 6: ZarubaNT (small blind) collected ($428.84)


PokerStars Game #102598388338:  Hold'em No Limit ($3/$6 USD) - 2013/08/11 6:15:19 ET
Table 'Klemola 40-100 bb' 6-max Seat #3 is the button
Seat 1: DuckinF0nk ($675 in chips) 
Seat 3: vjxbkf ($878.67 in chips) 
Seat 4: GERAKLmeat ($715.98 in chips) 
Seat 5: dreamtech129 ($1099.28 in chips) 
GERAKLmeat: posts small blind $3
dreamtech129: posts big blind $6
*** HOLE CARDS ***
ZarubaNT joins the table at seat #6 
DuckinF0nk: folds 
vjxbkf: raises $6 to $12
GERAKLmeat: folds 
dreamtech129: folds 
Uncalled bet ($6) returned to vjxbkf
vjxbkf collected $15 from pot
vjxbkf: doesn't show hand 
*** SUMMARY ***
Total pot $15 | Rake $0 
Seat 1: DuckinF0nk folded before Flop (didn't bet)
Seat 3: vjxbkf (button) collected ($15)
Seat 4: GERAKLmeat (small blind) folded before Flop
Seat 5: dreamtech129 (big blind) folded before Flop


PokerStars Game #102598397051:  Hold'em No Limit ($3/$6 USD) - 2013/08/11 6:15:39 ET
Table 'Klemola 40-100 bb' 6-max Seat #4 is the button
Seat 1: DuckinF0nk ($675 in chips) 
Seat 3: vjxbkf ($887.67 in chips) 
Seat 4: GERAKLmeat ($712.98 in chips) 
Seat 5: dreamtech129 ($1093.28 in chips) 
Seat 6: ZarubaNT ($707.35 in chips) 
dreamtech129: posts small blind $3
ZarubaNT: posts big blind $6
*** HOLE CARDS ***
DuckinF0nk: folds 
vjxbkf: folds 
GERAKLmeat: raises $6 to $12
dreamtech129: folds 
ZarubaNT: calls $6
*** FLOP *** [8s Qc 8d]
ZarubaNT: checks 
GERAKLmeat: bets $13.14
ZarubaNT: calls $13.14
*** TURN *** [8s Qc 8d] [As]
ZarubaNT: checks 
GERAKLmeat: checks 
*** RIVER *** [8s Qc 8d As] [7c]
ZarubaNT: bets $39
GERAKLmeat: folds 
Uncalled bet ($39) returned to ZarubaNT
ZarubaNT collected $50.88 from pot
ZarubaNT: doesn't show hand 
*** SUMMARY ***
Total pot $53.28 | Rake $2.40 
Board [8s Qc 8d As 7c]
Seat 1: DuckinF0nk folded before Flop (didn't bet)
Seat 3: vjxbkf folded before Flop (didn't bet)
Seat 4: GERAKLmeat (button) folded on the River
Seat 5: dreamtech129 (small blind) folded before Flop
Seat 6: ZarubaNT (big blind) collected ($50.88)


PokerStars Game #102598418720:  Hold'em No Limit ($3/$6 USD) - 2013/08/11 6:16:29 ET
Table 'Klemola 40-100 bb' 6-max Seat #5 is the button
Seat 1: DuckinF0nk ($675 in chips) 
Seat 3: vjxbkf ($887.67 in chips) 
Seat 4: GERAKLmeat ($687.84 in chips) 
Seat 5: dreamtech129 ($1090.28 in chips) 
Seat 6: ZarubaNT ($733.09 in chips) 
ZarubaNT: posts small blind $3
DuckinF0nk: posts big blind $6
*** HOLE CARDS ***
vjxbkf: folds 
GERAKLmeat: folds 
dreamtech129: folds 
ZarubaNT: folds 
Uncalled bet ($3) returned to DuckinF0nk
DuckinF0nk collected $6 from pot
DuckinF0nk: doesn't show hand 
*** SUMMARY ***
Total pot $6 | Rake $0 
Seat 1: DuckinF0nk (big blind) collected ($6)
Seat 3: vjxbkf folded before Flop (didn't bet)
Seat 4: GERAKLmeat folded before Flop (didn't bet)
Seat 5: dreamtech129 (button) folded before Flop (didn't bet)
Seat 6: ZarubaNT (small blind) folded before Flop


PokerStars Game #102598425660:  Hold'em No Limit ($3/$6 USD) - 2013/08/11 6:16:45 ET
Table 'Klemola 40-100 bb' 6-max Seat #6 is the button
Seat 1: DuckinF0nk ($678 in chips) 
Seat 3: vjxbkf ($887.67 in chips) 
Seat 4: GERAKLmeat ($687.84 in chips) 
Seat 5: dreamtech129 ($1090.28 in chips) 
Seat 6: ZarubaNT ($730.09 in chips) 
DuckinF0nk: posts small blind $3
vjxbkf: posts big blind $6
*** HOLE CARDS ***
GERAKLmeat: folds 
dreamtech129: folds 
ZarubaNT: folds 
DuckinF0nk: raises $12 to $18
vjxbkf: folds 
Uncalled bet ($12) returned to DuckinF0nk
DuckinF0nk collected $12 from pot
DuckinF0nk: doesn't show hand 
*** SUMMARY ***
Total pot $12 | Rake $0 
Seat 1: DuckinF0nk (small blind) collected ($12)
Seat 3: vjxbkf (big blind) folded before Flop
Seat 4: GERAKLmeat folded before Flop (didn't bet)
Seat 5: dreamtech129 folded before Flop (didn't bet)
Seat 6: ZarubaNT (button) folded before Flop (didn't bet)


PokerStars Game #102598443285:  Hold'em No Limit ($3/$6 USD) - 2013/08/11 6:17:26 ET
Table 'Klemola 40-100 bb' 6-max Seat #1 is the button
Seat 1: DuckinF0nk ($684 in chips) 
Seat 3: vjxbkf ($881.67 in chips) 
Seat 4: GERAKLmeat ($687.84 in chips) 
Seat 5: dreamtech129 ($1090.28 in chips) 
Seat 6: ZarubaNT ($730.09 in chips) 
vjxbkf: posts small blind $3
GERAKLmeat: posts big blind $6
*** HOLE CARDS ***
dreamtech129: folds 
ZarubaNT: raises $9 to $15
DuckinF0nk: raises $27 to $42
vjxbkf: folds 
GERAKLmeat: folds 
ZarubaNT: raises $66 to $108
DuckinF0nk: folds 
Uncalled bet ($66) returned to ZarubaNT
ZarubaNT collected $93 from pot
ZarubaNT: doesn't show hand 
*** SUMMARY ***
Total pot $93 | Rake $0 
Seat 1: DuckinF0nk (button) folded before Flop
Seat 3: vjxbkf (small blind) folded before Flop
Seat 4: GERAKLmeat (big blind) folded before Flop
Seat 5: dreamtech129 folded before Flop (didn't bet)
Seat 6: ZarubaNT collected ($93)


PokerStars Game #102598463256:  Hold'em No Limit ($3/$6 USD) - 2013/08/11 6:18:12 ET
Table 'Klemola 40-100 bb' 6-max Seat #3 is the button
Seat 1: DuckinF0nk ($642 in chips) 
Seat 3: vjxbkf ($878.67 in chips) 
Seat 4: GERAKLmeat ($681.84 in chips) 
Seat 5: dreamtech129 ($1090.28 in chips) 
Seat 6: ZarubaNT ($781.09 in chips) 
GERAKLmeat: posts small blind $3
dreamtech129: posts big blind $6
*** HOLE CARDS ***
ZarubaNT: raises $12 to $18
DuckinF0nk: folds 
vjxbkf: folds 
GERAKLmeat: folds 
dreamtech129: raises $42 to $60
ZarubaNT: calls $42
*** FLOP *** [Qh 9d 8d]
dreamtech129: checks 
ZarubaNT: checks 
*** TURN *** [Qh 9d 8d] [7d]
dreamtech129: checks 
ZarubaNT: checks 
*** RIVER *** [Qh 9d 8d 7d] [7s]
dreamtech129: checks 
ZarubaNT: checks 
*** SHOW DOWN ***
dreamtech129: shows [Ts Tc] (two pair, Tens and Sevens)
ZarubaNT: mucks hand 
dreamtech129 collected $120.20 from pot
*** SUMMARY ***
Total pot $123 | Rake $2.80 
Board [Qh 9d 8d 7d 7s]
Seat 1: DuckinF0nk folded before Flop (didn't bet)
Seat 3: vjxbkf (button) folded before Flop (didn't bet)
Seat 4: GERAKLmeat (small blind) folded before Flop
Seat 5: dreamtech129 (big blind) showed [Ts Tc] and won ($120.20) with two pair, Tens and Sevens
Seat 6: ZarubaNT mucked


PokerStars Game #102598484030:  Hold'em No Limit ($3/$6 USD) - 2013/08/11 6:19:00 ET
Table 'Klemola 40-100 bb' 6-max Seat #4 is the button
Seat 1: DuckinF0nk ($642 in chips) 
Seat 3: vjxbkf ($878.67 in chips) 
Seat 4: GERAKLmeat ($678.84 in chips) 
Seat 5: dreamtech129 ($1150.48 in chips) 
Seat 6: ZarubaNT ($721.09 in chips) 
dreamtech129: posts small blind $3
ZarubaNT: posts big blind $6
*** HOLE CARDS ***
DuckinF0nk: folds 
vjxbkf: folds 
GERAKLmeat: raises $6 to $12
dreamtech129: folds 
ZarubaNT: calls $6
*** FLOP *** [Js 5h Ah]
ZarubaNT: checks 
GERAKLmeat: bets $13.14
ZarubaNT: calls $13.14
*** TURN *** [Js 5h Ah] [Jc]
ZarubaNT: checks 
GERAKLmeat: bets $36
ZarubaNT: calls $36
*** RIVER *** [Js 5h Ah Jc] [3d]
ZarubaNT: checks 
GERAKLmeat: bets $80
ZarubaNT: calls $80
*** SHOW DOWN ***
GERAKLmeat: shows [Jd 9c] (three of a kind, Jacks)
ZarubaNT: mucks hand 
GERAKLmeat collected $282.48 from pot
*** SUMMARY ***
Total pot $285.28 | Rake $2.80 
Board [Js 5h Ah Jc 3d]
Seat 1: DuckinF0nk folded before Flop (didn't bet)
Seat 3: vjxbkf folded before Flop (didn't bet)
Seat 4: GERAKLmeat (button) showed [Jd 9c] and won ($282.48) with three of a kind, Jacks
Seat 5: dreamtech129 (small blind) folded before Flop
Seat 6: ZarubaNT (big blind) mucked
